PokerStars Hand #3966386570:  Hold'em No Limit ($2.50/$5) - 2020/06/26 13:14:34 ET
Table 'Zone Poker ID 1645' 9-max Seat #3 is the button
Seat 1: Big Blind ($500.00 in chips) 
Seat 2: UTG ($757.00 in chips) 
Seat 3: Dealer ($530.14 in chips) 
Seat 4: Hero ($539.50 in chips) 
Hero: posts small blind $2.50
Big Blind: posts big blind $5
*** HOLE CARDS ***
Dealt to Hero [6h Qh]
UTG: folds 
Dealer: folds 
Hero: raises $10.00 to $15
Big Blind: calls $10
*** FLOP *** [5h 4h 8s]
Hero: checks 
Big Blind: checks 
*** TURN *** [5h 4h 8s] [Qs]
Hero: checks 
Big Blind: checks 
*** RIVER *** [5h 4h 8s Qs] [Tc]
Hero: bets $21.38
Big Blind: raises $22.68 to $44.06
Hero: calls $22.68
*** SHOW DOWN ***
UTG: shows [8c 6c] (a hand...)
Dealer: shows [9c 4s] (a hand...)
Big Blind: shows [Jd Qc] (a hand...)
Hero: shows [6h Qh] (a hand...)
Big Blind collected $115.12 from pot
*** SUMMARY ***
Total pot $118.12 | Rake $3.00
Board [5h 4h 8s Qs Tc]
Seat 1: Big Blind showed [Jd Qc] and won ($115.12)
Seat 2: UTG folded
Seat 3: Dealer folded
Seat 4: Hero showed [6h Qh] and lost with...



PokerStars Hand #3966385841:  Hold'em No Limit ($2.50/$5) - 2020/06/26 13:11:54 ET
Table 'Zone Poker ID 1645' 9-max Seat #2 is the button
Seat 1: UTG+1 ($552.88 in chips) 
Seat 2: Dealer ($564.00 in chips) 
Seat 3: Small Blind ($681.29 in chips) 
Seat 4: Hero ($1181.18 in chips) 
Seat 5: UTG ($507.50 in chips) 
Small Blind: posts small blind $2.50
Hero: posts big blind $5
*** HOLE CARDS ***
Dealt to Hero [Kh Js]
UTG: folds 
UTG+1: folds 
Dealer: raises $10 to $15
Small Blind: folds 
Hero: calls $10
*** FLOP *** [Kc 5h 3c]
Hero: checks 
Dealer: bets $18.16
Hero: calls $18.16
*** TURN *** [Kc 5h 3c] [Th]
Hero: checks 
Dealer: bets $50.82
Hero: calls $50.82
*** RIVER *** [Kc 5h 3c Th] [9s]
Hero: checks 
Dealer: bets $120
Hero: calls $120
*** SHOW DOWN ***
Small Blind: shows [8d Qd] (a hand...)
Hero: shows [Kh Js] (a hand...)
Dealer: shows [Ts Tc] (a hand...)
UTG: shows [Qh 5d] (a hand...)
UTG+1: shows [9c 4d] (a hand...)
Dealer collected $407.46 from pot
*** SUMMARY ***
Total pot $410.46 | Rake $3.00
Board [Kc 5h 3c Th 9s]
Seat 1: UTG+1 folded
Seat 2: Dealer showed [Ts Tc] and won ($407.46)
Seat 3: Small Blind folded
Seat 4: Hero showed [Kh Js] and lost with...
Seat 5: UTG folded



PokerStars Hand #3966384457:  Hold'em No Limit ($2.50/$5) - 2020/06/26 13:06:59 ET
Table 'Zone Poker ID 1645' 9-max Seat #4 is the button
Seat 1: Hero ($583.11 in chips) 
Seat 2: UTG ($493.50 in chips) 
Seat 3: UTG+1 ($251.09 in chips) 
Seat 4: Dealer ($636.76 in chips) 
Seat 5: Small Blind ($713.46 in chips) 
Small Blind: posts small blind $2.50
Hero: posts big blind $5
*** HOLE CARDS ***
Dealt to Hero [6h 7c]
UTG: folds 
UTG+1: folds 
Dealer: folds 
Small Blind: raises $10.00 to $15
Hero: calls $10
*** FLOP *** [Tc Qc Ac]
Small Blind: checks 
Hero: checks 
*** TURN *** [Tc Qc Ac] [9d]
Small Blind: checks 
Hero: checks 
*** RIVER *** [Tc Qc Ac 9d] [Ks]
Small Blind: bets $5
Hero: folds 
*** SHOW DOWN ***
Small Blind: shows [Kc 6c] (a hand...)
Hero: shows [6h 7c] (a hand...)
Dealer: shows [Jh 2d] (a hand...)
UTG: shows [Ts 3s] (a hand...)
UTG+1: shows [Th 9c] (a hand...)
Uncalled bet ($5.00) returned to Small Blind
Small Blind collected $28.50 from pot
*** SUMMARY ***
Total pot $30.00 | Rake $1.50
Board [Tc Qc Ac 9d Ks]
Seat 1: Hero folded
Seat 2: UTG folded
Seat 3: UTG+1 folded
Seat 4: Dealer folded
Seat 5: Small Blind collected ($28.50)



PokerStars Hand #3966382520:  Hold'em No Limit ($2.50/$5) - 2020/06/26 13:00:18 ET
Table 'Zone Poker ID 1645' 9-max Seat #3 is the button
Seat 1: Big Blind ($500.00 in chips) 
Seat 2: UTG ($526.23 in chips) 
Seat 3: Dealer ($305.35 in chips) 
Seat 4: Hero ($698.74 in chips) 
Hero: posts small blind $2.50
Big Blind: posts big blind $5
*** HOLE CARDS ***
Dealt to Hero [Td Ad]
UTG: folds 
Dealer: folds 
Hero: raises $10.00 to $15
Big Blind: calls $10
*** FLOP *** [7d 2h 9d]
Hero: checks 
Big Blind: checks 
*** TURN *** [7d 2h 9d] [Th]
Hero: bets $21.38
Big Blind: calls $21.38
*** RIVER *** [7d 2h 9d Th] [8h]
Hero: checks 
Big Blind: bets $141
Hero: folds 
*** SHOW DOWN ***
UTG: shows [2c Jc] (a hand...)
Dealer: shows [5c Qh] (a hand...)
Big Blind: shows [7s Qs] (a hand...)
Hero: shows [Td Ad] (a hand...)
Uncalled bet ($141.00) returned to Big Blind
Big Blind collected $69.76 from pot
*** SUMMARY ***
Total pot $72.76 | Rake $3.00
Board [7d 2h 9d Th 8h]
Seat 1: Big Blind collected ($69.76)
Seat 2: UTG folded
Seat 3: Dealer folded
Seat 4: Hero folded



PokerStars Hand #3966380934:  Hold'em No Limit ($2.50/$5) - 2020/06/26 12:54:58 ET
Table 'Zone Poker ID 1645' 9-max Seat #3 is the button
Seat 1: Hero ($826.20 in chips) 
Seat 2: UTG ($713.47 in chips) 
Seat 3: Dealer ($521.00 in chips) 
Seat 4: Small Blind ($591.77 in chips) 
Small Blind: posts small blind $2.50
Hero: posts big blind $5
*** HOLE CARDS ***
Dealt to Hero [Qc Js]
UTG: raises $10 to $15
Dealer: folds 
Small Blind: folds 
Hero: calls $10
*** FLOP *** [7d 9h Qs]
Hero: checks 
UTG: bets $23.16
Hero: calls $23.16
*** TURN *** [7d 9h Qs] [9s]
Hero: checks 
UTG: bets $41.87
Hero: calls $41.87
*** RIVER *** [7d 9h Qs 9s] [5c]
Hero: checks 
UTG: bets $79.78
Hero: folds 
*** SHOW DOWN ***
Small Blind: shows [2s Tc] (a hand...)
UTG: shows [Kh 9c] (a hand...)
Dealer: shows [4s 5s] (a hand...)
Hero: shows [Qc Js] (a hand...)
Uncalled bet ($79.78) returned to UTG
UTG collected $159.56 from pot
*** SUMMARY ***
Total pot $162.56 | Rake $3.00
Board [7d 9h Qs 9s 5c]
Seat 1: Hero folded
Seat 2: UTG collected ($159.56)
Seat 3: Dealer folded
Seat 4: Small Blind folded



PokerStars Hand #3966374949:  Hold'em No Limit ($2.50/$5) - 2020/06/26 12:33:11 ET
Table 'Zone Poker ID 1645' 9-max Seat #3 is the button
Seat 1: Big Blind ($500.00 in chips) 
Seat 2: UTG ($1923.97 in chips) 
Seat 3: Dealer ($551.76 in chips) 
Seat 4: Hero ($988.75 in chips) 
Hero: posts small blind $2.50
Big Blind: posts big blind $5
*** HOLE CARDS ***
Dealt to Hero [5s Qs]
UTG: folds 
Dealer: folds 
Hero: raises $10.00 to $15
Big Blind: calls $10
*** FLOP *** [As Jd 3d]
Hero: bets $9.25
Big Blind: calls $9.25
*** TURN *** [As Jd 3d] [3c]
Hero: checks 
Big Blind: checks 
*** RIVER *** [As Jd 3d 3c] [7c]
Hero: checks 
Big Blind: bets $34.56
Hero: folds 
*** SHOW DOWN ***
UTG: shows [Jc 6c] (a hand...)
Dealer: shows [Jh 4c] (a hand...)
Big Blind: shows [4s Ad] (a hand...)
Hero: shows [5s Qs] (a hand...)
Uncalled bet ($34.56) returned to Big Blind
Big Blind collected $46.08 from pot
*** SUMMARY ***
Total pot $48.50 | Rake $2.42
Board [As Jd 3d 3c 7c]
Seat 1: Big Blind collected ($46.08)
Seat 2: UTG folded
Seat 3: Dealer folded
Seat 4: Hero folded



PokerStars Hand #3966371234:  Hold'em No Limit ($2.50/$5) - 2020/06/26 12:18:55 ET
Table 'Zone Poker ID 1645' 9-max Seat #3 is the button
Seat 1: UTG ($252.50 in chips) 
Seat 2: Hero ($520.88 in chips) 
Seat 3: Dealer ($507.50 in chips) 
Seat 4: Small Blind ($477.50 in chips) 
Seat 5: Big Blind ($330.83 in chips) 
Small Blind: posts small blind $2.50
Big Blind: posts big blind $5
*** HOLE CARDS ***
Dealt to Hero [Js As]
UTG: folds 
Hero: raises $7.50 to $12.50
Dealer: folds 
Small Blind: raises $32.50 to $45
Big Blind: folds 
Hero: calls $32.50
*** FLOP *** [Jh 8s Qd]
Small Blind: bets $24
Hero: calls $24
*** TURN *** [Jh 8s Qd] [Ah]
Small Blind: bets $75
Hero: calls $75
*** RIVER *** [Jh 8s Qd Ah] [Kc]
Small Blind: bets $95
Hero: calls $95
*** SHOW DOWN ***
Small Blind: shows [Th Ts] (a hand...)
Big Blind: shows [5s 6h] (a hand...)
Hero: shows [Js As] (a hand...)
Dealer: shows [Tc 8h] (a hand...)
UTG: shows [7c 2s] (a hand...)
Small Blind collected $480 from pot
*** SUMMARY ***
Total pot $483.00 | Rake $3.00
Board [Jh 8s Qd Ah Kc]
Seat 1: UTG folded
Seat 2: Hero showed [Js As] and lost with...
Seat 3: Dealer folded
Seat 4: Small Blind showed [Th Ts] and won ($480)
Seat 5: Big Blind folded



PokerStars Hand #3966371212:  Hold'em No Limit ($2.50/$5) - 2020/06/26 12:18:50 ET
Table 'Zone Poker ID 1645' 9-max Seat #2 is the button
Seat 1: Hero ($550.00 in chips) 
Seat 2: Dealer ($1766.39 in chips) 
Seat 3: Small Blind ($492.93 in chips) 
Seat 4: Big Blind ($500.00 in chips) 
Seat 5: UTG ($191.88 in chips) 
Small Blind: posts small blind $2.50
Big Blind: posts big blind $5
*** HOLE CARDS ***
Dealt to Hero [Qc Ac]
UTG: folds 
Hero: raises $7.50 to $12.50
Dealer: folds 
Small Blind: raises $37.50 to $50
Big Blind: folds 
Hero: calls $37.50
*** FLOP *** [6c 5h 8d]
Small Blind: checks 
Hero: checks 
*** TURN *** [6c 5h 8d] [3s]
Small Blind: bets $51
Hero: calls $51
*** RIVER *** [6c 5h 8d 3s] [Js]
Small Blind: bets $235
Hero: folds 
*** SHOW DOWN ***
Small Blind: shows [Ks Kc] (a hand...)
Big Blind: shows [3h Jd] (a hand...)
Hero: shows [Qc Ac] (a hand...)
Dealer: shows [9s Qh] (a hand...)
UTG: shows [7d 2h] (a hand...)
Uncalled bet ($235.00) returned to Small Blind
Small Blind collected $204 from pot
*** SUMMARY ***
Total pot $207.00 | Rake $3.00
Board [6c 5h 8d 3s Js]
Seat 1: Hero folded
Seat 2: Dealer folded
Seat 3: Small Blind collected ($204)
Seat 4: Big Blind folded
Seat 5: UTG folded



PokerStars Hand #3966370426:  Hold'em No Limit ($2.50/$5) - 2020/06/26 12:15:49 ET
Table 'Zone Poker ID 1645' 9-max Seat #2 is the button
Seat 1: UTG+1 ($639.40 in chips) 
Seat 2: Dealer ($1766.39 in chips) 
Seat 3: Small Blind ($1077.00 in chips) 
Seat 4: Big Blind ($318.70 in chips) 
Seat 5: Hero ($495.00 in chips) 
Small Blind: posts small blind $2.50
Big Blind: posts big blind $5
*** HOLE CARDS ***
Dealt to Hero [Kh Js]
Hero: raises $7.50 to $12.50
UTG+1: folds 
Dealer: folds 
Small Blind: folds 
Big Blind: calls $7.50
*** FLOP *** [3s Ac 2h]
Big Blind: checks 
Hero: checks 
*** TURN *** [3s Ac 2h] [Td]
Big Blind: checks 
Hero: checks 
*** RIVER *** [3s Ac 2h Td] [As]
Big Blind: bets $19.60
Hero: folds 
*** SHOW DOWN ***
Small Blind: shows [4s Ad] (a hand...)
Big Blind: shows [4h 8h] (a hand...)
Hero: shows [Kh Js] (a hand...)
Dealer: shows [Jh 8c] (a hand...)
UTG+1: shows [4d Qd] (a hand...)
Uncalled bet ($19.60) returned to Big Blind
Big Blind collected $26.13 from pot
*** SUMMARY ***
Total pot $27.50 | Rake $1.37
Board [3s Ac 2h Td As]
Seat 1: UTG+1 folded
Seat 2: Dealer folded
Seat 3: Small Blind folded
Seat 4: Big Blind collected ($26.13)
Seat 5: Hero folded



PokerStars Hand #3966369004:  Hold'em No Limit ($2.50/$5) - 2020/06/26 12:10:21 ET
Table 'Zone Poker ID 1645' 9-max Seat #5 is the button
Seat 1: Small Blind ($625.58 in chips) 
Seat 2: Hero ($550.86 in chips) 
Seat 3: UTG ($718.47 in chips) 
Seat 4: UTG+1 ($191.10 in chips) 
Seat 5: Dealer ($508.00 in chips) 
Small Blind: posts small blind $2.50
Hero: posts big blind $5
*** HOLE CARDS ***
Dealt to Hero [6c Qh]
UTG: folds 
UTG+1: folds 
Dealer: folds 
Small Blind: raises $10.00 to $15
Hero: calls $10
*** FLOP *** [8s 5d 3h]
Small Blind: checks 
Hero: checks 
*** TURN *** [8s 5d 3h] [Td]
Small Blind: checks 
Hero: checks 
*** RIVER *** [8s 5d 3h Td] [Ah]
Small Blind: bets $21.38
Hero: folds 
*** SHOW DOWN ***
Small Blind: shows [9h Ad] (a hand...)
Hero: shows [6c Qh] (a hand...)
Dealer: shows [3d Js] (a hand...)
UTG: shows [Ac 7d] (a hand...)
UTG+1: shows [Qd 7s] (a hand...)
Uncalled bet ($21.38) returned to Small Blind
Small Blind collected $28.50 from pot
*** SUMMARY ***
Total pot $30.00 | Rake $1.50
Board [8s 5d 3h Td Ah]
Seat 1: Small Blind collected ($28.50)
Seat 2: Hero folded
Seat 3: UTG folded
Seat 4: UTG+1 folded
Seat 5: Dealer folded



PokerStars Hand #3966368700:  Hold'em No Limit ($2.50/$5) - 2020/06/26 12:09:01 ET
Table 'Zone Poker ID 1645' 9-max Seat #4 is the button
Seat 1: Hero ($512.65 in chips) 
Seat 2: UTG ($624.74 in chips) 
Seat 3: UTG+1 ($510.00 in chips) 
Seat 4: Dealer ($235.00 in chips) 
Seat 5: Small Blind ($534.10 in chips) 
Small Blind: posts small blind $2.50
Hero: posts big blind $5
*** HOLE CARDS ***
Dealt to Hero [9h Td]
UTG: folds 
UTG+1: folds 
Dealer: folds 
Small Blind: raises $10.00 to $15
Hero: calls $10
*** FLOP *** [9s 8d 9c]
Small Blind: checks 
Hero: bets $9.25
Small Blind: raises $30.25 to $39.50
Hero: calls $30.25
*** TURN *** [9s 8d 9c] [6c]
Small Blind: checks 
Hero: checks 
*** RIVER *** [9s 8d 9c 6c] [5c]
Small Blind: bets $39.98
Hero: calls $39.98
*** SHOW DOWN ***
Small Blind: shows [9d Ah] (a hand...)
Hero: shows [9h Td] (a hand...)
Dealer: shows [Ks 4s] (a hand...)
UTG: shows [Ac 8s] (a hand...)
UTG+1: shows [Tc 6s] (a hand...)
Small Blind collected $185.96 from pot
*** SUMMARY ***
Total pot $188.96 | Rake $3.00
Board [9s 8d 9c 6c 5c]
Seat 1: Hero showed [9h Td] and lost with...
Seat 2: UTG folded
Seat 3: UTG+1 folded
Seat 4: Dealer folded
Seat 5: Small Blind showed [9d Ah] and won ($185.96)



PokerStars Hand #3966011955:  Hold'em No Limit ($2.50/$5) - 2020/06/25 18:00:07 ET
Table 'Zone Poker ID 1645' 9-max Seat #4 is the button
Seat 1: Hero ($627.24 in chips) 
Seat 2: UTG ($500.00 in chips) 
Seat 3: UTG+1 ($549.83 in chips) 
Seat 4: Dealer ($630.50 in chips) 
Seat 5: Small Blind ($599.92 in chips) 
Small Blind: posts small blind $2.50
Hero: posts big blind $5
*** HOLE CARDS ***
Dealt to Hero [Ad 4d]
UTG: folds 
UTG+1: folds 
Dealer: folds 
Small Blind: raises $10.00 to $15
Hero: raises $30 to $45
Small Blind: calls $30
*** FLOP *** [Js 5s Ac]
Small Blind: checks 
Hero: checks 
*** TURN *** [Js 5s Ac] [6h]
Small Blind: checks 
Hero: checks 
*** RIVER *** [Js 5s Ac 6h] [2h]
Small Blind: checks 
Hero: bets $43.50
Small Blind: raises $200.50 to $244
Hero: calls $200.50
*** SHOW DOWN ***
Small Blind: shows [Jh As] (a hand...)
Hero: shows [Ad 4d] (a hand...)
Dealer: shows [8h Ts] (a hand...)
UTG: shows [Tc 6c] (a hand...)
UTG+1: shows [9c 3s] (a hand...)
Small Blind collected $575 from pot
*** SUMMARY ***
Total pot $578.00 | Rake $3.00
Board [Js 5s Ac 6h 2h]
Seat 1: Hero showed [Ad 4d] and lost with...
Seat 2: UTG folded
Seat 3: UTG+1 folded
Seat 4: Dealer folded
Seat 5: Small Blind showed [Jh As] and won ($575)



PokerStars Hand #3966009513:  Hold'em No Limit ($2.50/$5) - 2020/06/25 17:54:02 ET
Table 'Zone Poker ID 1645' 9-max Seat #2 is the button
Seat 1: Hero ($464.70 in chips) 
Seat 2: Dealer ($1312.72 in chips) 
Seat 3: Small Blind ($455.98 in chips) 
Small Blind: posts small blind $2.50
Hero: posts big blind $5
*** HOLE CARDS ***
Dealt to Hero [4d Qd]
Dealer: folds 
Small Blind: raises $10.00 to $15
Hero: calls $10
*** FLOP *** [Jd 7c Ad]
Small Blind: bets $14.25
Hero: calls $14.25
*** TURN *** [Jd 7c Ad] [8s]
Small Blind: bets $42.38
Hero: calls $42.38
*** RIVER *** [Jd 7c Ad 8s] [8c]
Small Blind: bets $141.26
Hero: folds 
*** SHOW DOWN ***
Small Blind: shows [5h 6s] (a hand...)
Dealer: shows [6c Js] (a hand...)
Hero: shows [4d Qd] (a hand...)
Uncalled bet ($141.26) returned to Small Blind
Small Blind collected $141.26 from pot
*** SUMMARY ***
Total pot $143.26 | Rake $2.00
Board [Jd 7c Ad 8s 8c]
Seat 1: Hero folded
Seat 2: Dealer folded
Seat 3: Small Blind collected ($141.26)



PokerStars Hand #3966005532:  Hold'em No Limit ($2.50/$5) - 2020/06/25 17:43:53 ET
Table 'Zone Poker ID 1645' 9-max Seat #3 is the button
Seat 1: UTG ($608.20 in chips) 
Seat 2: UTG+1 ($623.30 in chips) 
Seat 3: Dealer ($473.25 in chips) 
Seat 4: Small Blind ($444.94 in chips) 
Seat 5: Hero ($505.00 in chips) 
Small Blind: posts small blind $2.50
Hero: posts big blind $5
*** HOLE CARDS ***
Dealt to Hero [9c Ad]
UTG: folds 
UTG+1: folds 
Dealer: raises $10 to $15
Small Blind: folds 
Hero: calls $10
*** FLOP *** [7s Kd 5h]
Hero: checks 
Dealer: checks 
*** TURN *** [7s Kd 5h] [2c]
Hero: checks 
Dealer: checks 
*** RIVER *** [7s Kd 5h 2c] [As]
Hero: checks 
Dealer: bets $23.16
Hero: calls $23.16
*** SHOW DOWN ***
Small Blind: shows [Tc 8h] (a hand...)
Hero: shows [9c Ad] (a hand...)
Dealer: shows [Qh Jh] (a hand...)
UTG: shows [Qc 6h] (a hand...)
UTG+1: shows [2s Td] (a hand...)
Hero collected $75.82 from pot
*** SUMMARY ***
Total pot $78.82 | Rake $3.00
Board [7s Kd 5h 2c As]
Seat 1: UTG folded
Seat 2: UTG+1 folded
Seat 3: Dealer showed [Qh Jh] and lost with...
Seat 4: Small Blind folded
Seat 5: Hero showed [9c Ad] and won ($75.82)



PokerStars Hand #3965998981:  Hold'em No Limit ($2.50/$5) - 2020/06/25 17:27:12 ET
Table 'Zone Poker ID 1645' 9-max Seat #5 is the button
Seat 1: Hero ($500.00 in chips) 
Seat 2: Big Blind ($998.01 in chips) 
Seat 3: UTG ($502.50 in chips) 
Seat 4: UTG+1 ($514.13 in chips) 
Seat 5: Dealer ($880.97 in chips) 
Hero: posts small blind $2.50
Big Blind: posts big blind $5
*** HOLE CARDS ***
Dealt to Hero [6c 5c]
UTG: folds 
UTG+1: folds 
Dealer: raises $7.50 to $12.50
Hero: raises $42.50 to $55
Big Blind: folds 
Dealer: calls $42.50
*** FLOP *** [7s Kh Js]
Hero: checks 
Dealer: checks 
*** TURN *** [7s Kh Js] [4h]
Hero: bets $72.04
Dealer: calls $72.04
*** RIVER *** [7s Kh Js 4h] [6s]
Hero: checks 
Dealer: bets $753.93 and is all-in
Hero: calls $372.96 and is all-in
*** SHOW DOWN ***
Big Blind: shows [2s Jd] (a hand...)
Hero: shows [6c 5c] (a hand...)
Dealer: shows [As 9s] (a hand...)
UTG: shows [Jc 4d] (a hand...)
UTG+1: shows [5h 3c] (a hand...)
Uncalled bet ($380.97) returned to Dealer
Dealer collected $1002 from pot
*** SUMMARY ***
Total pot $1005.00 | Rake $3.00
Board [7s Kh Js 4h 6s]
Seat 1: Hero showed [6c 5c] and lost with...
Seat 2: Big Blind folded
Seat 3: UTG folded
Seat 4: UTG+1 folded
Seat 5: Dealer showed [As 9s] and won ($1002)



PokerStars Hand #3965995601:  Hold'em No Limit ($2.50/$5) - 2020/06/25 17:18:03 ET
Table 'Zone Poker ID 1645' 9-max Seat #1 is the button
Seat 1: Dealer ($250.96 in chips) 
Seat 2: Small Blind ($500.00 in chips) 
Seat 3: Hero ($500.00 in chips) 
Small Blind: posts small blind $2.50
Hero: posts big blind $5
*** HOLE CARDS ***
Dealt to Hero [7s As]
Dealer: folds 
Small Blind: raises $5.00 to $10
Hero: calls $5
*** FLOP *** [2h 2c Ah]
Small Blind: bets $6.65
Hero: calls $6.65
*** TURN *** [2h 2c Ah] [Qh]
Small Blind: checks 
Hero: checks 
*** RIVER *** [2h 2c Ah Qh] [Tc]
Small Blind: bets $47.46
Hero: folds 
*** SHOW DOWN ***
Small Blind: shows [5s 4s] (a hand...)
Dealer: shows [Td 6c] (a hand...)
Hero: shows [7s As] (a hand...)
Uncalled bet ($47.46) returned to Small Blind
Small Blind collected $31.64 from pot
*** SUMMARY ***
Total pot $33.30 | Rake $1.66
Board [2h 2c Ah Qh Tc]
Seat 1: Dealer folded
Seat 2: Small Blind collected ($31.64)
Seat 3: Hero folded



PokerStars Hand #3965536529:  Hold'em No Limit ($2.50/$5) - 2020/06/24 17:28:34 ET
Table 'Zone Poker ID 1645' 9-max Seat #1 is the button
Seat 1: Hero ($933.89 in chips) 
Seat 2: Small Blind ($492.50 in chips) 
Seat 3: Big Blind ($1628.19 in chips) 
Seat 4: UTG ($500.00 in chips) 
Small Blind: posts small blind $2.50
Big Blind: posts big blind $5
*** HOLE CARDS ***
Dealt to Hero [Jc Js]
UTG: folds 
Hero: raises $7.50 to $12.50
Small Blind: folds 
Big Blind: raises $47.50 to $60
Hero: calls $47.50
*** FLOP *** [3h 8s 9d]
Big Blind: bets $59.75
Hero: calls $59.75
*** TURN *** [3h 8s 9d] [Kh]
Big Blind: checks 
Hero: checks 
*** RIVER *** [3h 8s 9d Kh] [Ks]
Big Blind: checks 
Hero: bets $142.50
Big Blind: raises $1365.94 to $1508.44 and is all-in
Hero: folds 
*** SHOW DOWN ***
Small Blind: shows [Ac 7h] (a hand...)
UTG: shows [6c 7s] (a hand...)
Big Blind: shows [Jd Kd] (a hand...)
Hero: shows [Jc Js] (a hand...)
Uncalled bet ($1365.94) returned to Big Blind
Big Blind collected $524 from pot
*** SUMMARY ***
Total pot $527.00 | Rake $3.00
Board [3h 8s 9d Kh Ks]
Seat 1: Hero folded
Seat 2: Small Blind folded
Seat 3: Big Blind collected ($524)
Seat 4: UTG folded



PokerStars Hand #3965536316:  Hold'em No Limit ($2.50/$5) - 2020/06/24 17:28:00 ET
Table 'Zone Poker ID 1645' 9-max Seat #3 is the button
Seat 1: Big Blind ($495.00 in chips) 
Seat 2: UTG ($515.81 in chips) 
Seat 3: Dealer ($583.63 in chips) 
Seat 4: Hero ($485.00 in chips) 
Hero: posts small blind $2.50
Big Blind: posts big blind $5
*** HOLE CARDS ***
Dealt to Hero [Ac Jc]
UTG: folds 
Dealer: raises $7.50 to $12.50
Hero: raises $40.00 to $52.50
Big Blind: folds 
Dealer: calls $40
*** FLOP *** [5c 6c 8h]
Hero: checks 
Dealer: bets $30.66
Hero: calls $30.66
*** TURN *** [5c 6c 8h] [4s]
Hero: checks 
Dealer: checks 
*** RIVER *** [5c 6c 8h 4s] [Qh]
Hero: bets $126.24
Dealer: raises $374.23 to $500.47 and is all-in
Hero: folds 
*** SHOW DOWN ***
UTG: shows [6s 4h] (a hand...)
Dealer: shows [9c 7c] (a hand...)
Big Blind: shows [Jh 7h] (a hand...)
Hero: shows [Ac Jc] (a hand...)
Uncalled bet ($374.23) returned to Dealer
Dealer collected $420.80 from pot
*** SUMMARY ***
Total pot $423.80 | Rake $3.00
Board [5c 6c 8h 4s Qh]
Seat 1: Big Blind folded
Seat 2: UTG folded
Seat 3: Dealer collected ($420.80)
Seat 4: Hero folded



PokerStars Hand #3965535114:  Hold'em No Limit ($2.50/$5) - 2020/06/24 17:24:53 ET
Table 'Zone Poker ID 1645' 9-max Seat #2 is the button
Seat 1: Hero ($1049.29 in chips) 
Seat 2: Dealer ($494.31 in chips) 
Seat 3: Small Blind ($933.76 in chips) 
Small Blind: posts small blind $2.50
Hero: posts big blind $5
*** HOLE CARDS ***
Dealt to Hero [8d 7h]
Dealer: raises $5 to $10
Small Blind: folds 
Hero: calls $5
*** FLOP *** [Jh 4s 7c]
Hero: checks 
Dealer: checks 
*** TURN *** [Jh 4s 7c] [9c]
Hero: checks 
Dealer: bets $15
Hero: calls $15
*** RIVER *** [Jh 4s 7c 9c] [2s]
Hero: checks 
Dealer: bets $39.40
Hero: folds 
*** SHOW DOWN ***
Small Blind: shows [Qd 5h] (a hand...)
Dealer: shows [Qs Td] (a hand...)
Hero: shows [8d 7h] (a hand...)
Uncalled bet ($39.40) returned to Dealer
Dealer collected $50.50 from pot
*** SUMMARY ***
Total pot $52.50 | Rake $2.00
Board [Jh 4s 7c 9c 2s]
Seat 1: Hero folded
Seat 2: Dealer collected ($50.50)
Seat 3: Small Blind folded



PokerStars Hand #3965531906:  Hold'em No Limit ($2.50/$5) - 2020/06/24 17:15:58 ET
Table 'Zone Poker ID 1645' 9-max Seat #1 is the button
Seat 1: Dealer ($181.44 in chips) 
Seat 2: Hero ($876.41 in chips) 
Seat 3: Big Blind ($542.50 in chips) 
Hero: posts small blind $2.50
Big Blind: posts big blind $5
*** HOLE CARDS ***
Dealt to Hero [Qs Jh]
Dealer: folds 
Hero: raises $10.00 to $15
Big Blind: calls $10
*** FLOP *** [8h Jd Ac]
Hero: bets $8.55
Big Blind: calls $8.55
*** TURN *** [8h Jd Ac] [5s]
Hero: checks 
Big Blind: bets $15.55
Hero: calls $15.55
*** RIVER *** [8h Jd Ac 5s] [As]
Hero: checks 
Big Blind: bets $117
Hero: calls $117
*** SHOW DOWN ***
Dealer: shows [6c 3d] (a hand...)
Big Blind: shows [Tc 2c] (a hand...)
Hero: shows [Qs Jh] (a hand...)
Hero collected $310.20 from pot
*** SUMMARY ***
Total pot $312.20 | Rake $2.00
Board [8h Jd Ac 5s As]
Seat 1: Dealer folded
Seat 2: Hero showed [Qs Jh] and won ($310.20)
Seat 3: Big Blind showed [Tc 2c] and lost with...



PokerStars Hand #3965530495:  Hold'em No Limit ($2.50/$5) - 2020/06/24 17:11:58 ET
Table 'Zone Poker ID 1645' 9-max Seat #2 is the button
Seat 1: Hero ($478.79 in chips) 
Seat 2: Dealer ($344.12 in chips) 
Seat 3: Small Blind ($502.50 in chips) 
Small Blind: posts small blind $2.50
Hero: posts big blind $5
*** HOLE CARDS ***
Dealt to Hero [9c Jc]
Dealer: folds 
Small Blind: raises $10.00 to $15
Hero: raises $30 to $45
Small Blind: calls $30
*** FLOP *** [6h Tc Jd]
Small Blind: checks 
Hero: checks 
*** TURN *** [6h Tc Jd] [4s]
Small Blind: bets $90
Hero: calls $90
*** RIVER *** [6h Tc Jd 4s] [5c]
Small Blind: bets $367.50 and is all-in
Hero: calls $343.79 and is all-in
*** SHOW DOWN ***
Small Blind: shows [Kd Qc] (a hand...)
Dealer: shows [8s 5d] (a hand...)
Hero: shows [9c Jc] (a hand...)
Uncalled bet ($23.71) returned to Small Blind
Hero collected $955.58 from pot
*** SUMMARY ***
Total pot $957.58 | Rake $2.00
Board [6h Tc Jd 4s 5c]
Seat 1: Hero showed [9c Jc] and won ($955.58)
Seat 2: Dealer folded
Seat 3: Small Blind showed [Kd Qc] and lost with...



PokerStars Hand #3965465838:  Hold'em No Limit ($2.50/$5) - 2020/06/24 13:45:02 ET
Table 'Zone Poker ID 1645' 9-max Seat #2 is the button
Seat 1: Hero ($512.25 in chips) 
Seat 2: Dealer ($794.30 in chips) 
Seat 3: Small Blind ($517.25 in chips) 
Small Blind: posts small blind $2.50
Hero: posts big blind $5
*** HOLE CARDS ***
Dealt to Hero [3s 8c]
Dealer: calls $5
Small Blind: folds 
Hero: checks 
*** FLOP *** [7d 9h 5s]
Hero: checks 
Dealer: bets $5.80
Hero: raises $11.74 to $17.54
Dealer: calls $11.74
*** TURN *** [7d 9h 5s] [3h]
Hero: checks 
Dealer: checks 
*** RIVER *** [7d 9h 5s 3h] [Qd]
Hero: checks 
Dealer: bets $60.58
Hero: folds 
*** SHOW DOWN ***
Small Blind: shows [7s 6h] (a hand...)
Dealer: shows [Jh Qh] (a hand...)
Hero: shows [3s 8c] (a hand...)
Uncalled bet ($60.58) returned to Dealer
Dealer collected $45.58 from pot
*** SUMMARY ***
Total pot $47.58 | Rake $2.00
Board [7d 9h 5s 3h Qd]
Seat 1: Hero folded
Seat 2: Dealer collected ($45.58)
Seat 3: Small Blind folded



PokerStars Hand #3965464748:  Hold'em No Limit ($2.50/$5) - 2020/06/24 13:41:02 ET
Table 'Zone Poker ID 1645' 9-max Seat #3 is the button
Seat 1: Hero ($502.50 in chips) 
Seat 2: Big Blind ($955.58 in chips) 
Seat 3: Dealer ($605.04 in chips) 
Hero: posts small blind $2.50
Big Blind: posts big blind $5
*** HOLE CARDS ***
Dealt to Hero [7d Ks]
Dealer: folds 
Hero: raises $10.00 to $15
Big Blind: calls $10
*** FLOP *** [Qd 5d 4d]
Hero: checks 
Big Blind: bets $10
Hero: raises $24.25 to $34.25
Big Blind: calls $24.25
*** TURN *** [Qd 5d 4d] [5h]
Hero: bets $72.38
Big Blind: calls $72.38
*** RIVER *** [Qd 5d 4d 5h] [Kh]
Hero: checks 
Big Blind: bets $241.26
Hero: calls $241.26
*** SHOW DOWN ***
Dealer: shows [9c Jd] (a hand...)
Big Blind: shows [Ad 9d] (a hand...)
Hero: shows [7d Ks] (a hand...)
Big Blind collected $723.78 from pot
*** SUMMARY ***
Total pot $725.78 | Rake $2.00
Board [Qd 5d 4d 5h Kh]
Seat 1: Hero showed [7d Ks] and lost with...
Seat 2: Big Blind showed [Ad 9d] and won ($723.78)
Seat 3: Dealer folded



PokerStars Hand #3965464231:  Hold'em No Limit ($2.50/$5) - 2020/06/24 13:39:06 ET
Table 'Zone Poker ID 1645' 9-max Seat #2 is the button
Seat 1: Hero ($690.60 in chips) 
Seat 2: Dealer ($519.07 in chips) 
Seat 3: Small Blind ($338.75 in chips) 
Small Blind: posts small blind $2.50
Hero: posts big blind $5
*** HOLE CARDS ***
Dealt to Hero [3c Kd]
Dealer: folds 
Small Blind: calls $2.50
Hero: checks 
*** FLOP *** [7h Ks 9s]
Small Blind: bets $9.50
Hero: calls $9.50
*** TURN *** [7h Ks 9s] [8s]
Small Blind: bets $13.78
Hero: calls $13.78
*** RIVER *** [7h Ks 9s 8s] [Tc]
Small Blind: bets $54.56
Hero: folds 
*** SHOW DOWN ***
Small Blind: shows [2s 4s] (a hand...)
Dealer: shows [9h 5c] (a hand...)
Hero: shows [3c Kd] (a hand...)
Uncalled bet ($54.56) returned to Small Blind
Small Blind collected $54.56 from pot
*** SUMMARY ***
Total pot $56.56 | Rake $2.00
Board [7h Ks 9s 8s Tc]
Seat 1: Hero folded
Seat 2: Dealer folded
Seat 3: Small Blind collected ($54.56)



PokerStars Hand #3965462467:  Hold'em No Limit ($2.50/$5) - 2020/06/24 13:32:29 ET
Table 'Zone Poker ID 1645' 9-max Seat #3 is the button
Seat 1: Small Blind ($599.05 in chips) 
Seat 2: Big Blind ($507.86 in chips) 
Seat 3: Hero ($618.63 in chips) 
Small Blind: posts small blind $2.50
Big Blind: posts big blind $5
*** HOLE CARDS ***
Dealt to Hero [Ad Ah]
Hero: raises $7.50 to $12.50
Small Blind: calls $10
Big Blind: folds 
*** FLOP *** [3h Ts 3s]
Small Blind: checks 
Hero: bets $20
Small Blind: calls $20
*** TURN *** [3h Ts 3s] [Th]
Small Blind: checks 
Hero: checks 
*** RIVER *** [3h Ts 3s Th] [6d]
Small Blind: bets $45
Hero: calls $45
*** SHOW DOWN ***
Small Blind: shows [As 4s] (a hand...)
Big Blind: shows [3d Jc] (a hand...)
Hero: shows [Ad Ah] (a hand...)
Hero collected $158 from pot
*** SUMMARY ***
Total pot $160.00 | Rake $2.00
Board [3h Ts 3s Th 6d]
Seat 1: Small Blind showed [As 4s] and lost with...
Seat 2: Big Blind folded
Seat 3: Hero showed [Ad Ah] and won ($158)



PokerStars Hand #3965461786:  Hold'em No Limit ($2.50/$5) - 2020/06/24 13:29:52 ET
Table 'Zone Poker ID 1645' 9-max Seat #3 is the button
Seat 1: Small Blind ($550.04 in chips) 
Seat 2: Hero ($576.18 in chips) 
Seat 3: Dealer ($948.46 in chips) 
Small Blind: posts small blind $2.50
Hero: posts big blind $5
*** HOLE CARDS ***
Dealt to Hero [5h 5s]
Dealer: folds 
Small Blind: calls $2.50
Hero: raises $15 to $20
Small Blind: calls $15
*** FLOP *** [4c 9d Qs]
Small Blind: checks 
Hero: bets $11.40
Small Blind: calls $11.40
*** TURN *** [4c 9d Qs] [9h]
Small Blind: checks 
Hero: checks 
*** RIVER *** [4c 9d Qs 9h] [2c]
Small Blind: bets $75.80
Hero: calls $75.80
*** SHOW DOWN ***
Small Blind: shows [6c 9c] (a hand...)
Dealer: shows [8d Kd] (a hand...)
Hero: shows [5h 5s] (a hand...)
Small Blind collected $212.40 from pot
*** SUMMARY ***
Total pot $214.40 | Rake $2.00
Board [4c 9d Qs 9h 2c]
Seat 1: Small Blind showed [6c 9c] and won ($212.40)
Seat 2: Hero showed [5h 5s] and lost with...
Seat 3: Dealer folded



PokerStars Hand #3965461756:  Hold'em No Limit ($2.50/$5) - 2020/06/24 13:29:46 ET
Table 'Zone Poker ID 1645' 9-max Seat #3 is the button
Seat 1: Small Blind ($552.54 in chips) 
Seat 2: Hero ($548.38 in chips) 
Seat 3: Dealer ($651.23 in chips) 
Small Blind: posts small blind $2.50
Hero: posts big blind $5
*** HOLE CARDS ***
Dealt to Hero [Kc 8h]
Dealer: calls $5
Small Blind: folds 
Hero: checks 
*** FLOP *** [7s 3d Ah]
Hero: checks 
Dealer: checks 
*** TURN *** [7s 3d Ah] [9c]
Hero: checks 
Dealer: bets $5
Hero: calls $5
*** RIVER *** [7s 3d Ah 9c] [Ad]
Hero: checks 
Dealer: bets $11
Hero: calls $11
*** SHOW DOWN ***
Small Blind: shows [6d 4c] (a hand...)
Dealer: shows [8s 5s] (a hand...)
Hero: shows [Kc 8h] (a hand...)
Hero collected $42.50 from pot
*** SUMMARY ***
Total pot $44.50 | Rake $2.00
Board [7s 3d Ah 9c Ad]
Seat 1: Small Blind folded
Seat 2: Hero showed [Kc 8h] and won ($42.50)
Seat 3: Dealer showed [8s 5s] and lost with...



PokerStars Hand #3965460101:  Hold'em No Limit ($2.50/$5) - 2020/06/24 13:23:33 ET
Table 'Zone Poker ID 1645' 9-max Seat #2 is the button
Seat 1: Big Blind ($376.88 in chips) 
Seat 2: Hero ($487.87 in chips) 
Seat 3: Small Blind ($594.70 in chips) 
Small Blind: posts small blind $2.50
Big Blind: posts big blind $5
*** HOLE CARDS ***
Dealt to Hero [8c Tc]
Hero: raises $7.50 to $12.50
Small Blind: raises $45.00 to $57.50
Big Blind: folds 
Hero: calls $45
*** FLOP *** [Qs Jh 8h]
Small Blind: checks 
Hero: checks 
*** TURN *** [Qs Jh 8h] [4s]
Small Blind: bets $88.50
Hero: calls $88.50
*** RIVER *** [Qs Jh 8h 4s] [4d]
Small Blind: bets $448.70 and is all-in
Hero: folds 
*** SHOW DOWN ***
Small Blind: shows [Kd Kh] (a hand...)
Big Blind: shows [4h Ad] (a hand...)
Hero: shows [8c Tc] (a hand...)
Uncalled bet ($448.70) returned to Small Blind
Small Blind collected $295 from pot
*** SUMMARY ***
Total pot $297.00 | Rake $2.00
Board [Qs Jh 8h 4s 4d]
Seat 1: Big Blind folded
Seat 2: Hero folded
Seat 3: Small Blind collected ($295)



PokerStars Hand #3965457169:  Hold'em No Limit ($2.50/$5) - 2020/06/24 13:12:46 ET
Table 'Zone Poker ID 1645' 9-max Seat #2 is the button
Seat 1: Big Blind ($526.26 in chips) 
Seat 2: Dealer ($519.65 in chips) 
Seat 3: Hero ($433.60 in chips) 
Hero: posts small blind $2.50
Big Blind: posts big blind $5
*** HOLE CARDS ***
Dealt to Hero [Qc As]
Dealer: folds 
Hero: raises $10.00 to $15
Big Blind: raises $30 to $45
Hero: calls $30
*** FLOP *** [3h Jc Jh]
Hero: checks 
Big Blind: checks 
*** TURN *** [3h Jc Jh] [9h]
Hero: checks 
Big Blind: bets $60
Hero: calls $60
*** RIVER *** [3h Jc Jh 9h] [2c]
Hero: checks 
Big Blind: bets $421.26 and is all-in
Hero: folds 
*** SHOW DOWN ***
Dealer: shows [Js 5h] (a hand...)
Big Blind: shows [Qh Ah] (a hand...)
Hero: shows [Qc As] (a hand...)
Uncalled bet ($421.26) returned to Big Blind
Big Blind collected $208 from pot
*** SUMMARY ***
Total pot $210.00 | Rake $2.00
Board [3h Jc Jh 9h 2c]
Seat 1: Big Blind collected ($208)
Seat 2: Dealer folded
Seat 3: Hero folded



PokerStars Hand #3965040065:  Hold'em No Limit ($2.50/$5) - 2020/06/23 15:26:34 ET
Table 'Zone Poker ID 1612' 9-max Seat #3 is the button
Seat 1: Hero ($475.68 in chips) 
Seat 2: UTG ($478.39 in chips) 
Seat 3: Dealer ($667.82 in chips) 
Seat 4: Small Blind ($638.01 in chips) 
Small Blind: posts small blind $2.50
Hero: posts big blind $5
*** HOLE CARDS ***
Dealt to Hero [2s Ac]
UTG: folds 
Dealer: raises $7.50 to $12.50
Small Blind: folds 
Hero: calls $7.50
*** FLOP *** [Tc Ah 2h]
Hero: checks 
Dealer: bets $18.07
Hero: calls $18.07
*** TURN *** [Tc Ah 2h] [6c]
Hero: checks 
Dealer: bets $45.48
Hero: calls $45.48
*** RIVER *** [Tc Ah 2h 6c] [4c]
Hero: checks 
Dealer: bets $75.80
Hero: calls $75.80
*** SHOW DOWN ***
Small Blind: shows [9d Ks] (a hand...)
UTG: shows [Js 3d] (a hand...)
Dealer: shows [2c As] (a hand...)
Hero: shows [2s Ac] (a hand...)
Hero collected $151.60 from pot
Dealer collected $151.60 from pot
*** SUMMARY ***
Total pot $306.20 | Rake $3.00
Board [Tc Ah 2h 6c 4c]
Seat 1: Hero showed [2s Ac] and won ($151.60)
Seat 2: UTG folded
Seat 3: Dealer showed [2c As] and won ($151.60)
Seat 4: Small Blind folded



PokerStars Hand #3965038081:  Hold'em No Limit ($2.50/$5) - 2020/06/23 15:20:36 ET
Table 'Zone Poker ID 1612' 9-max Seat #3 is the button
Seat 1: Big Blind ($1116.64 in chips) 
Seat 2: UTG ($836.49 in chips) 
Seat 3: Hero ($639.82 in chips) 
Seat 4: Small Blind ($414.60 in chips) 
Small Blind: posts small blind $2.50
Big Blind: posts big blind $5
*** HOLE CARDS ***
Dealt to Hero [Qd Qs]
UTG: folds 
Hero: raises $7.50 to $12.50
Small Blind: calls $10
Big Blind: folds 
*** FLOP *** [Kd 4s 9h]
Small Blind: checks 
Hero: checks 
*** TURN *** [Kd 4s 9h] [9d]
Small Blind: bets $28.50
Hero: calls $28.50
*** RIVER *** [Kd 4s 9h 9d] [8c]
Small Blind: bets $84
Hero: folds 
*** SHOW DOWN ***
Small Blind: shows [Ah 9c] (a hand...)
UTG: shows [Qh 8s] (a hand...)
Big Blind: shows [8d 2c] (a hand...)
Hero: shows [Qd Qs] (a hand...)
Uncalled bet ($84.00) returned to Small Blind
Small Blind collected $84 from pot
*** SUMMARY ***
Total pot $87.00 | Rake $3.00
Board [Kd 4s 9h 9d 8c]
Seat 1: Big Blind folded
Seat 2: UTG folded
Seat 3: Hero folded
Seat 4: Small Blind collected ($84)



PokerStars Hand #3965037394:  Hold'em No Limit ($2.50/$5) - 2020/06/23 15:18:35 ET
Table 'Zone Poker ID 1612' 9-max Seat #2 is the button
Seat 1: Hero ($664.82 in chips) 
Seat 2: Dealer ($501.75 in chips) 
Seat 3: Small Blind ($82.58 in chips) 
Small Blind: posts small blind $2.50
Hero: posts big blind $5
*** HOLE CARDS ***
Dealt to Hero [7h 6d]
Dealer: raises $5 to $10
Small Blind: folds 
Hero: calls $5
*** FLOP *** [As Qc Kc]
Hero: checks 
Dealer: checks 
*** TURN *** [As Qc Kc] [5s]
Hero: checks 
Dealer: checks 
*** RIVER *** [As Qc Kc 5s] [9s]
Hero: checks 
Dealer: bets $16.04
Hero: folds 
*** SHOW DOWN ***
Small Blind: shows [2h Kd] (a hand...)
Dealer: shows [9h Qs] (a hand...)
Hero: shows [7h 6d] (a hand...)
Uncalled bet ($16.04) returned to Dealer
Dealer collected $21.38 from pot
*** SUMMARY ***
Total pot $22.50 | Rake $1.12
Board [As Qc Kc 5s 9s]
Seat 1: Hero folded
Seat 2: Dealer collected ($21.38)
Seat 3: Small Blind folded



PokerStars Hand #3965036567:  Hold'em No Limit ($2.50/$5) - 2020/06/23 15:16:11 ET
Table 'Zone Poker ID 1612' 9-max Seat #1 is the button
Seat 1: Hero ($1166.37 in chips) 
Seat 2: Small Blind ($834.14 in chips) 
Seat 3: Big Blind ($146.75 in chips) 
Small Blind: posts small blind $2.50
Big Blind: posts big blind $5
*** HOLE CARDS ***
Dealt to Hero [7s 5s]
Hero: raises $7.50 to $12.50
Small Blind: raises $37.50 to $50
Big Blind: folds 
Hero: calls $37.50
*** FLOP *** [2s 7d Js]
Small Blind: bets $51.50
Hero: raises $80.75 to $132.25
Small Blind: calls $80.75
*** TURN *** [2s 7d Js] [6d]
Small Blind: checks 
Hero: checks 
*** RIVER *** [2s 7d Js 6d] [4d]
Small Blind: bets $120
Hero: calls $120
*** SHOW DOWN ***
Small Blind: shows [Jh Ac] (a hand...)
Big Blind: shows [8s 9s] (a hand...)
Hero: shows [7s 5s] (a hand...)
Small Blind collected $607.50 from pot
*** SUMMARY ***
Total pot $609.50 | Rake $2.00
Board [2s 7d Js 6d 4d]
Seat 1: Hero showed [7s 5s] and lost with...
Seat 2: Small Blind showed [Jh Ac] and won ($607.50)
Seat 3: Big Blind folded



PokerStars Hand #3965032549:  Hold'em No Limit ($2.50/$5) - 2020/06/23 15:03:40 ET
Table 'Zone Poker ID 1612' 9-max Seat #2 is the button
Seat 1: Big Blind ($650.93 in chips) 
Seat 2: Dealer ($337.57 in chips) 
Seat 3: Hero ($565.70 in chips) 
Hero: posts small blind $2.50
Big Blind: posts big blind $5
*** HOLE CARDS ***
Dealt to Hero [6d 4d]
Dealer: folds 
Hero: raises $10.00 to $15
Big Blind: calls $10
*** FLOP *** [9d 7d 8d]
Hero: checks 
Big Blind: bets $10
Hero: calls $10
*** TURN *** [9d 7d 8d] [7s]
Hero: checks 
Big Blind: bets $36
Hero: calls $36
*** RIVER *** [9d 7d 8d 7s] [As]
Hero: checks 
Big Blind: bets $160
Hero: calls $160
*** SHOW DOWN ***
Dealer: shows [5c 8s] (a hand...)
Big Blind: shows [3d Qd] (a hand...)
Hero: shows [6d 4d] (a hand...)
Big Blind collected $440 from pot
*** SUMMARY ***
Total pot $442.00 | Rake $2.00
Board [9d 7d 8d 7s As]
Seat 1: Big Blind showed [3d Qd] and won ($440)
Seat 2: Dealer folded
Seat 3: Hero showed [6d 4d] and lost with...



PokerStars Hand #3965028792:  Hold'em No Limit ($2.50/$5) - 2020/06/23 14:51:40 ET
Table 'Zone Poker ID 1612' 9-max Seat #1 is the button
Seat 1: Dealer ($635.27 in chips) 
Seat 2: Hero ($500.00 in chips) 
Seat 3: Big Blind ($583.24 in chips) 
Hero: posts small blind $2.50
Big Blind: posts big blind $5
*** HOLE CARDS ***
Dealt to Hero [Kh Qc]
Dealer: folds 
Hero: raises $10.00 to $15
Big Blind: calls $10
*** FLOP *** [Ts 7d Ah]
Hero: checks 
Big Blind: bets $10
Hero: calls $10
*** TURN *** [Ts 7d Ah] [2c]
Hero: checks 
Big Blind: checks 
*** RIVER *** [Ts 7d Ah 2c] [As]
Hero: checks 
Big Blind: bets $15
Hero: folds 
*** SHOW DOWN ***
Dealer: shows [8h Qs] (a hand...)
Big Blind: shows [9d Ac] (a hand...)
Hero: shows [Kh Qc] (a hand...)
Uncalled bet ($15.00) returned to Big Blind
Big Blind collected $48 from pot
*** SUMMARY ***
Total pot $50.00 | Rake $2.00
Board [Ts 7d Ah 2c As]
Seat 1: Dealer folded
Seat 2: Hero folded
Seat 3: Big Blind collected ($48)



PokerStars Hand #3963622296:  Hold'em No Limit ($2.50/$5) - 2020/06/20 13:24:28 ET
Table 'Zone Poker ID 1612' 9-max Seat #2 is the button
Seat 1: Big Blind ($482.50 in chips) 
Seat 2: Hero ($731.30 in chips) 
Seat 3: Small Blind ($629.19 in chips) 
Small Blind: posts small blind $2.50
Big Blind: posts big blind $5
*** HOLE CARDS ***
Dealt to Hero [9s 9h]
Hero: raises $7.50 to $12.50
Small Blind: raises $42.50 to $55
Big Blind: folds 
Hero: calls $42.50
*** FLOP *** [Jh 4h 7h]
Small Blind: bets $20
Hero: calls $20
*** TURN *** [Jh 4h 7h] [5c]
Small Blind: bets $76.50
Hero: calls $76.50
*** RIVER *** [Jh 4h 7h 5c] [Qc]
Small Blind: bets $30
Hero: calls $30
*** SHOW DOWN ***
Small Blind: shows [Qs Kh] (a hand...)
Big Blind: shows [Th 8s] (a hand...)
Hero: shows [9s 9h] (a hand...)
Small Blind collected $366 from pot
*** SUMMARY ***
Total pot $368.00 | Rake $2.00
Board [Jh 4h 7h 5c Qc]
Seat 1: Big Blind folded
Seat 2: Hero showed [9s 9h] and lost with...
Seat 3: Small Blind showed [Qs Kh] and won ($366)



PokerStars Hand #3963621179:  Hold'em No Limit ($2.50/$5) - 2020/06/20 13:20:43 ET
Table 'Zone Poker ID 1612' 9-max Seat #1 is the button
Seat 1: Dealer ($579.06 in chips) 
Seat 2: Hero ($870.50 in chips) 
Seat 3: Big Blind ($1332.65 in chips) 
Hero: posts small blind $2.50
Big Blind: posts big blind $5
*** HOLE CARDS ***
Dealt to Hero [3h Ah]
Dealer: folds 
Hero: raises $10.00 to $15
Big Blind: calls $10
*** FLOP *** [5s Tc 4h]
Hero: bets $8.55
Big Blind: raises $22.80 to $31.35
Hero: calls $22.80
*** TURN *** [5s Tc 4h] [Th]
Hero: checks 
Big Blind: bets $45.35
Hero: calls $45.35
*** RIVER *** [5s Tc 4h Th] [8s]
Hero: checks 
Big Blind: bets $121.05
Hero: folds 
*** SHOW DOWN ***
Dealer: shows [6c Ks] (a hand...)
Big Blind: shows [Jc Ts] (a hand...)
Hero: shows [3h Ah] (a hand...)
Uncalled bet ($121.05) returned to Big Blind
Big Blind collected $181.40 from pot
*** SUMMARY ***
Total pot $183.40 | Rake $2.00
Board [5s Tc 4h Th 8s]
Seat 1: Dealer folded
Seat 2: Hero folded
Seat 3: Big Blind collected ($181.40)



PokerStars Hand #3963619080:  Hold'em No Limit ($2.50/$5) - 2020/06/20 13:13:38 ET
Table 'Zone Poker ID 1612' 9-max Seat #3 is the button
Seat 1: Small Blind ($526.41 in chips) 
Seat 2: Big Blind ($500.00 in chips) 
Seat 3: Hero ($572.02 in chips) 
Small Blind: posts small blind $2.50
Big Blind: posts big blind $5
*** HOLE CARDS ***
Dealt to Hero [9d Kd]
Hero: raises $7.50 to $12.50
Small Blind: folds 
Big Blind: calls $7.50
*** FLOP *** [Ah Jc 9s]
Big Blind: checks 
Hero: checks 
*** TURN *** [Ah Jc 9s] [2s]
Big Blind: bets $15
Hero: calls $15
*** RIVER *** [Ah Jc 9s 2s] [3d]
Big Blind: bets $25
Hero: folds 
*** SHOW DOWN ***
Small Blind: shows [9c 3h] (a hand...)
Big Blind: shows [7c 7s] (a hand...)
Hero: shows [9d Kd] (a hand...)
Uncalled bet ($25.00) returned to Big Blind
Big Blind collected $55.50 from pot
*** SUMMARY ***
Total pot $57.50 | Rake $2.00
Board [Ah Jc 9s 2s 3d]
Seat 1: Small Blind folded
Seat 2: Big Blind collected ($55.50)
Seat 3: Hero folded



PokerStars Hand #3963461802:  Hold'em No Limit ($2.50/$5) - 2020/06/20 01:50:33 ET
Table 'Zone Poker ID 1612' 9-max Seat #3 is the button
Seat 1: Hero ($1499.21 in chips) 
Seat 2: UTG ($950.14 in chips) 
Seat 3: Dealer ($526.78 in chips) 
Seat 4: Small Blind ($522.51 in chips) 
Small Blind: posts small blind $2.50
Hero: posts big blind $5
*** HOLE CARDS ***
Dealt to Hero [As 8c]
UTG: folds 
Dealer: folds 
Small Blind: raises $10.00 to $15
Hero: calls $10
*** FLOP *** [4h 6c Qh]
Small Blind: checks 
Hero: checks 
*** TURN *** [4h 6c Qh] [4s]
Small Blind: checks 
Hero: checks 
*** RIVER *** [4h 6c Qh 4s] [Ts]
Small Blind: bets $21.38
Hero: folds 
*** SHOW DOWN ***
Small Blind: shows [Th 9s] (a hand...)
UTG: shows [7d Qs] (a hand...)
Dealer: shows [6h Tc] (a hand...)
Hero: shows [As 8c] (a hand...)
Uncalled bet ($21.38) returned to Small Blind
Small Blind collected $28.50 from pot
*** SUMMARY ***
Total pot $30.00 | Rake $1.50
Board [4h 6c Qh 4s Ts]
Seat 1: Hero folded
Seat 2: UTG folded
Seat 3: Dealer folded
Seat 4: Small Blind collected ($28.50)



PokerStars Hand #3963460781:  Hold'em No Limit ($2.50/$5) - 2020/06/20 01:48:18 ET
Table 'Zone Poker ID 1612' 9-max Seat #2 is the button
Seat 1: UTG ($992.00 in chips) 
Seat 2: Dealer ($950.14 in chips) 
Seat 3: Hero ($1732.77 in chips) 
Seat 4: Big Blind ($243.43 in chips) 
Hero: posts small blind $2.50
Big Blind: posts big blind $5
*** HOLE CARDS ***
Dealt to Hero [Jd 3d]
UTG: folds 
Dealer: folds 
Hero: raises $10.00 to $15
Big Blind: calls $10
*** FLOP *** [Ts Td 9d]
Hero: bets $9.25
Big Blind: calls $9.25
*** TURN *** [Ts Td 9d] [Js]
Hero: checks 
Big Blind: bets $23.04
Hero: calls $23.04
*** RIVER *** [Ts Td 9d Js] [Ah]
Hero: checks 
Big Blind: bets $106.58
Hero: folds 
*** SHOW DOWN ***
UTG: shows [Jc 2s] (a hand...)
Dealer: shows [Jh 7c] (a hand...)
Big Blind: shows [8s 6h] (a hand...)
Hero: shows [Jd 3d] (a hand...)
Uncalled bet ($106.58) returned to Big Blind
Big Blind collected $91.58 from pot
*** SUMMARY ***
Total pot $94.58 | Rake $3.00
Board [Ts Td 9d Js Ah]
Seat 1: UTG folded
Seat 2: Dealer folded
Seat 3: Hero folded
Seat 4: Big Blind collected ($91.58)



PokerStars Hand #3963457388:  Hold'em No Limit ($2.50/$5) - 2020/06/20 01:40:47 ET
Table 'Zone Poker ID 1612' 9-max Seat #2 is the button
Seat 1: Hero ($1888.19 in chips) 
Seat 2: Dealer ($608.41 in chips) 
Seat 3: Small Blind ($2291.02 in chips) 
Small Blind: posts small blind $2.50
Hero: posts big blind $5
*** HOLE CARDS ***
Dealt to Hero [9c 9d]
Dealer: folds 
Small Blind: calls $2.50
Hero: raises $15 to $20
Small Blind: calls $15
*** FLOP *** [8h Th 7s]
Small Blind: checks 
Hero: bets $27
Small Blind: calls $27
*** TURN *** [8h Th 7s] [4h]
Small Blind: checks 
Hero: checks 
*** RIVER *** [8h Th 7s 4h] [Qs]
Small Blind: bets $97
Hero: folds 
*** SHOW DOWN ***
Small Blind: shows [7c 8d] (a hand...)
Dealer: shows [6s 2d] (a hand...)
Hero: shows [9c 9d] (a hand...)
Uncalled bet ($97.00) returned to Small Blind
Small Blind collected $92 from pot
*** SUMMARY ***
Total pot $94.00 | Rake $2.00
Board [8h Th 7s 4h Qs]
Seat 1: Hero folded
Seat 2: Dealer folded
Seat 3: Small Blind collected ($92)



PokerStars Hand #3963456899:  Hold'em No Limit ($2.50/$5) - 2020/06/20 01:39:44 ET
Table 'Zone Poker ID 1612' 9-max Seat #2 is the button
Seat 1: Big Blind ($528.50 in chips) 
Seat 2: Dealer ($608.41 in chips) 
Seat 3: Hero ($1881.69 in chips) 
Hero: posts small blind $2.50
Big Blind: posts big blind $5
*** HOLE CARDS ***
Dealt to Hero [8c Qs]
Dealer: folds 
Hero: raises $10.00 to $15
Big Blind: calls $10
*** FLOP *** [Qd 7h Jc]
Hero: checks 
Big Blind: checks 
*** TURN *** [Qd 7h Jc] [5h]
Hero: bets $20
Big Blind: calls $20
*** RIVER *** [Qd 7h Jc 5h] [7c]
Hero: checks 
Big Blind: bets $34
Hero: calls $34
*** SHOW DOWN ***
Dealer: shows [Td 3c] (a hand...)
Big Blind: shows [6c Qc] (a hand...)
Hero: shows [8c Qs] (a hand...)
Big Blind collected $68 from pot
Hero collected $68 from pot
*** SUMMARY ***
Total pot $138.00 | Rake $2.00
Board [Qd 7h Jc 5h 7c]
Seat 1: Big Blind showed [6c Qc] and won ($68)
Seat 2: Dealer folded
Seat 3: Hero showed [8c Qs] and won ($68)



PokerStars Hand #3963452381:  Hold'em No Limit ($2.50/$5) - 2020/06/20 01:30:15 ET
Table 'Zone Poker ID 1612' 9-max Seat #1 is the button
Seat 1: Dealer ($500.00 in chips) 
Seat 2: Small Blind ($743.01 in chips) 
Seat 3: Big Blind ($741.71 in chips) 
Seat 4: UTG ($1048.43 in chips) 
Seat 5: Hero ($2000.62 in chips) 
Small Blind: posts small blind $2.50
Big Blind: posts big blind $5
*** HOLE CARDS ***
Dealt to Hero [Ac Qs]
UTG: folds 
Hero: raises $7.50 to $12.50
Dealer: folds 
Small Blind: folds 
Big Blind: calls $7.50
*** FLOP *** [7s Kd 4h]
Big Blind: checks 
Hero: bets $7.84
Big Blind: calls $7.84
*** TURN *** [7s Kd 4h] [2h]
Big Blind: checks 
Hero: checks 
*** RIVER *** [7s Kd 4h 2h] [5h]
Big Blind: bets $41.03
Hero: folds 
*** SHOW DOWN ***
Small Blind: shows [6d As] (a hand...)
Big Blind: shows [7c 7h] (a hand...)
Hero: shows [Ac Qs] (a hand...)
Dealer: shows [Jc Kh] (a hand...)
UTG: shows [3h 9c] (a hand...)
Uncalled bet ($41.03) returned to Big Blind
Big Blind collected $41.03 from pot
*** SUMMARY ***
Total pot $43.18 | Rake $2.15
Board [7s Kd 4h 2h 5h]
Seat 1: Dealer folded
Seat 2: Small Blind folded
Seat 3: Big Blind collected ($41.03)
Seat 4: UTG folded
Seat 5: Hero folded



PokerStars Hand #3963451051:  Hold'em No Limit ($2.50/$5) - 2020/06/20 01:27:25 ET
Table 'Zone Poker ID 1612' 9-max Seat #4 is the button
Seat 1: Hero ($1791.61 in chips) 
Seat 2: UTG ($552.98 in chips) 
Seat 3: UTG+1 ($1120.31 in chips) 
Seat 4: Dealer ($493.70 in chips) 
Seat 5: Small Blind ($730.98 in chips) 
Small Blind: posts small blind $2.50
Hero: posts big blind $5
*** HOLE CARDS ***
Dealt to Hero [4s 6s]
UTG: raises $7.50 to $12.50
UTG+1: folds 
Dealer: folds 
Small Blind: folds 
Hero: calls $7.50
*** FLOP *** [8s Js 2s]
Hero: checks 
UTG: bets $8.07
Hero: calls $8.07
*** TURN *** [8s Js 2s] [3d]
Hero: checks 
UTG: bets $31.10
Hero: calls $31.10
*** RIVER *** [8s Js 2s 3d] [7h]
Hero: checks 
UTG: bets $152.84
Hero: calls $152.84
*** SHOW DOWN ***
Small Blind: shows [2d Jc] (a hand...)
Hero: shows [4s 6s] (a hand...)
Dealer: shows [Ks 8d] (a hand...)
UTG: shows [8c 8h] (a hand...)
UTG+1: shows [Ac 7s] (a hand...)
Hero collected $408.52 from pot
*** SUMMARY ***
Total pot $411.52 | Rake $3.00
Board [8s Js 2s 3d 7h]
Seat 1: Hero showed [4s 6s] and won ($408.52)
Seat 2: UTG showed [8c 8h] and lost with...
Seat 3: UTG+1 folded
Seat 4: Dealer folded
Seat 5: Small Blind folded



PokerStars Hand #3963449394:  Hold'em No Limit ($2.50/$5) - 2020/06/20 01:24:06 ET
Table 'Zone Poker ID 1612' 9-max Seat #4 is the button
Seat 1: Hero ($943.84 in chips) 
Seat 2: UTG ($1987.48 in chips) 
Seat 3: UTG+1 ($111.91 in chips) 
Seat 4: Dealer ($95.99 in chips) 
Seat 5: Small Blind ($489.28 in chips) 
Small Blind: posts small blind $2.50
Hero: posts big blind $5
*** HOLE CARDS ***
Dealt to Hero [Kc 4c]
UTG: folds 
UTG+1: folds 
Dealer: raises $5 to $10
Small Blind: folds 
Hero: calls $5
*** FLOP *** [6c 7c 6h]
Hero: checks 
Dealer: checks 
*** TURN *** [6c 7c 6h] [Qs]
Hero: checks 
Dealer: bets $10.69
Hero: calls $10.69
*** RIVER *** [6c 7c 6h Qs] [Ks]
Hero: checks 
Dealer: bets $75.30 and is all-in
Hero: calls $75.30
*** SHOW DOWN ***
Small Blind: shows [2s Jd] (a hand...)
Hero: shows [Kc 4c] (a hand...)
Dealer: shows [As Ad] (a hand...)
UTG: shows [7h Qc] (a hand...)
UTG+1: shows [5s Js] (a hand...)
Dealer collected $191.48 from pot
*** SUMMARY ***
Total pot $194.48 | Rake $3.00
Board [6c 7c 6h Qs Ks]
Seat 1: Hero showed [Kc 4c] and lost with...
Seat 2: UTG folded
Seat 3: UTG+1 folded
Seat 4: Dealer showed [As Ad] and won ($191.48)
Seat 5: Small Blind folded



PokerStars Hand #3963446476:  Hold'em No Limit ($2.50/$5) - 2020/06/20 01:18:18 ET
Table 'Zone Poker ID 1612' 9-max Seat #2 is the button
Seat 1: UTG+2 ($531.66 in chips) 
Seat 2: Hero ($868.79 in chips) 
Seat 3: Small Blind ($351.41 in chips) 
Seat 4: Big Blind ($1210.71 in chips) 
Seat 5: UTG ($1080.91 in chips) 
Seat 6: UTG+1 ($444.19 in chips) 
Small Blind: posts small blind $2.50
Big Blind: posts big blind $5
*** HOLE CARDS ***
Dealt to Hero [7h Ah]
UTG: raises $6.25 to $11.25
UTG+1: calls $11.25
UTG+2: folds 
Hero: calls $11.25
Small Blind: folds 
Big Blind: folds 
*** FLOP *** [5d 9s Js]
UTG: checks 
UTG+1: checks 
Hero: checks 
*** TURN *** [5d 9s Js] [Jc]
UTG: checks 
UTG+1: checks 
Hero: checks 
*** RIVER *** [5d 9s Js Jc] [3s]
UTG: checks 
UTG+1: bets $39.19
Hero: folds 
UTG: folds 
*** SHOW DOWN ***
Small Blind: shows [6h Kh] (a hand...)
Big Blind: shows [6d 9c] (a hand...)
Hero: shows [7h Ah] (a hand...)
UTG+2: shows [4c 5s] (a hand...)
UTG: shows [As Kd] (a hand...)
UTG+1: shows [4s Ks] (a hand...)
Uncalled bet ($39.19) returned to UTG+1
UTG+1 collected $39.19 from pot
*** SUMMARY ***
Total pot $41.25 | Rake $2.06
Board [5d 9s Js Jc 3s]
Seat 1: UTG+2 folded
Seat 2: Hero folded
Seat 3: Small Blind folded
Seat 4: Big Blind folded
Seat 5: UTG folded
Seat 6: UTG+1 collected ($39.19)



PokerStars Hand #3963444582:  Hold'em No Limit ($2.50/$5) - 2020/06/20 01:14:35 ET
Table 'Zone Poker ID 1612' 9-max Seat #1 is the button
Seat 1: Dealer ($554.92 in chips) 
Seat 2: Hero ($1144.62 in chips) 
Seat 3: Big Blind ($1070.91 in chips) 
Seat 4: UTG ($2026.35 in chips) 
Seat 5: UTG+1 ($399.59 in chips) 
Seat 6: UTG+2 ($519.56 in chips) 
Hero: posts small blind $2.50
Big Blind: posts big blind $5
*** HOLE CARDS ***
Dealt to Hero [Ad Td]
UTG: folds 
UTG+1: raises $10 to $15
UTG+2: folds 
Dealer: folds 
Hero: calls $12.50
Big Blind: folds 
*** FLOP *** [3s 5s 4c]
Hero: checks 
UTG+1: checks 
*** TURN *** [3s 5s 4c] [Ac]
Hero: checks 
UTG+1: bets $16.63
Hero: calls $16.63
*** RIVER *** [3s 5s 4c Ac] [5h]
Hero: checks 
UTG+1: bets $32.43
Hero: calls $32.43
*** SHOW DOWN ***
Big Blind: shows [7h 2s] (a hand...)
Hero: shows [Ad Td] (a hand...)
Dealer: shows [6s 8c] (a hand...)
UTG+2: shows [8h 2h] (a hand...)
UTG: shows [7s 4h] (a hand...)
UTG+1: shows [Ah 8d] (a hand...)
Hero collected $129.12 from pot
*** SUMMARY ***
Total pot $133.12 | Rake $4.00
Board [3s 5s 4c Ac 5h]
Seat 1: Dealer folded
Seat 2: Hero showed [Ad Td] and won ($129.12)
Seat 3: Big Blind folded
Seat 4: UTG folded
Seat 5: UTG+1 showed [Ah 8d] and lost with...
Seat 6: UTG+2 folded



PokerStars Hand #3963440403:  Hold'em No Limit ($2.50/$5) - 2020/06/20 01:06:13 ET
Table 'Zone Poker ID 1612' 9-max Seat #1 is the button
Seat 1: Dealer ($495.00 in chips) 
Seat 2: Small Blind ($502.50 in chips) 
Seat 3: Big Blind ($1071.53 in chips) 
Seat 4: Hero ($687.23 in chips) 
Seat 5: UTG+1 ($403.91 in chips) 
Small Blind: posts small blind $2.50
Big Blind: posts big blind $5
*** HOLE CARDS ***
Dealt to Hero [Qc Qh]
Hero: raises $7.50 to $12.50
UTG+1: folds 
Dealer: folds 
Small Blind: calls $10
Big Blind: folds 
*** FLOP *** [9d 5h 2c]
Small Blind: bets $14.25
Hero: raises $28.50 to $42.75
Small Blind: calls $28.50
*** TURN *** [9d 5h 2c] [4h]
Small Blind: bets $56.25
Hero: raises $112.50 to $168.75
Small Blind: calls $112.50
*** RIVER *** [9d 5h 2c 4h] [Ac]
Small Blind: bets $278.50 and is all-in
Hero: calls $278.50
*** SHOW DOWN ***
Small Blind: shows [8d 9h] (a hand...)
Big Blind: shows [8h 5s] (a hand...)
Hero: shows [Qc Qh] (a hand...)
Dealer: shows [Kh Jd] (a hand...)
UTG+1: shows [7h 6d] (a hand...)
Hero collected $1007 from pot
*** SUMMARY ***
Total pot $1010.00 | Rake $3.00
Board [9d 5h 2c 4h Ac]
Seat 1: Dealer folded
Seat 2: Small Blind showed [8d 9h] and lost with...
Seat 3: Big Blind folded
Seat 4: Hero showed [Qc Qh] and won ($1007)
Seat 5: UTG+1 folded



PokerStars Hand #3963435448:  Hold'em No Limit ($2.50/$5) - 2020/06/20 00:56:36 ET
Table 'Zone Poker ID 1612' 9-max Seat #5 is the button
Seat 1: Small Blind ($504.38 in chips) 
Seat 2: Big Blind ($757.39 in chips) 
Seat 3: UTG ($413.53 in chips) 
Seat 4: Hero ($482.50 in chips) 
Seat 5: Dealer ($564.75 in chips) 
Small Blind: posts small blind $2.50
Big Blind: posts big blind $5
*** HOLE CARDS ***
Dealt to Hero [Tc Ts]
UTG: folds 
Hero: raises $7.50 to $12.50
Dealer: folds 
Small Blind: raises $42.50 to $55
Big Blind: folds 
Hero: calls $42.50
*** FLOP *** [Kh 7h Jh]
Small Blind: checks 
Hero: checks 
*** TURN *** [Kh 7h Jh] [2c]
Small Blind: checks 
Hero: checks 
*** RIVER *** [Kh 7h Jh 2c] [4h]
Small Blind: bets $84
Hero: folds 
*** SHOW DOWN ***
Small Blind: shows [Ad Qd] (a hand...)
Big Blind: shows [8h 5d] (a hand...)
Hero: shows [Tc Ts] (a hand...)
Dealer: shows [2d 9d] (a hand...)
UTG: shows [5h Jc] (a hand...)
Uncalled bet ($84.00) returned to Small Blind
Small Blind collected $112 from pot
*** SUMMARY ***
Total pot $115.00 | Rake $3.00
Board [Kh 7h Jh 2c 4h]
Seat 1: Small Blind collected ($112)
Seat 2: Big Blind folded
Seat 3: UTG folded
Seat 4: Hero folded
Seat 5: Dealer folded



PokerStars Hand #3963435111:  Hold'em No Limit ($2.50/$5) - 2020/06/20 00:55:56 ET
Table 'Zone Poker ID 1612' 9-max Seat #2 is the button
Seat 1: Hero ($664.58 in chips) 
Seat 2: Dealer ($1013.75 in chips) 
Seat 3: Small Blind ($190.83 in chips) 
Seat 4: Big Blind ($569.37 in chips) 
Seat 5: UTG ($662.60 in chips) 
Small Blind: posts small blind $2.50
Big Blind: posts big blind $5
*** HOLE CARDS ***
Dealt to Hero [Jd Ah]
UTG: folds 
Hero: raises $7.50 to $12.50
Dealer: raises $27.50 to $40
Small Blind: folds 
Big Blind: folds 
Hero: calls $27.50
*** FLOP *** [Ts Ad 5h]
Hero: checks 
Dealer: bets $27.25
Hero: calls $27.25
*** TURN *** [Ts Ad 5h] [3d]
Hero: checks 
Dealer: bets $109.25
Hero: calls $109.25
*** RIVER *** [Ts Ad 5h 3d] [Ac]
Hero: checks 
Dealer: bets $837.25 and is all-in
Hero: calls $488.08 and is all-in
*** SHOW DOWN ***
Small Blind: shows [8c 7h] (a hand...)
Big Blind: shows [7c Qc] (a hand...)
Hero: shows [Jd Ah] (a hand...)
Dealer: shows [Qd As] (a hand...)
UTG: shows [Kc 7s] (a hand...)
Uncalled bet ($349.17) returned to Dealer
Dealer collected $1333.66 from pot
*** SUMMARY ***
Total pot $1336.66 | Rake $3.00
Board [Ts Ad 5h 3d Ac]
Seat 1: Hero showed [Jd Ah] and lost with...
Seat 2: Dealer showed [Qd As] and won ($1333.66)
Seat 3: Small Blind folded
Seat 4: Big Blind folded
Seat 5: UTG folded



PokerStars Hand #3963432904:  Hold'em No Limit ($2.50/$5) - 2020/06/20 00:51:40 ET
Table 'Zone Poker ID 1612' 9-max Seat #1 is the button
Seat 1: Dealer ($571.85 in chips) 
Seat 2: Small Blind ($1608.54 in chips) 
Seat 3: Hero ($553.50 in chips) 
Seat 4: UTG ($428.86 in chips) 
Seat 5: UTG+1 ($1045.25 in chips) 
Small Blind: posts small blind $2.50
Hero: posts big blind $5
*** HOLE CARDS ***
Dealt to Hero [6s 4d]
UTG: folds 
UTG+1: folds 
Dealer: folds 
Small Blind: raises $10.00 to $15
Hero: calls $10
*** FLOP *** [9h 6c Th]
Small Blind: checks 
Hero: checks 
*** TURN *** [9h 6c Th] [4s]
Small Blind: bets $9.25
Hero: calls $9.25
*** RIVER *** [9h 6c Th 4s] [Qc]
Small Blind: bets $91.08
Hero: calls $91.08
*** SHOW DOWN ***
Small Blind: shows [5c As] (a hand...)
Hero: shows [6s 4d] (a hand...)
Dealer: shows [7d 8c] (a hand...)
UTG: shows [Kh 2s] (a hand...)
UTG+1: shows [8h Jc] (a hand...)
Hero collected $227.66 from pot
*** SUMMARY ***
Total pot $230.66 | Rake $3.00
Board [9h 6c Th 4s Qc]
Seat 1: Dealer folded
Seat 2: Small Blind showed [5c As] and lost with...
Seat 3: Hero showed [6s 4d] and won ($227.66)
Seat 4: UTG folded
Seat 5: UTG+1 folded



PokerStars Hand #3963420430:  Hold'em No Limit ($2.50/$5) - 2020/06/20 00:27:16 ET
Table 'Zone Poker ID 1612' 9-max Seat #2 is the button
Seat 1: Hero ($688.31 in chips) 
Seat 2: Dealer ($601.13 in chips) 
Seat 3: Small Blind ($563.99 in chips) 
Seat 4: Big Blind ($701.03 in chips) 
Seat 5: UTG ($1226.22 in chips) 
Small Blind: posts small blind $2.50
Big Blind: posts big blind $5
*** HOLE CARDS ***
Dealt to Hero [9c As]
UTG: folds 
Hero: raises $7.50 to $12.50
Dealer: folds 
Small Blind: calls $10
Big Blind: folds 
*** FLOP *** [Tc Kh 2c]
Small Blind: checks 
Hero: bets $20
Small Blind: calls $20
*** TURN *** [Tc Kh 2c] [Td]
Small Blind: checks 
Hero: checks 
*** RIVER *** [Tc Kh 2c Td] [4d]
Small Blind: bets $50.25
Hero: folds 
*** SHOW DOWN ***
Small Blind: shows [Th 9h] (a hand...)
Big Blind: shows [6c Js] (a hand...)
Hero: shows [9c As] (a hand...)
Dealer: shows [Jd Ks] (a hand...)
UTG: shows [Ad 7h] (a hand...)
Uncalled bet ($50.25) returned to Small Blind
Small Blind collected $67 from pot
*** SUMMARY ***
Total pot $70.00 | Rake $3.00
Board [Tc Kh 2c Td 4d]
Seat 1: Hero folded
Seat 2: Dealer folded
Seat 3: Small Blind collected ($67)
Seat 4: Big Blind folded
Seat 5: UTG folded



PokerStars Hand #3963420390:  Hold'em No Limit ($2.50/$5) - 2020/06/20 00:27:12 ET
Table 'Zone Poker ID 1612' 9-max Seat #1 is the button
Seat 1: Hero ($1084.02 in chips) 
Seat 2: Small Blind ($1228.72 in chips) 
Seat 3: Big Blind ($500.00 in chips) 
Seat 4: UTG ($701.03 in chips) 
Seat 5: UTG+1 ($512.50 in chips) 
Small Blind: posts small blind $2.50
Big Blind: posts big blind $5
*** HOLE CARDS ***
Dealt to Hero [6d Jd]
UTG: folds 
UTG+1: folds 
Hero: raises $7.50 to $12.50
Small Blind: folds 
Big Blind: calls $7.50
*** FLOP *** [6h Tc 9d]
Big Blind: checks 
Hero: checks 
*** TURN *** [6h Tc 9d] [9s]
Big Blind: bets $41
Hero: calls $41
*** RIVER *** [6h Tc 9d 9s] [8c]
Big Blind: bets $37
Hero: folds 
*** SHOW DOWN ***
Small Blind: shows [Th 5c] (a hand...)
Big Blind: shows [Kh 9c] (a hand...)
Hero: shows [6d Jd] (a hand...)
UTG: shows [2s 7s] (a hand...)
UTG+1: shows [3d 4c] (a hand...)
Uncalled bet ($37.00) returned to Big Blind
Big Blind collected $106.50 from pot
*** SUMMARY ***
Total pot $109.50 | Rake $3.00
Board [6h Tc 9d 9s 8c]
Seat 1: Hero folded
Seat 2: Small Blind folded
Seat 3: Big Blind collected ($106.50)
Seat 4: UTG folded
Seat 5: UTG+1 folded



PokerStars Hand #3963417689:  Hold'em No Limit ($2.50/$5) - 2020/06/20 00:21:51 ET
Table 'Zone Poker ID 1612' 9-max Seat #1 is the button
Seat 1: Dealer ($492.50 in chips) 
Seat 2: Small Blind ($2091.70 in chips) 
Seat 3: Big Blind ($300.00 in chips) 
Seat 4: Hero ($773.31 in chips) 
Seat 5: UTG+1 ($500.00 in chips) 
Small Blind: posts small blind $2.50
Big Blind: posts big blind $5
*** HOLE CARDS ***
Dealt to Hero [Qd 9d]
Hero: raises $7.50 to $12.50
UTG+1: calls $12.50
Dealer: folds 
Small Blind: folds 
Big Blind: folds 
*** FLOP *** [3h Ah Qs]
Hero: checks 
UTG+1: checks 
*** TURN *** [3h Ah Qs] [7h]
Hero: checks 
UTG+1: checks 
*** RIVER *** [3h Ah Qs 7h] [7c]
Hero: checks 
UTG+1: bets $10
Hero: calls $10
*** SHOW DOWN ***
Small Blind: shows [6d 2d] (a hand...)
Big Blind: shows [Tc 8s] (a hand...)
Hero: shows [Qd 9d] (a hand...)
Dealer: shows [5d 6s] (a hand...)
UTG+1: shows [8d Ad] (a hand...)
UTG+1 collected $49.88 from pot
*** SUMMARY ***
Total pot $52.50 | Rake $2.62
Board [3h Ah Qs 7h 7c]
Seat 1: Dealer folded
Seat 2: Small Blind folded
Seat 3: Big Blind folded
Seat 4: Hero showed [Qd 9d] and lost with...
Seat 5: UTG+1 showed [8d Ad] and won ($49.88)



PokerStars Hand #3963414347:  Hold'em No Limit ($2.50/$5) - 2020/06/20 00:15:24 ET
Table 'Zone Poker ID 1612' 9-max Seat #4 is the button
Seat 1: Hero ($650.29 in chips) 
Seat 2: UTG ($696.00 in chips) 
Seat 3: UTG+1 ($429.22 in chips) 
Seat 4: Dealer ($487.50 in chips) 
Seat 5: Small Blind ($1320.73 in chips) 
Small Blind: posts small blind $2.50
Hero: posts big blind $5
*** HOLE CARDS ***
Dealt to Hero [Qs 4s]
UTG: folds 
UTG+1: folds 
Dealer: folds 
Small Blind: calls $2.50
Hero: checks 
*** FLOP *** [Qc 5h Th]
Small Blind: bets $5
Hero: calls $5
*** TURN *** [Qc 5h Th] [5s]
Small Blind: bets $12.50
Hero: calls $12.50
*** RIVER *** [Qc 5h Th 5s] [6c]
Small Blind: bets $52.75
Hero: calls $52.75
*** SHOW DOWN ***
Small Blind: shows [8c 7c] (a hand...)
Hero: shows [Qs 4s] (a hand...)
Dealer: shows [3s Ah] (a hand...)
UTG: shows [7h 2c] (a hand...)
UTG+1: shows [9c 4h] (a hand...)
Hero collected $147.50 from pot
*** SUMMARY ***
Total pot $150.50 | Rake $3.00
Board [Qc 5h Th 5s 6c]
Seat 1: Hero showed [Qs 4s] and won ($147.50)
Seat 2: UTG folded
Seat 3: UTG+1 folded
Seat 4: Dealer folded
Seat 5: Small Blind showed [8c 7c] and lost with...



PokerStars Hand #3963409717:  Hold'em No Limit ($2.50/$5) - 2020/06/20 00:06:28 ET
Table 'Zone Poker ID 1612' 9-max Seat #2 is the button
Seat 1: Hero ($485.00 in chips) 
Seat 2: Dealer ($268.99 in chips) 
Seat 3: Small Blind ($425.39 in chips) 
Seat 4: Big Blind ($700.74 in chips) 
Seat 5: UTG ($419.37 in chips) 
Small Blind: posts small blind $2.50
Big Blind: posts big blind $5
*** HOLE CARDS ***
Dealt to Hero [8d 6d]
UTG: folds 
Hero: raises $7.50 to $12.50
Dealer: folds 
Small Blind: folds 
Big Blind: calls $7.50
*** FLOP *** [9s 8h 4h]
Big Blind: checks 
Hero: checks 
*** TURN *** [9s 8h 4h] [Jc]
Big Blind: bets $15
Hero: calls $15
*** RIVER *** [9s 8h 4h Jc] [3d]
Big Blind: bets $40
Hero: folds 
*** SHOW DOWN ***
Small Blind: shows [Kh 7d] (a hand...)
Big Blind: shows [Th As] (a hand...)
Hero: shows [8d 6d] (a hand...)
Dealer: shows [Ac 5d] (a hand...)
UTG: shows [4d 9d] (a hand...)
Uncalled bet ($40.00) returned to Big Blind
Big Blind collected $54.63 from pot
*** SUMMARY ***
Total pot $57.50 | Rake $2.87
Board [9s 8h 4h Jc 3d]
Seat 1: Hero folded
Seat 2: Dealer folded
Seat 3: Small Blind folded
Seat 4: Big Blind collected ($54.63)
Seat 5: UTG folded



PokerStars Hand #3963408957:  Hold'em No Limit ($2.50/$5) - 2020/06/20 00:05:00 ET
Table 'Zone Poker ID 1612' 9-max Seat #3 is the button
Seat 1: Hero ($482.50 in chips) 
Seat 2: UTG ($1113.73 in chips) 
Seat 3: Dealer ($389.11 in chips) 
Seat 4: Small Blind ($1447.68 in chips) 
Small Blind: posts small blind $2.50
Hero: posts big blind $5
*** HOLE CARDS ***
Dealt to Hero [Kd Td]
UTG: folds 
Dealer: raises $10 to $15
Small Blind: folds 
Hero: raises $45 to $60
Dealer: calls $45
*** FLOP *** [7h 5h 5s]
Hero: bets $65
Dealer: calls $65
*** TURN *** [7h 5h 5s] [Qh]
Hero: checks 
Dealer: checks 
*** RIVER *** [7h 5h 5s Qh] [Ah]
Hero: bets $187.13
Dealer: raises $76.98 to $264.11 and is all-in
Hero: folds 
*** SHOW DOWN ***
Small Blind: shows [3h 8d] (a hand...)
UTG: shows [4d 2c] (a hand...)
Dealer: shows [Ad Ac] (a hand...)
Hero: shows [Kd Td] (a hand...)
Uncalled bet ($76.98) returned to Dealer
Dealer collected $623.76 from pot
*** SUMMARY ***
Total pot $626.76 | Rake $3.00
Board [7h 5h 5s Qh Ah]
Seat 1: Hero folded
Seat 2: UTG folded
Seat 3: Dealer collected ($623.76)
Seat 4: Small Blind folded



PokerStars Hand #3963166072:  Hold'em No Limit ($2.50/$5) - 2020/06/19 14:52:45 ET
Table 'Zone Poker ID 1612' 9-max Seat #1 is the button
Seat 1: Dealer ($2358.34 in chips) 
Seat 2: Hero ($479.43 in chips) 
Seat 3: Big Blind ($574.68 in chips) 
Hero: posts small blind $2.50
Big Blind: posts big blind $5
*** HOLE CARDS ***
Dealt to Hero [9d Qs]
Dealer: folds 
Hero: raises $10.00 to $15
Big Blind: calls $10
*** FLOP *** [Tc 8d Qd]
Hero: checks 
Big Blind: checks 
*** TURN *** [Tc 8d Qd] [5h]
Hero: checks 
Big Blind: checks 
*** RIVER *** [Tc 8d Qd 5h] [Ah]
Hero: checks 
Big Blind: bets $16.38
Hero: folds 
*** SHOW DOWN ***
Dealer: shows [3c 7s] (a hand...)
Big Blind: shows [6s Kd] (a hand...)
Hero: shows [9d Qs] (a hand...)
Uncalled bet ($16.38) returned to Big Blind
Big Blind collected $28.50 from pot
*** SUMMARY ***
Total pot $30.00 | Rake $1.50
Board [Tc 8d Qd 5h Ah]
Seat 1: Dealer folded
Seat 2: Hero folded
Seat 3: Big Blind collected ($28.50)



PokerStars Hand #3963156332:  Hold'em No Limit ($2.50/$5) - 2020/06/19 14:22:30 ET
Table 'Zone Poker ID 1612' 9-max Seat #2 is the button
Seat 1: Hero ($1021.19 in chips) 
Seat 2: Dealer ($335.18 in chips) 
Seat 3: Small Blind ($497.50 in chips) 
Small Blind: posts small blind $2.50
Hero: posts big blind $5
*** HOLE CARDS ***
Dealt to Hero [8d Kd]
Dealer: raises $10 to $15
Small Blind: folds 
Hero: calls $10
*** FLOP *** [2c Th 4d]
Hero: checks 
Dealer: checks 
*** TURN *** [2c Th 4d] [Td]
Hero: bets $20
Dealer: calls $20
*** RIVER *** [2c Th 4d Td] [Qc]
Hero: bets $52.88
Dealer: raises $247.30 to $300.18 and is all-in
Hero: folds 
*** SHOW DOWN ***
Small Blind: shows [4h Qd] (a hand...)
Dealer: shows [Ah Qh] (a hand...)
Hero: shows [8d Kd] (a hand...)
Uncalled bet ($247.30) returned to Dealer
Dealer collected $176.26 from pot
*** SUMMARY ***
Total pot $178.26 | Rake $2.00
Board [2c Th 4d Td Qc]
Seat 1: Hero folded
Seat 2: Dealer collected ($176.26)
Seat 3: Small Blind folded



PokerStars Hand #3963155147:  Hold'em No Limit ($2.50/$5) - 2020/06/19 14:18:30 ET
Table 'Zone Poker ID 1612' 9-max Seat #2 is the button
Seat 1: Big Blind ($306.85 in chips) 
Seat 2: Hero ($492.50 in chips) 
Seat 3: Small Blind ($1532.55 in chips) 
Small Blind: posts small blind $2.50
Big Blind: posts big blind $5
*** HOLE CARDS ***
Dealt to Hero [Ks 9s]
Hero: raises $7.50 to $12.50
Small Blind: calls $10
Big Blind: calls $7.50
*** FLOP *** [9d Td 6s]
Small Blind: checks 
Big Blind: checks 
Hero: checks 
*** TURN *** [9d Td 6s] [Qs]
Small Blind: checks 
Big Blind: checks 
Hero: checks 
*** RIVER *** [9d Td 6s Qs] [Qd]
Small Blind: bets $17.82
Big Blind: calls $17.82
Hero: folds 
*** SHOW DOWN ***
Small Blind: shows [Kh Jd] (a hand...)
Big Blind: shows [9h Jc] (a hand...)
Hero: shows [Ks 9s] (a hand...)
Small Blind collected $71.14 from pot
*** SUMMARY ***
Total pot $73.14 | Rake $2.00
Board [9d Td 6s Qs Qd]
Seat 1: Big Blind showed [9h Jc] and lost with...
Seat 2: Hero folded
Seat 3: Small Blind showed [Kh Jd] and won ($71.14)



PokerStars Hand #3963153702:  Hold'em No Limit ($2.50/$5) - 2020/06/19 14:13:55 ET
Table 'Zone Poker ID 1612' 9-max Seat #4 is the button
Seat 1: Small Blind ($495.00 in chips) 
Seat 2: Big Blind ($789.29 in chips) 
Seat 3: UTG ($718.76 in chips) 
Seat 4: Hero ($647.88 in chips) 
Small Blind: posts small blind $2.50
Big Blind: posts big blind $5
*** HOLE CARDS ***
Dealt to Hero [5d Ad]
UTG: folds 
Hero: raises $7.50 to $12.50
Small Blind: folds 
Big Blind: calls $7.50
*** FLOP *** [8d 5h Qh]
Big Blind: checks 
Hero: bets $20
Big Blind: calls $20
*** TURN *** [8d 5h Qh] [Qc]
Big Blind: checks 
Hero: checks 
*** RIVER *** [8d 5h Qh Qc] [Qd]
Big Blind: bets $135
Hero: calls $135
*** SHOW DOWN ***
Small Blind: shows [Ah 4s] (a hand...)
UTG: shows [Th 8s] (a hand...)
Big Blind: shows [Qs Jc] (a hand...)
Hero: shows [5d Ad] (a hand...)
Big Blind collected $334.50 from pot
*** SUMMARY ***
Total pot $337.50 | Rake $3.00
Board [8d 5h Qh Qc Qd]
Seat 1: Small Blind folded
Seat 2: Big Blind showed [Qs Jc] and won ($334.50)
Seat 3: UTG folded
Seat 4: Hero showed [5d Ad] and lost with...



PokerStars Hand #3963151584:  Hold'em No Limit ($2.50/$5) - 2020/06/19 14:07:12 ET
Table 'Zone Poker ID 1612' 9-max Seat #2 is the button
Seat 1: Big Blind ($297.50 in chips) 
Seat 2: Dealer ($668.01 in chips) 
Seat 3: Hero ($744.45 in chips) 
Hero: posts small blind $2.50
Big Blind: posts big blind $5
*** HOLE CARDS ***
Dealt to Hero [6d 6h]
Dealer: folds 
Hero: raises $10.00 to $15
Big Blind: calls $10
*** FLOP *** [4d 9c 7s]
Hero: bets $8.55
Big Blind: calls $8.55
*** TURN *** [4d 9c 7s] [8h]
Hero: checks 
Big Blind: checks 
*** RIVER *** [4d 9c 7s 8h] [7d]
Hero: checks 
Big Blind: bets $45.10
Hero: calls $45.10
*** SHOW DOWN ***
Dealer: shows [5h Jc] (a hand...)
Big Blind: shows [Qs 7c] (a hand...)
Hero: shows [6d 6h] (a hand...)
Big Blind collected $135.30 from pot
*** SUMMARY ***
Total pot $137.30 | Rake $2.00
Board [4d 9c 7s 8h 7d]
Seat 1: Big Blind showed [Qs 7c] and won ($135.30)
Seat 2: Dealer folded
Seat 3: Hero showed [6d 6h] and lost with...



PokerStars Hand #3963148967:  Hold'em No Limit ($2.50/$5) - 2020/06/19 13:58:55 ET
Table 'Zone Poker ID 1612' 9-max Seat #3 is the button
Seat 1: Big Blind ($680.77 in chips) 
Seat 2: UTG ($751.97 in chips) 
Seat 3: Hero ($703.44 in chips) 
Seat 4: Small Blind ($530.50 in chips) 
Small Blind: posts small blind $2.50
Big Blind: posts big blind $5
*** HOLE CARDS ***
Dealt to Hero [Ks 8h]
UTG: folds 
Hero: raises $7.50 to $12.50
Small Blind: folds 
Big Blind: calls $7.50
*** FLOP *** [Jc 8s Qc]
Big Blind: checks 
Hero: checks 
*** TURN *** [Jc 8s Qc] [9c]
Big Blind: checks 
Hero: checks 
*** RIVER *** [Jc 8s Qc 9c] [Tc]
Big Blind: bets $8.71
Hero: calls $8.71
*** SHOW DOWN ***
Small Blind: shows [6s 2c] (a hand...)
UTG: shows [3s 6d] (a hand...)
Big Blind: shows [3d 3c] (a hand...)
Hero: shows [Ks 8h] (a hand...)
Big Blind collected $42.68 from pot
*** SUMMARY ***
Total pot $44.92 | Rake $2.24
Board [Jc 8s Qc 9c Tc]
Seat 1: Big Blind showed [3d 3c] and won ($42.68)
Seat 2: UTG folded
Seat 3: Hero showed [Ks 8h] and lost with...
Seat 4: Small Blind folded



PokerStars Hand #3963148518:  Hold'em No Limit ($2.50/$5) - 2020/06/19 13:57:30 ET
Table 'Zone Poker ID 1612' 9-max Seat #4 is the button
Seat 1: Small Blind ($467.50 in chips) 
Seat 2: Big Blind ($507.50 in chips) 
Seat 3: Hero ($587.52 in chips) 
Seat 4: Dealer ($704.34 in chips) 
Small Blind: posts small blind $2.50
Big Blind: posts big blind $5
*** HOLE CARDS ***
Dealt to Hero [Qd Ad]
Hero: raises $7.50 to $12.50
Dealer: folds 
Small Blind: calls $10
Big Blind: folds 
*** FLOP *** [6d 7h 8d]
Small Blind: checks 
Hero: bets $20
Small Blind: calls $20
*** TURN *** [6d 7h 8d] [9h]
Small Blind: checks 
Hero: checks 
*** RIVER *** [6d 7h 8d 9h] [Ah]
Small Blind: bets $33.50
Hero: calls $33.50
*** SHOW DOWN ***
Small Blind: shows [5h 6h] (a hand...)
Dealer: shows [7s Tc] (a hand...)
Big Blind: shows [6s Jh] (a hand...)
Hero: shows [Qd Ad] (a hand...)
Small Blind collected $134 from pot
*** SUMMARY ***
Total pot $137.00 | Rake $3.00
Board [6d 7h 8d 9h Ah]
Seat 1: Small Blind showed [5h 6h] and won ($134)
Seat 2: Big Blind folded
Seat 3: Hero showed [Qd Ad] and lost with...
Seat 4: Dealer folded



PokerStars Hand #3963145272:  Hold'em No Limit ($2.50/$5) - 2020/06/19 13:47:19 ET
Table 'Zone Poker ID 1612' 9-max Seat #2 is the button
Seat 1: Hero ($480.00 in chips) 
Seat 2: Dealer ($541.05 in chips) 
Seat 3: Small Blind ($680.29 in chips) 
Small Blind: posts small blind $2.50
Hero: posts big blind $5
*** HOLE CARDS ***
Dealt to Hero [Ad 9c]
Dealer: raises $10 to $15
Small Blind: folds 
Hero: calls $10
*** FLOP *** [9h 2h 8s]
Hero: checks 
Dealer: bets $23.16
Hero: calls $23.16
*** TURN *** [9h 2h 8s] [Qs]
Hero: checks 
Dealer: bets $57.62
Hero: calls $57.62
*** RIVER *** [9h 2h 8s Qs] [6d]
Hero: checks 
Dealer: bets $192.06
Hero: calls $192.06
*** SHOW DOWN ***
Small Blind: shows [Ts 7c] (a hand...)
Dealer: shows [Qc Ac] (a hand...)
Hero: shows [Ad 9c] (a hand...)
Dealer collected $576.18 from pot
*** SUMMARY ***
Total pot $578.18 | Rake $2.00
Board [9h 2h 8s Qs 6d]
Seat 1: Hero showed [Ad 9c] and lost with...
Seat 2: Dealer showed [Qc Ac] and won ($576.18)
Seat 3: Small Blind folded



PokerStars Hand #3963144898:  Hold'em No Limit ($2.50/$5) - 2020/06/19 13:46:10 ET
Table 'Zone Poker ID 1612' 9-max Seat #3 is the button
Seat 1: Small Blind ($913.35 in chips) 
Seat 2: Hero ($492.50 in chips) 
Seat 3: Dealer ($685.90 in chips) 
Small Blind: posts small blind $2.50
Hero: posts big blind $5
*** HOLE CARDS ***
Dealt to Hero [Td 3d]
Dealer: folds 
Small Blind: calls $2.50
Hero: checks 
*** FLOP *** [3s 5s 7h]
Small Blind: checks 
Hero: bets $5
Small Blind: calls $5
*** TURN *** [3s 5s 7h] [Qd]
Small Blind: checks 
Hero: checks 
*** RIVER *** [3s 5s 7h Qd] [9d]
Small Blind: bets $29
Hero: folds 
*** SHOW DOWN ***
Small Blind: shows [6s Jd] (a hand...)
Dealer: shows [7c 8d] (a hand...)
Hero: shows [Td 3d] (a hand...)
Uncalled bet ($29.00) returned to Small Blind
Small Blind collected $19 from pot
*** SUMMARY ***
Total pot $20.00 | Rake $1.00
Board [3s 5s 7h Qd 9d]
Seat 1: Small Blind collected ($19)
Seat 2: Hero folded
Seat 3: Dealer folded



PokerStars Hand #3963144110:  Hold'em No Limit ($2.50/$5) - 2020/06/19 13:43:35 ET
Table 'Zone Poker ID 1612' 9-max Seat #4 is the button
Seat 1: Hero ($513.63 in chips) 
Seat 2: UTG ($1195.58 in chips) 
Seat 3: UTG+1 ($481.88 in chips) 
Seat 4: Dealer ($266.45 in chips) 
Seat 5: Small Blind ($629.49 in chips) 
Small Blind: posts small blind $2.50
Hero: posts big blind $5
*** HOLE CARDS ***
Dealt to Hero [Kc 6c]
UTG: folds 
UTG+1: folds 
Dealer: folds 
Small Blind: raises $10.00 to $15
Hero: calls $10
*** FLOP *** [Qs 5h 5c]
Small Blind: checks 
Hero: checks 
*** TURN *** [Qs 5h 5c] [4c]
Small Blind: bets $9.50
Hero: calls $9.50
*** RIVER *** [Qs 5h 5c 4c] [6s]
Small Blind: bets $34.91
Hero: calls $34.91
*** SHOW DOWN ***
Small Blind: shows [Qc Td] (a hand...)
Hero: shows [Kc 6c] (a hand...)
Dealer: shows [8c 2h] (a hand...)
UTG: shows [5d Jc] (a hand...)
UTG+1: shows [9d 2s] (a hand...)
Small Blind collected $115.82 from pot
*** SUMMARY ***
Total pot $118.82 | Rake $3.00
Board [Qs 5h 5c 4c 6s]
Seat 1: Hero showed [Kc 6c] and lost with...
Seat 2: UTG folded
Seat 3: UTG+1 folded
Seat 4: Dealer folded
Seat 5: Small Blind showed [Qc Td] and won ($115.82)



PokerStars Hand #3963109425:  Hold'em No Limit ($2.50/$5) - 2020/06/19 11:42:01 ET
Table 'Zone Poker ID 1612' 9-max Seat #2 is the button
Seat 1: Big Blind ($502.50 in chips) 
Seat 2: Dealer ($1030.51 in chips) 
Seat 3: Hero ($1232.54 in chips) 
Hero: posts small blind $2.50
Big Blind: posts big blind $5
*** HOLE CARDS ***
Dealt to Hero [Ah 8h]
Dealer: folds 
Hero: raises $10.00 to $15
Big Blind: calls $10
*** FLOP *** [7d Ad 3s]
Hero: bets $8.55
Big Blind: calls $8.55
*** TURN *** [7d Ad 3s] [Ac]
Hero: checks 
Big Blind: bets $15.23
Hero: calls $15.23
*** RIVER *** [7d Ad 3s Ac] [6c]
Hero: checks 
Big Blind: bets $110
Hero: calls $110
*** SHOW DOWN ***
Dealer: shows [Th 7s] (a hand...)
Big Blind: shows [Ts Qs] (a hand...)
Hero: shows [Ah 8h] (a hand...)
Hero collected $295.56 from pot
*** SUMMARY ***
Total pot $297.56 | Rake $2.00
Board [7d Ad 3s Ac 6c]
Seat 1: Big Blind showed [Ts Qs] and lost with...
Seat 2: Dealer folded
Seat 3: Hero showed [Ah 8h] and won ($295.56)



PokerStars Hand #3963107986:  Hold'em No Limit ($2.50/$5) - 2020/06/19 11:36:31 ET
Table 'Zone Poker ID 1612' 9-max Seat #2 is the button
Seat 1: Hero ($1082.28 in chips) 
Seat 2: Dealer ($506.13 in chips) 
Seat 3: Small Blind ($441.34 in chips) 
Small Blind: posts small blind $2.50
Hero: posts big blind $5
*** HOLE CARDS ***
Dealt to Hero [Ad 3c]
Dealer: folds 
Small Blind: raises $10.00 to $15
Hero: calls $10
*** FLOP *** [5c 2c 6h]
Small Blind: checks 
Hero: checks 
*** TURN *** [5c 2c 6h] [9s]
Small Blind: bets $21.38
Hero: calls $21.38
*** RIVER *** [5c 2c 6h 9s] [Ah]
Small Blind: bets $35.38
Hero: calls $35.38
*** SHOW DOWN ***
Small Blind: shows [9c Ks] (a hand...)
Dealer: shows [5h Jc] (a hand...)
Hero: shows [Ad 3c] (a hand...)
Hero collected $141.52 from pot
*** SUMMARY ***
Total pot $143.52 | Rake $2.00
Board [5c 2c 6h 9s Ah]
Seat 1: Hero showed [Ad 3c] and won ($141.52)
Seat 2: Dealer folded
Seat 3: Small Blind showed [9c Ks] and lost with...



PokerStars Hand #3963107798:  Hold'em No Limit ($2.50/$5) - 2020/06/19 11:35:50 ET
Table 'Zone Poker ID 1612' 9-max Seat #1 is the button
Seat 1: Dealer ($924.86 in chips) 
Seat 2: Small Blind ($516.13 in chips) 
Seat 3: Hero ($516.60 in chips) 
Small Blind: posts small blind $2.50
Hero: posts big blind $5
*** HOLE CARDS ***
Dealt to Hero [Kc Ts]
Dealer: raises $6.25 to $11.25
Small Blind: folds 
Hero: calls $6.25
*** FLOP *** [Qd Qc Ah]
Hero: checks 
Dealer: bets $6.65
Hero: calls $6.65
*** TURN *** [Qd Qc Ah] [As]
Hero: checks 
Dealer: checks 
*** RIVER *** [Qd Qc Ah As] [Ad]
Hero: bets $56.52
Dealer: raises $63.48 to $120
Hero: calls $63.48
*** SHOW DOWN ***
Small Blind: shows [4c 9s] (a hand...)
Dealer: shows [Tc Ac] (a hand...)
Hero: shows [Kc Ts] (a hand...)
Dealer collected $276.30 from pot
*** SUMMARY ***
Total pot $278.30 | Rake $2.00
Board [Qd Qc Ah As Ad]
Seat 1: Dealer showed [Tc Ac] and won ($276.30)
Seat 2: Small Blind folded
Seat 3: Hero showed [Kc Ts] and lost with...



PokerStars Hand #3963106054:  Hold'em No Limit ($2.50/$5) - 2020/06/19 11:29:03 ET
Table 'Zone Poker ID 1612' 9-max Seat #2 is the button
Seat 1: Big Blind ($783.34 in chips) 
Seat 2: Dealer ($577.42 in chips) 
Seat 3: Hero ($657.28 in chips) 
Hero: posts small blind $2.50
Big Blind: posts big blind $5
*** HOLE CARDS ***
Dealt to Hero [5h As]
Dealer: folds 
Hero: raises $10.00 to $15
Big Blind: calls $10
*** FLOP *** [9h Ac Qd]
Hero: bets $8.55
Big Blind: calls $8.55
*** TURN *** [9h Ac Qd] [Qs]
Hero: checks 
Big Blind: bets $22.55
Hero: calls $22.55
*** RIVER *** [9h Ac Qd Qs] [2c]
Hero: checks 
Big Blind: bets $200
Hero: calls $200
*** SHOW DOWN ***
Dealer: shows [4s 7c] (a hand...)
Big Blind: shows [Jc Td] (a hand...)
Hero: shows [5h As] (a hand...)
Hero collected $490.20 from pot
*** SUMMARY ***
Total pot $492.20 | Rake $2.00
Board [9h Ac Qd Qs 2c]
Seat 1: Big Blind showed [Jc Td] and lost with...
Seat 2: Dealer folded
Seat 3: Hero showed [5h As] and won ($490.20)



PokerStars Hand #3963105969:  Hold'em No Limit ($2.50/$5) - 2020/06/19 11:28:44 ET
Table 'Zone Poker ID 1612' 9-max Seat #2 is the button
Seat 1: Big Blind ($342.59 in chips) 
Seat 2: Hero ($500.00 in chips) 
Seat 3: Small Blind ($602.15 in chips) 
Small Blind: posts small blind $2.50
Big Blind: posts big blind $5
*** HOLE CARDS ***
Dealt to Hero [7d 8d]
Hero: raises $7.50 to $12.50
Small Blind: folds 
Big Blind: calls $7.50
*** FLOP *** [Kd Qh 5c]
Big Blind: checks 
Hero: bets $7.84
Big Blind: calls $7.84
*** TURN *** [Kd Qh 5c] [Td]
Big Blind: checks 
Hero: bets $30.89
Big Blind: calls $30.89
*** RIVER *** [Kd Qh 5c Td] [Qc]
Big Blind: bets $77.22
Hero: folds 
*** SHOW DOWN ***
Small Blind: shows [9d 4h] (a hand...)
Big Blind: shows [3s Qs] (a hand...)
Hero: shows [7d 8d] (a hand...)
Uncalled bet ($77.22) returned to Big Blind
Big Blind collected $102.96 from pot
*** SUMMARY ***
Total pot $104.96 | Rake $2.00
Board [Kd Qh 5c Td Qc]
Seat 1: Big Blind collected ($102.96)
Seat 2: Hero folded
Seat 3: Small Blind folded



PokerStars Hand #3963105811:  Hold'em No Limit ($2.50/$5) - 2020/06/19 11:28:08 ET
Table 'Zone Poker ID 1612' 9-max Seat #2 is the button
Seat 1: Hero ($679.78 in chips) 
Seat 2: Dealer ($762.84 in chips) 
Seat 3: Small Blind ($357.59 in chips) 
Small Blind: posts small blind $2.50
Hero: posts big blind $5
*** HOLE CARDS ***
Dealt to Hero [8d Ac]
Dealer: raises $7 to $12
Small Blind: folds 
Hero: calls $7
*** FLOP *** [Qd Js Ts]
Hero: checks 
Dealer: bets $8
Hero: calls $8
*** TURN *** [Qd Js Ts] [3d]
Hero: checks 
Dealer: checks 
*** RIVER *** [Qd Js Ts 3d] [4h]
Hero: checks 
Dealer: bets $30.38
Hero: folds 
*** SHOW DOWN ***
Small Blind: shows [Kh 5s] (a hand...)
Dealer: shows [4c 4d] (a hand...)
Hero: shows [8d Ac] (a hand...)
Uncalled bet ($30.38) returned to Dealer
Dealer collected $40.50 from pot
*** SUMMARY ***
Total pot $42.50 | Rake $2.00
Board [Qd Js Ts 3d 4h]
Seat 1: Hero folded
Seat 2: Dealer collected ($40.50)
Seat 3: Small Blind folded



PokerStars Hand #3962741103:  Hold'em No Limit ($2.50/$5) - 2020/06/18 16:42:27 ET
Table 'Zone Poker ID 1612' 9-max Seat #2 is the button
Seat 1: UTG ($706.66 in chips) 
Seat 2: Dealer ($525.61 in chips) 
Seat 3: Hero ($500.00 in chips) 
Seat 4: Big Blind ($691.98 in chips) 
Hero: posts small blind $2.50
Big Blind: posts big blind $5
*** HOLE CARDS ***
Dealt to Hero [Qc Qh]
UTG: raises $7 to $12
Dealer: raises $25.50 to $37.50
Hero: raises $72.50 to $110
Big Blind: folds 
UTG: folds 
Dealer: calls $72.50
*** FLOP *** [2s 5s Qs]
Hero: checks 
Dealer: checks 
*** TURN *** [2s 5s Qs] [4s]
Hero: checks 
Dealer: bets $69.72
Hero: calls $69.72
*** RIVER *** [2s 5s Qs 4s] [3h]
Hero: checks 
Dealer: bets $345.89 and is all-in
Hero: calls $320.28 and is all-in
*** SHOW DOWN ***
UTG: shows [5c 4c] (a hand...)
Dealer: shows [As Ad] (a hand...)
Big Blind: shows [Tc Th] (a hand...)
Hero: shows [Qc Qh] (a hand...)
Uncalled bet ($25.61) returned to Dealer
Dealer collected $1014 from pot
*** SUMMARY ***
Total pot $1017.00 | Rake $3.00
Board [2s 5s Qs 4s 3h]
Seat 1: UTG folded
Seat 2: Dealer showed [As Ad] and won ($1014)
Seat 3: Hero showed [Qc Qh] and lost with...
Seat 4: Big Blind folded



PokerStars Hand #3962738956:  Hold'em No Limit ($2.50/$5) - 2020/06/18 16:37:18 ET
Table 'Zone Poker ID 1612' 9-max Seat #3 is the button
Seat 1: Small Blind ($506.33 in chips) 
Seat 2: Hero ($621.63 in chips) 
Seat 3: Dealer ($517.43 in chips) 
Small Blind: posts small blind $2.50
Hero: posts big blind $5
*** HOLE CARDS ***
Dealt to Hero [As 4h]
Dealer: raises $7.50 to $12.50
Small Blind: folds 
Hero: calls $7.50
*** FLOP *** [Ks Ah 3h]
Hero: checks 
Dealer: bets $8.07
Hero: calls $8.07
*** TURN *** [Ks Ah 3h] [Jc]
Hero: checks 
Dealer: bets $71.64
Hero: calls $71.64
*** RIVER *** [Ks Ah 3h Jc] [Qs]
Hero: checks 
Dealer: bets $425.22 and is all-in
Hero: folds 
*** SHOW DOWN ***
Small Blind: shows [7d 9c] (a hand...)
Dealer: shows [Tc 7c] (a hand...)
Hero: shows [As 4h] (a hand...)
Uncalled bet ($425.22) returned to Dealer
Dealer collected $184.92 from pot
*** SUMMARY ***
Total pot $186.92 | Rake $2.00
Board [Ks Ah 3h Jc Qs]
Seat 1: Small Blind folded
Seat 2: Hero folded
Seat 3: Dealer collected ($184.92)



PokerStars Hand #3962738712:  Hold'em No Limit ($2.50/$5) - 2020/06/18 16:36:40 ET
Table 'Zone Poker ID 1612' 9-max Seat #4 is the button
Seat 1: Small Blind ($1263.25 in chips) 
Seat 2: Hero ($515.00 in chips) 
Seat 3: UTG ($513.83 in chips) 
Seat 4: Dealer ($566.77 in chips) 
Small Blind: posts small blind $2.50
Hero: posts big blind $5
*** HOLE CARDS ***
Dealt to Hero [6h Ac]
UTG: folds 
Dealer: folds 
Small Blind: raises $10.00 to $15
Hero: calls $10
*** FLOP *** [Jh 3d 4c]
Small Blind: bets $10
Hero: calls $10
*** TURN *** [Jh 3d 4c] [5d]
Small Blind: bets $35.63
Hero: calls $35.63
*** RIVER *** [Jh 3d 4c 5d] [Td]
Small Blind: bets $88.70
Hero: folds 
*** SHOW DOWN ***
Small Blind: shows [6c 8c] (a hand...)
UTG: shows [7s 5h] (a hand...)
Dealer: shows [Ad 2c] (a hand...)
Hero: shows [6h Ac] (a hand...)
Uncalled bet ($88.70) returned to Small Blind
Small Blind collected $118.26 from pot
*** SUMMARY ***
Total pot $121.26 | Rake $3.00
Board [Jh 3d 4c 5d Td]
Seat 1: Small Blind collected ($118.26)
Seat 2: Hero folded
Seat 3: UTG folded
Seat 4: Dealer folded



PokerStars Hand #3962737810:  Hold'em No Limit ($2.50/$5) - 2020/06/18 16:34:34 ET
Table 'Zone Poker ID 1612' 9-max Seat #3 is the button
Seat 1: Big Blind ($500.00 in chips) 
Seat 2: UTG ($536.38 in chips) 
Seat 3: Hero ($438.66 in chips) 
Seat 4: Small Blind ($586.50 in chips) 
Small Blind: posts small blind $2.50
Big Blind: posts big blind $5
*** HOLE CARDS ***
Dealt to Hero [7d 6d]
UTG: folds 
Hero: raises $7.50 to $12.50
Small Blind: folds 
Big Blind: calls $7.50
*** FLOP *** [9d 5s Qs]
Big Blind: checks 
Hero: checks 
*** TURN *** [9d 5s Qs] [Js]
Big Blind: checks 
Hero: checks 
*** RIVER *** [9d 5s Qs Js] [Ts]
Big Blind: bets $13.07
Hero: folds 
*** SHOW DOWN ***
Small Blind: shows [6h 8h] (a hand...)
UTG: shows [2d 3h] (a hand...)
Big Blind: shows [9s 8d] (a hand...)
Hero: shows [7d 6d] (a hand...)
Uncalled bet ($13.07) returned to Big Blind
Big Blind collected $26.13 from pot
*** SUMMARY ***
Total pot $27.50 | Rake $1.37
Board [9d 5s Qs Js Ts]
Seat 1: Big Blind collected ($26.13)
Seat 2: UTG folded
Seat 3: Hero folded
Seat 4: Small Blind folded



PokerStars Hand #3962737325:  Hold'em No Limit ($2.50/$5) - 2020/06/18 16:33:22 ET
Table 'Zone Poker ID 1612' 9-max Seat #3 is the button
Seat 1: Hero ($508.78 in chips) 
Seat 2: UTG ($516.88 in chips) 
Seat 3: Dealer ($493.44 in chips) 
Seat 4: Small Blind ($558.13 in chips) 
Small Blind: posts small blind $2.50
Hero: posts big blind $5
*** HOLE CARDS ***
Dealt to Hero [As Th]
UTG: raises $7.50 to $12.50
Dealer: folds 
Small Blind: folds 
Hero: calls $7.50
*** FLOP *** [Td Kc 7s]
Hero: checks 
UTG: bets $8.62
Hero: calls $8.62
*** TURN *** [Td Kc 7s] [8s]
Hero: checks 
UTG: checks 
*** RIVER *** [Td Kc 7s 8s] [6d]
Hero: bets $14.02
UTG: raises $34.98 to $49
Hero: calls $34.98
*** SHOW DOWN ***
Small Blind: shows [6c 4c] (a hand...)
UTG: shows [9h 9d] (a hand...)
Dealer: shows [Jh 3s] (a hand...)
Hero: shows [As Th] (a hand...)
UTG collected $139.74 from pot
*** SUMMARY ***
Total pot $142.74 | Rake $3.00
Board [Td Kc 7s 8s 6d]
Seat 1: Hero showed [As Th] and lost with...
Seat 2: UTG showed [9h 9d] and won ($139.74)
Seat 3: Dealer folded
Seat 4: Small Blind folded



PokerStars Hand #3962722024:  Hold'em No Limit ($2.50/$5) - 2020/06/18 15:55:09 ET
Table 'Zone Poker ID 1612' 9-max Seat #2 is the button
Seat 1: Hero ($500.00 in chips) 
Seat 2: Dealer ($593.00 in chips) 
Seat 3: Small Blind ($527.72 in chips) 
Small Blind: posts small blind $2.50
Hero: posts big blind $5
*** HOLE CARDS ***
Dealt to Hero [Ts 9h]
Dealer: raises $7.50 to $12.50
Small Blind: folds 
Hero: calls $7.50
*** FLOP *** [8d 6s 5s]
Hero: checks 
Dealer: bets $10
Hero: calls $10
*** TURN *** [8d 6s 5s] [Th]
Hero: checks 
Dealer: bets $34.13
Hero: calls $34.13
*** RIVER *** [8d 6s 5s Th] [Ac]
Hero: checks 
Dealer: bets $85.32
Hero: calls $85.32
*** SHOW DOWN ***
Small Blind: shows [4s Td] (a hand...)
Dealer: shows [8s As] (a hand...)
Hero: shows [Ts 9h] (a hand...)
Dealer collected $284.40 from pot
*** SUMMARY ***
Total pot $286.40 | Rake $2.00
Board [8d 6s 5s Th Ac]
Seat 1: Hero showed [Ts 9h] and lost with...
Seat 2: Dealer showed [8s As] and won ($284.40)
Seat 3: Small Blind folded



PokerStars Hand #3962721437:  Hold'em No Limit ($2.50/$5) - 2020/06/18 15:53:38 ET
Table 'Zone Poker ID 1612' 9-max Seat #3 is the button
Seat 1: Small Blind ($467.62 in chips) 
Seat 2: Big Blind ($470.75 in chips) 
Seat 3: Hero ($533.50 in chips) 
Small Blind: posts small blind $2.50
Big Blind: posts big blind $5
*** HOLE CARDS ***
Dealt to Hero [Td As]
Hero: raises $7.50 to $12.50
Small Blind: folds 
Big Blind: calls $7.50
*** FLOP *** [Ac Qh Kh]
Big Blind: checks 
Hero: bets $20
Big Blind: calls $20
*** TURN *** [Ac Qh Kh] [Ts]
Big Blind: checks 
Hero: checks 
*** RIVER *** [Ac Qh Kh Ts] [7c]
Big Blind: bets $55.50
Hero: calls $55.50
*** SHOW DOWN ***
Small Blind: shows [9h 5h] (a hand...)
Big Blind: shows [Js Qd] (a hand...)
Hero: shows [Td As] (a hand...)
Big Blind collected $176.50 from pot
*** SUMMARY ***
Total pot $178.50 | Rake $2.00
Board [Ac Qh Kh Ts 7c]
Seat 1: Small Blind folded
Seat 2: Big Blind showed [Js Qd] and won ($176.50)
Seat 3: Hero showed [Td As] and lost with...



PokerStars Hand #3962711323:  Hold'em No Limit ($2.50/$5) - 2020/06/18 15:26:07 ET
Table 'Zone Poker ID 1612' 9-max Seat #2 is the button
Seat 1: Hero ($541.96 in chips) 
Seat 2: Dealer ($497.50 in chips) 
Seat 3: Small Blind ($676.23 in chips) 
Small Blind: posts small blind $2.50
Hero: posts big blind $5
*** HOLE CARDS ***
Dealt to Hero [8d Ah]
Dealer: folds 
Small Blind: raises $10.00 to $15
Hero: calls $10
*** FLOP *** [4s 3d Qc]
Small Blind: checks 
Hero: checks 
*** TURN *** [4s 3d Qc] [2h]
Small Blind: bets $19.25
Hero: calls $19.25
*** RIVER *** [4s 3d Qc 2h] [Kd]
Small Blind: bets $49.88
Hero: calls $49.88
*** SHOW DOWN ***
Small Blind: shows [Ks 9h] (a hand...)
Dealer: shows [3c Th] (a hand...)
Hero: shows [8d Ah] (a hand...)
Small Blind collected $166.26 from pot
*** SUMMARY ***
Total pot $168.26 | Rake $2.00
Board [4s 3d Qc 2h Kd]
Seat 1: Hero showed [8d Ah] and lost with...
Seat 2: Dealer folded
Seat 3: Small Blind showed [Ks 9h] and won ($166.26)



PokerStars Hand #3962710002:  Hold'em No Limit ($2.50/$5) - 2020/06/18 15:22:14 ET
Table 'Zone Poker ID 1612' 9-max Seat #3 is the button
Seat 1: Small Blind ($1116.25 in chips) 
Seat 2: Hero ($865.00 in chips) 
Seat 3: Dealer ($245.00 in chips) 
Small Blind: posts small blind $2.50
Hero: posts big blind $5
*** HOLE CARDS ***
Dealt to Hero [3s As]
Dealer: folds 
Small Blind: raises $10.00 to $15
Hero: raises $35 to $50
Small Blind: calls $35
*** FLOP *** [4d Kd 7c]
Small Blind: checks 
Hero: bets $29.40
Small Blind: calls $29.40
*** TURN *** [4d Kd 7c] [Jh]
Small Blind: checks 
Hero: checks 
*** RIVER *** [4d Kd 7c Jh] [3h]
Small Blind: bets $196.80
Hero: calls $196.80
*** SHOW DOWN ***
Small Blind: shows [8c Ac] (a hand...)
Dealer: shows [6h 2h] (a hand...)
Hero: shows [3s As] (a hand...)
Hero collected $550.40 from pot
*** SUMMARY ***
Total pot $552.40 | Rake $2.00
Board [4d Kd 7c Jh 3h]
Seat 1: Small Blind showed [8c Ac] and lost with...
Seat 2: Hero showed [3s As] and won ($550.40)
Seat 3: Dealer folded



PokerStars Hand #3962708652:  Hold'em No Limit ($2.50/$5) - 2020/06/18 15:18:15 ET
Table 'Zone Poker ID 1612' 9-max Seat #3 is the button
Seat 1: Hero ($672.50 in chips) 
Seat 2: Big Blind ($2568.04 in chips) 
Seat 3: Dealer ($263.56 in chips) 
Hero: posts small blind $2.50
Big Blind: posts big blind $5
*** HOLE CARDS ***
Dealt to Hero [Ah Qd]
Dealer: folds 
Hero: raises $10.00 to $15
Big Blind: raises $20 to $35
Hero: calls $20
*** FLOP *** [Ac 4s Jh]
Hero: checks 
Big Blind: bets $34
Hero: calls $34
*** TURN *** [Ac 4s Jh] [4d]
Hero: checks 
Big Blind: bets $68
Hero: calls $68
*** RIVER *** [Ac 4s Jh 4d] [2s]
Hero: checks 
Big Blind: bets $204
Hero: calls $204
*** SHOW DOWN ***
Dealer: shows [3s 4c] (a hand...)
Big Blind: shows [As Ad] (a hand...)
Hero: shows [Ah Qd] (a hand...)
Big Blind collected $680 from pot
*** SUMMARY ***
Total pot $682.00 | Rake $2.00
Board [Ac 4s Jh 4d 2s]
Seat 1: Hero showed [Ah Qd] and lost with...
Seat 2: Big Blind showed [As Ad] and won ($680)
Seat 3: Dealer folded



PokerStars Hand #3962708029:  Hold'em No Limit ($2.50/$5) - 2020/06/18 15:16:26 ET
Table 'Zone Poker ID 1612' 9-max Seat #3 is the button
Seat 1: Small Blind ($445.56 in chips) 
Seat 2: Hero ($507.50 in chips) 
Seat 3: Dealer ($568.07 in chips) 
Small Blind: posts small blind $2.50
Hero: posts big blind $5
*** HOLE CARDS ***
Dealt to Hero [8d 8s]
Dealer: folds 
Small Blind: raises $10.00 to $15
Hero: raises $30 to $45
Small Blind: calls $30
*** FLOP *** [As 5h 5s]
Small Blind: checks 
Hero: bets $26.40
Small Blind: calls $26.40
*** TURN *** [As 5h 5s] [7h]
Small Blind: checks 
Hero: checks 
*** RIVER *** [As 5h 5s 7h] [Ac]
Small Blind: bets $105.60
Hero: calls $105.60
*** SHOW DOWN ***
Small Blind: shows [Qc Ks] (a hand...)
Dealer: shows [6s 8c] (a hand...)
Hero: shows [8d 8s] (a hand...)
Hero collected $352 from pot
*** SUMMARY ***
Total pot $354.00 | Rake $2.00
Board [As 5h 5s 7h Ac]
Seat 1: Small Blind showed [Qc Ks] and lost with...
Seat 2: Hero showed [8d 8s] and won ($352)
Seat 3: Dealer folded



PokerStars Hand #3962707395:  Hold'em No Limit ($2.50/$5) - 2020/06/18 15:14:35 ET
Table 'Zone Poker ID 1612' 9-max Seat #2 is the button
Seat 1: Big Blind ($496.57 in chips) 
Seat 2: Dealer ($472.50 in chips) 
Seat 3: Hero ($495.00 in chips) 
Hero: posts small blind $2.50
Big Blind: posts big blind $5
*** HOLE CARDS ***
Dealt to Hero [Jh Kh]
Dealer: folds 
Hero: raises $10.00 to $15
Big Blind: calls $10
*** FLOP *** [2h Ac 7d]
Hero: checks 
Big Blind: bets $10
Hero: calls $10
*** TURN *** [2h Ac 7d] [Kd]
Hero: checks 
Big Blind: bets $36
Hero: calls $36
*** RIVER *** [2h Ac 7d Kd] [8d]
Hero: checks 
Big Blind: bets $85
Hero: folds 
*** SHOW DOWN ***
Dealer: shows [8s 6d] (a hand...)
Big Blind: shows [Ad 2c] (a hand...)
Hero: shows [Jh Kh] (a hand...)
Uncalled bet ($85.00) returned to Big Blind
Big Blind collected $120 from pot
*** SUMMARY ***
Total pot $122.00 | Rake $2.00
Board [2h Ac 7d Kd 8d]
Seat 1: Big Blind collected ($120)
Seat 2: Dealer folded
Seat 3: Hero folded



PokerStars Hand #3962687892:  Hold'em No Limit ($2.50/$5) - 2020/06/18 14:18:28 ET
Table 'Zone Poker ID 1612' 9-max Seat #1 is the button
Seat 1: Dealer ($518.95 in chips) 
Seat 2: Hero ($539.51 in chips) 
Seat 3: Big Blind ($1091.83 in chips) 
Hero: posts small blind $2.50
Big Blind: posts big blind $5
*** HOLE CARDS ***
Dealt to Hero [2h Ah]
Dealer: folds 
Hero: raises $10.00 to $15
Big Blind: raises $30 to $45
Hero: raises $75.00 to $120
Big Blind: calls $75
*** FLOP *** [Ac As 4d]
Hero: bets $52.60
Big Blind: calls $52.60
*** TURN *** [Ac As 4d] [9d]
Hero: checks 
Big Blind: checks 
*** RIVER *** [Ac As 4d 9d] [Qc]
Hero: checks 
Big Blind: bets $919.23 and is all-in
Hero: calls $366.91 and is all-in
*** SHOW DOWN ***
Dealer: shows [Jc 4h] (a hand...)
Big Blind: shows [Ad Td] (a hand...)
Hero: shows [2h Ah] (a hand...)
Uncalled bet ($552.32) returned to Big Blind
Big Blind collected $1077.02 from pot
*** SUMMARY ***
Total pot $1079.02 | Rake $2.00
Board [Ac As 4d 9d Qc]
Seat 1: Dealer folded
Seat 2: Hero showed [2h Ah] and lost with...
Seat 3: Big Blind showed [Ad Td] and won ($1077.02)



PokerStars Hand #3962675509:  Hold'em No Limit ($2.50/$5) - 2020/06/18 13:40:46 ET
Table 'Zone Poker ID 1612' 9-max Seat #2 is the button
Seat 1: Big Blind ($554.63 in chips) 
Seat 2: Dealer ($754.00 in chips) 
Seat 3: Hero ($362.50 in chips) 
Hero: posts small blind $2.50
Big Blind: posts big blind $5
*** HOLE CARDS ***
Dealt to Hero [7h 7s]
Dealer: raises $5 to $10
Hero: raises $35.00 to $45
Big Blind: folds 
Dealer: calls $35
*** FLOP *** [5h Jd Tc]
Hero: bets $27.90
Dealer: calls $27.90
*** TURN *** [5h Jd Tc] [2s]
Hero: checks 
Dealer: checks 
*** RIVER *** [5h Jd Tc 2s] [Js]
Hero: checks 
Dealer: bets $111.60
Hero: calls $111.60
*** SHOW DOWN ***
Dealer: shows [Ts As] (a hand...)
Big Blind: shows [6h 2d] (a hand...)
Hero: shows [7h 7s] (a hand...)
Dealer collected $372 from pot
*** SUMMARY ***
Total pot $374.00 | Rake $2.00
Board [5h Jd Tc 2s Js]
Seat 1: Big Blind folded
Seat 2: Dealer showed [Ts As] and won ($372)
Seat 3: Hero showed [7h 7s] and lost with...



PokerStars Hand #3962393495:  Hold'em No Limit ($2.50/$5) - 2020/06/17 21:46:30 ET
Table 'Zone Poker ID 1612' 9-max Seat #3 is the button
Seat 1: Hero ($537.51 in chips) 
Seat 2: UTG ($511.38 in chips) 
Seat 3: Dealer ($963.14 in chips) 
Seat 4: Small Blind ($834.22 in chips) 
Small Blind: posts small blind $2.50
Hero: posts big blind $5
*** HOLE CARDS ***
Dealt to Hero [8d Kc]
UTG: raises $5 to $10
Dealer: folds 
Small Blind: folds 
Hero: calls $5
*** FLOP *** [8s 4c 4d]
Hero: checks 
UTG: bets $6
Hero: calls $6
*** TURN *** [8s 4c 4d] [Ah]
Hero: checks 
UTG: checks 
*** RIVER *** [8s 4c 4d Ah] [4h]
Hero: bets $8
UTG: raises $17.31 to $25.31
Hero: folds 
*** SHOW DOWN ***
Small Blind: shows [Qh 8c] (a hand...)
UTG: shows [Kh Ad] (a hand...)
Dealer: shows [Qs 7d] (a hand...)
Hero: shows [8d Kc] (a hand...)
Uncalled bet ($17.31) returned to UTG
UTG collected $47.98 from pot
*** SUMMARY ***
Total pot $50.50 | Rake $2.52
Board [8s 4c 4d Ah 4h]
Seat 1: Hero folded
Seat 2: UTG collected ($47.98)
Seat 3: Dealer folded
Seat 4: Small Blind folded



PokerStars Hand #3962390959:  Hold'em No Limit ($2.50/$5) - 2020/06/17 21:41:51 ET
Table 'Zone Poker ID 1612' 9-max Seat #1 is the button
Seat 1: Hero ($503.00 in chips) 
Seat 2: Small Blind ($500.00 in chips) 
Seat 3: Big Blind ($712.13 in chips) 
Seat 4: UTG ($573.39 in chips) 
Small Blind: posts small blind $2.50
Big Blind: posts big blind $5
*** HOLE CARDS ***
Dealt to Hero [8d 6d]
UTG: folds 
Hero: raises $7.50 to $12.50
Small Blind: folds 
Big Blind: calls $7.50
*** FLOP *** [Qc Jh 6c]
Big Blind: checks 
Hero: checks 
*** TURN *** [Qc Jh 6c] [Th]
Big Blind: checks 
Hero: checks 
*** RIVER *** [Qc Jh 6c Th] [3d]
Big Blind: bets $17.51
Hero: calls $17.51
*** SHOW DOWN ***
Small Blind: shows [2d 7h] (a hand...)
UTG: shows [4s 5c] (a hand...)
Big Blind: shows [2s Ks] (a hand...)
Hero: shows [8d 6d] (a hand...)
Hero collected $59.52 from pot
*** SUMMARY ***
Total pot $62.52 | Rake $3.00
Board [Qc Jh 6c Th 3d]
Seat 1: Hero showed [8d 6d] and won ($59.52)
Seat 2: Small Blind folded
Seat 3: Big Blind showed [2s Ks] and lost with...
Seat 4: UTG folded



PokerStars Hand #3962221369:  Hold'em No Limit ($2.50/$5) - 2020/06/17 14:35:01 ET
Table 'Zone Poker ID 1612' 9-max Seat #3 is the button
Seat 1: Small Blind ($1583.61 in chips) 
Seat 2: Hero ($588.14 in chips) 
Seat 3: Dealer ($502.50 in chips) 
Small Blind: posts small blind $2.50
Hero: posts big blind $5
*** HOLE CARDS ***
Dealt to Hero [Ad 5c]
Dealer: folds 
Small Blind: raises $10.00 to $15
Hero: calls $10
*** FLOP *** [6d 8c 8h]
Small Blind: bets $9.25
Hero: raises $23.50 to $32.75
Small Blind: calls $23.50
*** TURN *** [6d 8c 8h] [Qs]
Small Blind: checks 
Hero: checks 
*** RIVER *** [6d 8c 8h Qs] [Ks]
Small Blind: bets $46.75
Hero: calls $46.75
*** SHOW DOWN ***
Small Blind: shows [7d 8d] (a hand...)
Dealer: shows [2s 6s] (a hand...)
Hero: shows [Ad 5c] (a hand...)
Small Blind collected $187 from pot
*** SUMMARY ***
Total pot $189.00 | Rake $2.00
Board [6d 8c 8h Qs Ks]
Seat 1: Small Blind showed [7d 8d] and won ($187)
Seat 2: Hero showed [Ad 5c] and lost with...
Seat 3: Dealer folded



PokerStars Hand #3962221127:  Hold'em No Limit ($2.50/$5) - 2020/06/17 14:34:12 ET
Table 'Zone Poker ID 1612' 9-max Seat #3 is the button
Seat 1: Small Blind ($546.70 in chips) 
Seat 2: Big Blind ($500.00 in chips) 
Seat 3: Hero ($608.48 in chips) 
Small Blind: posts small blind $2.50
Big Blind: posts big blind $5
*** HOLE CARDS ***
Dealt to Hero [7s Ad]
Hero: raises $7.50 to $12.50
Small Blind: folds 
Big Blind: calls $7.50
*** FLOP *** [Kh 9h 3h]
Big Blind: checks 
Hero: bets $7.84
Big Blind: calls $7.84
*** TURN *** [Kh 9h 3h] [7h]
Big Blind: checks 
Hero: checks 
*** RIVER *** [Kh 9h 3h 7h] [Qc]
Big Blind: bets $30.89
Hero: folds 
*** SHOW DOWN ***
Small Blind: shows [6h 8s] (a hand...)
Big Blind: shows [As Jh] (a hand...)
Hero: shows [7s Ad] (a hand...)
Uncalled bet ($30.89) returned to Big Blind
Big Blind collected $41.18 from pot
*** SUMMARY ***
Total pot $43.18 | Rake $2.00
Board [Kh 9h 3h 7h Qc]
Seat 1: Small Blind folded
Seat 2: Big Blind collected ($41.18)
Seat 3: Hero folded



PokerStars Hand #3962220419:  Hold'em No Limit ($2.50/$5) - 2020/06/17 14:31:57 ET
Table 'Zone Poker ID 1612' 9-max Seat #2 is the button
Seat 1: Big Blind ($577.75 in chips) 
Seat 2: Dealer ($1670.36 in chips) 
Seat 3: Hero ($539.50 in chips) 
Hero: posts small blind $2.50
Big Blind: posts big blind $5
*** HOLE CARDS ***
Dealt to Hero [Ad 8c]
Dealer: folds 
Hero: raises $10.00 to $15
Big Blind: calls $10
*** FLOP *** [Ah 4d 7c]
Hero: checks 
Big Blind: bets $20
Hero: calls $20
*** TURN *** [Ah 4d 7c] [6c]
Hero: checks 
Big Blind: checks 
*** RIVER *** [Ah 4d 7c 6c] [4c]
Hero: checks 
Big Blind: bets $21
Hero: calls $21
*** SHOW DOWN ***
Dealer: shows [9c 3d] (a hand...)
Big Blind: shows [Ac 9s] (a hand...)
Hero: shows [Ad 8c] (a hand...)
Big Blind collected $110 from pot
*** SUMMARY ***
Total pot $112.00 | Rake $2.00
Board [Ah 4d 7c 6c 4c]
Seat 1: Big Blind showed [Ac 9s] and won ($110)
Seat 2: Dealer folded
Seat 3: Hero showed [Ad 8c] and lost with...



PokerStars Hand #3962219559:  Hold'em No Limit ($2.50/$5) - 2020/06/17 14:29:11 ET
Table 'Zone Poker ID 1612' 9-max Seat #2 is the button
Seat 1: UTG ($583.00 in chips) 
Seat 2: Hero ($497.50 in chips) 
Seat 3: Small Blind ($1584.48 in chips) 
Seat 4: Big Blind ($825.66 in chips) 
Small Blind: posts small blind $2.50
Big Blind: posts big blind $5
*** HOLE CARDS ***
Dealt to Hero [8d Ad]
UTG: folds 
Hero: raises $7.50 to $12.50
Small Blind: raises $37.50 to $50
Big Blind: folds 
Hero: calls $37.50
*** FLOP *** [Td 9h Qs]
Small Blind: bets $30
Hero: calls $30
*** TURN *** [Td 9h Qs] [3h]
Small Blind: checks 
Hero: checks 
*** RIVER *** [Td 9h Qs 3h] [7c]
Small Blind: bets $121.50
Hero: folds 
*** SHOW DOWN ***
Small Blind: shows [Kc Qh] (a hand...)
UTG: shows [6h 9s] (a hand...)
Big Blind: shows [3c 5s] (a hand...)
Hero: shows [8d Ad] (a hand...)
Uncalled bet ($121.50) returned to Small Blind
Small Blind collected $162 from pot
*** SUMMARY ***
Total pot $165.00 | Rake $3.00
Board [Td 9h Qs 3h 7c]
Seat 1: UTG folded
Seat 2: Hero folded
Seat 3: Small Blind collected ($162)
Seat 4: Big Blind folded



PokerStars Hand #3961796408:  Hold'em No Limit ($2.50/$5) - 2020/06/16 17:08:17 ET
Table 'Zone Poker ID 1612' 9-max Seat #1 is the button
Seat 1: Dealer ($583.82 in chips) 
Seat 2: Small Blind ($415.59 in chips) 
Seat 3: Hero ($938.00 in chips) 
Small Blind: posts small blind $2.50
Hero: posts big blind $5
*** HOLE CARDS ***
Dealt to Hero [Qd 2d]
Dealer: raises $7.50 to $12.50
Small Blind: folds 
Hero: calls $7.50
*** FLOP *** [Ad Tc Ac]
Hero: checks 
Dealer: bets $5
Hero: calls $5
*** TURN *** [Ad Tc Ac] [7c]
Hero: checks 
Dealer: checks 
*** RIVER *** [Ad Tc Ac 7c] [6s]
Hero: checks 
Dealer: bets $26.72
Hero: folds 
*** SHOW DOWN ***
Small Blind: shows [7d 6c] (a hand...)
Dealer: shows [Qh 9h] (a hand...)
Hero: shows [Qd 2d] (a hand...)
Uncalled bet ($26.72) returned to Dealer
Dealer collected $35.63 from pot
*** SUMMARY ***
Total pot $37.50 | Rake $1.87
Board [Ad Tc Ac 7c 6s]
Seat 1: Dealer collected ($35.63)
Seat 2: Small Blind folded
Seat 3: Hero folded



PokerStars Hand #3961795208:  Hold'em No Limit ($2.50/$5) - 2020/06/16 17:05:20 ET
Table 'Zone Poker ID 1612' 9-max Seat #3 is the button
Seat 1: Hero ($495.00 in chips) 
Seat 2: Big Blind ($700.25 in chips) 
Seat 3: Dealer ($515.00 in chips) 
Hero: posts small blind $2.50
Big Blind: posts big blind $5
*** HOLE CARDS ***
Dealt to Hero [9d Qd]
Dealer: folds 
Hero: raises $10.00 to $15
Big Blind: calls $10
*** FLOP *** [Ad 6h Ah]
Hero: bets $8.55
Big Blind: calls $8.55
*** TURN *** [Ad 6h Ah] [7s]
Hero: checks 
Big Blind: checks 
*** RIVER *** [Ad 6h Ah 7s] [7c]
Hero: checks 
Big Blind: bets $22.55
Hero: calls $22.55
*** SHOW DOWN ***
Dealer: shows [4c Tc] (a hand...)
Big Blind: shows [5c 5d] (a hand...)
Hero: shows [9d Qd] (a hand...)
Hero collected $90.20 from pot
*** SUMMARY ***
Total pot $92.20 | Rake $2.00
Board [Ad 6h Ah 7s 7c]
Seat 1: Hero showed [9d Qd] and won ($90.20)
Seat 2: Big Blind showed [5c 5d] and lost with...
Seat 3: Dealer folded



PokerStars Hand #3961794547:  Hold'em No Limit ($2.50/$5) - 2020/06/16 17:03:42 ET
Table 'Zone Poker ID 1612' 9-max Seat #2 is the button
Seat 1: Big Blind ($787.85 in chips) 
Seat 2: Hero ($488.50 in chips) 
Seat 3: Small Blind ($500.00 in chips) 
Small Blind: posts small blind $2.50
Big Blind: posts big blind $5
*** HOLE CARDS ***
Dealt to Hero [Td Ts]
Hero: raises $7.50 to $12.50
Small Blind: raises $37.50 to $50
Big Blind: folds 
Hero: calls $37.50
*** FLOP *** [9d 9c Qd]
Small Blind: bets $35
Hero: calls $35
*** TURN *** [9d 9c Qd] [2h]
Small Blind: bets $114.75
Hero: calls $114.75
*** RIVER *** [9d 9c Qd 2h] [5c]
Small Blind: bets $300.25 and is all-in
Hero: folds 
*** SHOW DOWN ***
Small Blind: shows [Kh Kc] (a hand...)
Big Blind: shows [8h Jh] (a hand...)
Hero: shows [Td Ts] (a hand...)
Uncalled bet ($300.25) returned to Small Blind
Small Blind collected $402.50 from pot
*** SUMMARY ***
Total pot $404.50 | Rake $2.00
Board [9d 9c Qd 2h 5c]
Seat 1: Big Blind folded
Seat 2: Hero folded
Seat 3: Small Blind collected ($402.50)



PokerStars Hand #3961792468:  Hold'em No Limit ($2.50/$5) - 2020/06/16 16:58:39 ET
Table 'Zone Poker ID 1612' 9-max Seat #2 is the button
Seat 1: Big Blind ($293.81 in chips) 
Seat 2: Hero ($828.71 in chips) 
Seat 3: Small Blind ($678.92 in chips) 
Small Blind: posts small blind $2.50
Big Blind: posts big blind $5
*** HOLE CARDS ***
Dealt to Hero [8c 9s]
Hero: raises $7.50 to $12.50
Small Blind: folds 
Big Blind: calls $7.50
*** FLOP *** [3h 8d Jh]
Big Blind: checks 
Hero: bets $7.84
Big Blind: calls $7.84
*** TURN *** [3h 8d Jh] [7s]
Big Blind: bets $20.59
Hero: calls $20.59
*** RIVER *** [3h 8d Jh 7s] [7h]
Big Blind: bets $41.18
Hero: calls $41.18
*** SHOW DOWN ***
Small Blind: shows [4c 3d] (a hand...)
Big Blind: shows [9d Ah] (a hand...)
Hero: shows [8c 9s] (a hand...)
Hero collected $164.72 from pot
*** SUMMARY ***
Total pot $166.72 | Rake $2.00
Board [3h 8d Jh 7s 7h]
Seat 1: Big Blind showed [9d Ah] and lost with...
Seat 2: Hero showed [8c 9s] and won ($164.72)
Seat 3: Small Blind folded



PokerStars Hand #3961789548:  Hold'em No Limit ($2.50/$5) - 2020/06/16 16:51:47 ET
Table 'Zone Poker ID 1612' 9-max Seat #2 is the button
Seat 1: Hero ($538.67 in chips) 
Seat 2: Dealer ($516.50 in chips) 
Seat 3: Small Blind ($598.05 in chips) 
Small Blind: posts small blind $2.50
Hero: posts big blind $5
*** HOLE CARDS ***
Dealt to Hero [3c 3s]
Dealer: folds 
Small Blind: raises $10.00 to $15
Hero: calls $10
*** FLOP *** [Ah 7c Kc]
Small Blind: checks 
Hero: checks 
*** TURN *** [Ah 7c Kc] [Kd]
Small Blind: checks 
Hero: checks 
*** RIVER *** [Ah 7c Kc Kd] [4c]
Small Blind: bets $14.25
Hero: calls $14.25
*** SHOW DOWN ***
Small Blind: shows [4d 4h] (a hand...)
Dealer: shows [Jh 8c] (a hand...)
Hero: shows [3c 3s] (a hand...)
Small Blind collected $56.50 from pot
*** SUMMARY ***
Total pot $58.50 | Rake $2.00
Board [Ah 7c Kc Kd 4c]
Seat 1: Hero showed [3c 3s] and lost with...
Seat 2: Dealer folded
Seat 3: Small Blind showed [4d 4h] and won ($56.50)



PokerStars Hand #3961786937:  Hold'em No Limit ($2.50/$5) - 2020/06/16 16:45:38 ET
Table 'Zone Poker ID 1612' 9-max Seat #1 is the button
Seat 1: Hero ($512.26 in chips) 
Seat 2: Small Blind ($954.95 in chips) 
Seat 3: Big Blind ($500.00 in chips) 
Small Blind: posts small blind $2.50
Big Blind: posts big blind $5
*** HOLE CARDS ***
Dealt to Hero [Qc Kh]
Hero: raises $7.50 to $12.50
Small Blind: folds 
Big Blind: calls $7.50
*** FLOP *** [4s 9s 8d]
Big Blind: checks 
Hero: checks 
*** TURN *** [4s 9s 8d] [5h]
Big Blind: checks 
Hero: checks 
*** RIVER *** [4s 9s 8d 5h] [9h]
Big Blind: bets $8
Hero: calls $8
*** SHOW DOWN ***
Small Blind: shows [2h 7c] (a hand...)
Big Blind: shows [5d Ah] (a hand...)
Hero: shows [Qc Kh] (a hand...)
Big Blind collected $41.50 from pot
*** SUMMARY ***
Total pot $43.50 | Rake $2.00
Board [4s 9s 8d 5h 9h]
Seat 1: Hero showed [Qc Kh] and lost with...
Seat 2: Small Blind folded
Seat 3: Big Blind showed [5d Ah] and won ($41.50)



PokerStars Hand #3961784541:  Hold'em No Limit ($2.50/$5) - 2020/06/16 16:39:56 ET
Table 'Zone Poker ID 1612' 9-max Seat #2 is the button
Seat 1: Hero ($544.76 in chips) 
Seat 2: Dealer ($710.20 in chips) 
Seat 3: Small Blind ($457.80 in chips) 
Small Blind: posts small blind $2.50
Hero: posts big blind $5
*** HOLE CARDS ***
Dealt to Hero [Kh 8c]
Dealer: folds 
Small Blind: raises $10.00 to $15
Hero: calls $10
*** FLOP *** [7h As 9s]
Small Blind: checks 
Hero: checks 
*** TURN *** [7h As 9s] [5d]
Small Blind: bets $14.25
Hero: calls $14.25
*** RIVER *** [7h As 9s 5d] [Ks]
Small Blind: bets $33.25
Hero: calls $33.25
*** SHOW DOWN ***
Small Blind: shows [Ah 8d] (a hand...)
Dealer: shows [8s Jc] (a hand...)
Hero: shows [Kh 8c] (a hand...)
Small Blind collected $123 from pot
*** SUMMARY ***
Total pot $125.00 | Rake $2.00
Board [7h As 9s 5d Ks]
Seat 1: Hero showed [Kh 8c] and lost with...
Seat 2: Dealer folded
Seat 3: Small Blind showed [Ah 8d] and won ($123)



PokerStars Hand #3961783933:  Hold'em No Limit ($2.50/$5) - 2020/06/16 16:38:30 ET
Table 'Zone Poker ID 1612' 9-max Seat #2 is the button
Seat 1: Hero ($726.62 in chips) 
Seat 2: Dealer ($700.00 in chips) 
Seat 3: Small Blind ($530.60 in chips) 
Small Blind: posts small blind $2.50
Hero: posts big blind $5
*** HOLE CARDS ***
Dealt to Hero [Ac 9s]
Dealer: raises $7.50 to $12.50
Small Blind: folds 
Hero: calls $7.50
*** FLOP *** [5c 2d Ks]
Hero: checks 
Dealer: bets $8.07
Hero: calls $8.07
*** TURN *** [5c 2d Ks] [8s]
Hero: checks 
Dealer: checks 
*** RIVER *** [5c 2d Ks 8s] [3h]
Hero: checks 
Dealer: bets $10
Hero: folds 
*** SHOW DOWN ***
Small Blind: shows [5s 2c] (a hand...)
Dealer: shows [Ts 8d] (a hand...)
Hero: shows [Ac 9s] (a hand...)
Uncalled bet ($10.00) returned to Dealer
Dealer collected $41.64 from pot
*** SUMMARY ***
Total pot $43.64 | Rake $2.00
Board [5c 2d Ks 8s 3h]
Seat 1: Hero folded
Seat 2: Dealer collected ($41.64)
Seat 3: Small Blind folded



PokerStars Hand #3961783354:  Hold'em No Limit ($2.50/$5) - 2020/06/16 16:37:05 ET
Table 'Zone Poker ID 1612' 9-max Seat #2 is the button
Seat 1: Big Blind ($564.36 in chips) 
Seat 2: Dealer ($1179.57 in chips) 
Seat 3: Hero ($495.00 in chips) 
Hero: posts small blind $2.50
Big Blind: posts big blind $5
*** HOLE CARDS ***
Dealt to Hero [5s 5d]
Dealer: folds 
Hero: raises $10.00 to $15
Big Blind: raises $29.25 to $44.25
Hero: calls $29.25
*** FLOP *** [3h 7s 7c]
Hero: checks 
Big Blind: bets $49.88
Hero: calls $49.88
*** TURN *** [3h 7s 7c] [3c]
Hero: checks 
Big Blind: checks 
*** RIVER *** [3h 7s 7c 3c] [Ks]
Hero: checks 
Big Blind: bets $139.49
Hero: calls $139.49
*** SHOW DOWN ***
Dealer: shows [2d Qs] (a hand...)
Big Blind: shows [5h 6h] (a hand...)
Hero: shows [5s 5d] (a hand...)
Hero collected $465.24 from pot
*** SUMMARY ***
Total pot $467.24 | Rake $2.00
Board [3h 7s 7c 3c Ks]
Seat 1: Big Blind showed [5h 6h] and lost with...
Seat 2: Dealer folded
Seat 3: Hero showed [5s 5d] and won ($465.24)



PokerStars Hand #3961756696:  Hold'em No Limit ($2.50/$5) - 2020/06/16 15:28:37 ET
Table 'Zone Poker ID 1612' 9-max Seat #1 is the button
Seat 1: Hero ($1440.22 in chips) 
Seat 2: Small Blind ($1221.67 in chips) 
Seat 3: Big Blind ($696.70 in chips) 
Small Blind: posts small blind $2.50
Big Blind: posts big blind $5
*** HOLE CARDS ***
Dealt to Hero [Th Ts]
Hero: raises $7.50 to $12.50
Small Blind: raises $42.50 to $55
Big Blind: folds 
Hero: calls $42.50
*** FLOP *** [As 8s 9c]
Small Blind: bets $38
Hero: calls $38
*** TURN *** [As 8s 9c] [4s]
Small Blind: checks 
Hero: checks 
*** RIVER *** [As 8s 9c 4s] [6h]
Small Blind: bets $602.91
Hero: folds 
*** SHOW DOWN ***
Small Blind: shows [Kd Td] (a hand...)
Big Blind: shows [5d 7c] (a hand...)
Hero: shows [Th Ts] (a hand...)
Uncalled bet ($602.91) returned to Small Blind
Small Blind collected $189 from pot
*** SUMMARY ***
Total pot $191.00 | Rake $2.00
Board [As 8s 9c 4s 6h]
Seat 1: Hero folded
Seat 2: Small Blind collected ($189)
Seat 3: Big Blind folded



PokerStars Hand #3961756313:  Hold'em No Limit ($2.50/$5) - 2020/06/16 15:27:31 ET
Table 'Zone Poker ID 1612' 9-max Seat #2 is the button
Seat 1: Big Blind ($507.32 in chips) 
Seat 2: Hero ($490.63 in chips) 
Seat 3: Small Blind ($886.11 in chips) 
Small Blind: posts small blind $2.50
Big Blind: posts big blind $5
*** HOLE CARDS ***
Dealt to Hero [6s Js]
Hero: raises $7.50 to $12.50
Small Blind: calls $10
Big Blind: folds 
*** FLOP *** [Qc 6c 9h]
Small Blind: checks 
Hero: bets $8.55
Small Blind: calls $8.55
*** TURN *** [Qc 6c 9h] [Qd]
Small Blind: checks 
Hero: checks 
*** RIVER *** [Qc 6c 9h Qd] [Ah]
Small Blind: bets $45.10
Hero: folds 
*** SHOW DOWN ***
Small Blind: shows [2s 2h] (a hand...)
Big Blind: shows [8d 3s] (a hand...)
Hero: shows [6s Js] (a hand...)
Uncalled bet ($45.10) returned to Small Blind
Small Blind collected $45.10 from pot
*** SUMMARY ***
Total pot $47.10 | Rake $2.00
Board [Qc 6c 9h Qd Ah]
Seat 1: Big Blind folded
Seat 2: Hero folded
Seat 3: Small Blind collected ($45.10)



PokerStars Hand #3961754763:  Hold'em No Limit ($2.50/$5) - 2020/06/16 15:23:03 ET
Table 'Zone Poker ID 1612' 9-max Seat #2 is the button
Seat 1: Big Blind ($502.50 in chips) 
Seat 2: Hero ($508.63 in chips) 
Seat 3: Small Blind ($680.26 in chips) 
Small Blind: posts small blind $2.50
Big Blind: posts big blind $5
*** HOLE CARDS ***
Dealt to Hero [7d 6d]
Hero: raises $7.50 to $12.50
Small Blind: folds 
Big Blind: calls $7.50
*** FLOP *** [6h Qc 4s]
Big Blind: checks 
Hero: bets $7.84
Big Blind: calls $7.84
*** TURN *** [6h Qc 4s] [2s]
Big Blind: checks 
Hero: checks 
*** RIVER *** [6h Qc 4s 2s] [8c]
Big Blind: bets $30.89
Hero: calls $30.89
*** SHOW DOWN ***
Small Blind: shows [4c 9c] (a hand...)
Big Blind: shows [Qh Ts] (a hand...)
Hero: shows [7d 6d] (a hand...)
Big Blind collected $102.96 from pot
*** SUMMARY ***
Total pot $104.96 | Rake $2.00
Board [6h Qc 4s 2s 8c]
Seat 1: Big Blind showed [Qh Ts] and won ($102.96)
Seat 2: Hero showed [7d 6d] and lost with...
Seat 3: Small Blind folded



PokerStars Hand #3961754516:  Hold'em No Limit ($2.50/$5) - 2020/06/16 15:22:23 ET
Table 'Zone Poker ID 1612' 9-max Seat #2 is the button
Seat 1: Big Blind ($1508.91 in chips) 
Seat 2: Hero ($1451.92 in chips) 
Seat 3: Small Blind ($280.75 in chips) 
Small Blind: posts small blind $2.50
Big Blind: posts big blind $5
*** HOLE CARDS ***
Dealt to Hero [8c 7s]
Hero: raises $7.50 to $12.50
Small Blind: folds 
Big Blind: calls $7.50
*** FLOP *** [Ts 7c 7d]
Big Blind: checks 
Hero: bets $7.84
Big Blind: raises $20.91 to $28.75
Hero: calls $20.91
*** TURN *** [Ts 7c 7d] [Qc]
Big Blind: bets $41.50
Hero: calls $41.50
*** RIVER *** [Ts 7c 7d Qc] [4c]
Big Blind: bets $83
Hero: calls $83
*** SHOW DOWN ***
Small Blind: shows [6c 3c] (a hand...)
Big Blind: shows [Js Td] (a hand...)
Hero: shows [8c 7s] (a hand...)
Hero collected $332 from pot
*** SUMMARY ***
Total pot $334.00 | Rake $2.00
Board [Ts 7c 7d Qc 4c]
Seat 1: Big Blind showed [Js Td] and lost with...
Seat 2: Hero showed [8c 7s] and won ($332)
Seat 3: Small Blind folded



PokerStars Hand #3961752318:  Hold'em No Limit ($2.50/$5) - 2020/06/16 15:16:14 ET
Table 'Zone Poker ID 1612' 9-max Seat #3 is the button
Seat 1: Hero ($533.44 in chips) 
Seat 2: Big Blind ($529.13 in chips) 
Seat 3: Dealer ($551.00 in chips) 
Hero: posts small blind $2.50
Big Blind: posts big blind $5
*** HOLE CARDS ***
Dealt to Hero [As 8s]
Dealer: folds 
Hero: raises $10.00 to $15
Big Blind: calls $10
*** FLOP *** [6d 4c 5d]
Hero: checks 
Big Blind: bets $10
Hero: calls $10
*** TURN *** [6d 4c 5d] [Ks]
Hero: checks 
Big Blind: bets $73
Hero: calls $73
*** RIVER *** [6d 4c 5d Ks] [Ts]
Hero: checks 
Big Blind: bets $431.13 and is all-in
Hero: folds 
*** SHOW DOWN ***
Dealer: shows [9s 4d] (a hand...)
Big Blind: shows [8d Qc] (a hand...)
Hero: shows [As 8s] (a hand...)
Uncalled bet ($431.13) returned to Big Blind
Big Blind collected $194 from pot
*** SUMMARY ***
Total pot $196.00 | Rake $2.00
Board [6d 4c 5d Ks Ts]
Seat 1: Hero folded
Seat 2: Big Blind collected ($194)
Seat 3: Dealer folded



PokerStars Hand #3961752041:  Hold'em No Limit ($2.50/$5) - 2020/06/16 15:15:26 ET
Table 'Zone Poker ID 1612' 9-max Seat #2 is the button
Seat 1: Hero ($1111.92 in chips) 
Seat 2: Dealer ($1309.38 in chips) 
Seat 3: Small Blind ($447.30 in chips) 
Small Blind: posts small blind $2.50
Hero: posts big blind $5
*** HOLE CARDS ***
Dealt to Hero [8h As]
Dealer: raises $7.50 to $12.50
Small Blind: calls $10
Hero: calls $7.50
*** FLOP *** [Kd Qs 2s]
Small Blind: checks 
Hero: checks 
Dealer: checks 
*** TURN *** [Kd Qs 2s] [Qc]
Small Blind: checks 
Hero: checks 
Dealer: checks 
*** RIVER *** [Kd Qs 2s Qc] [3h]
Small Blind: checks 
Hero: checks 
Dealer: bets $26.72
Small Blind: folds 
Hero: folds 
*** SHOW DOWN ***
Small Blind: shows [Jd 5d] (a hand...)
Dealer: shows [3d Kh] (a hand...)
Hero: shows [8h As] (a hand...)
Uncalled bet ($26.72) returned to Dealer
Dealer collected $35.63 from pot
*** SUMMARY ***
Total pot $37.50 | Rake $1.87
Board [Kd Qs 2s Qc 3h]
Seat 1: Hero folded
Seat 2: Dealer collected ($35.63)
Seat 3: Small Blind folded



PokerStars Hand #3961750807:  Hold'em No Limit ($2.50/$5) - 2020/06/16 15:11:57 ET
Table 'Zone Poker ID 1612' 9-max Seat #2 is the button
Seat 1: Hero ($678.06 in chips) 
Seat 2: Dealer ($902.81 in chips) 
Seat 3: Small Blind ($502.50 in chips) 
Small Blind: posts small blind $2.50
Hero: posts big blind $5
*** HOLE CARDS ***
Dealt to Hero [8c 7c]
Dealer: raises $7.50 to $12.50
Small Blind: folds 
Hero: raises $45.00 to $57.50
Dealer: raises $65.00 to $122.50
Hero: calls $65
*** FLOP *** [7s 3s 5h]
Hero: checks 
Dealer: bets $80
Hero: calls $80
*** TURN *** [7s 3s 5h] [3d]
Hero: checks 
Dealer: bets $160
Hero: calls $160
*** RIVER *** [7s 3s 5h 3d] [9c]
Hero: checks 
Dealer: bets $540.31 and is all-in
Hero: folds 
*** SHOW DOWN ***
Small Blind: shows [4s 2h] (a hand...)
Dealer: shows [Ac As] (a hand...)
Hero: shows [8c 7c] (a hand...)
Uncalled bet ($540.31) returned to Dealer
Dealer collected $725.50 from pot
*** SUMMARY ***
Total pot $727.50 | Rake $2.00
Board [7s 3s 5h 3d 9c]
Seat 1: Hero folded
Seat 2: Dealer collected ($725.50)
Seat 3: Small Blind folded



PokerStars Hand #3961746966:  Hold'em No Limit ($2.50/$5) - 2020/06/16 15:01:16 ET
Table 'Zone Poker ID 1612' 9-max Seat #2 is the button
Seat 1: Hero ($492.50 in chips) 
Seat 2: Dealer ($2169.51 in chips) 
Seat 3: Small Blind ($298.55 in chips) 
Small Blind: posts small blind $2.50
Hero: posts big blind $5
*** HOLE CARDS ***
Dealt to Hero [4h Js]
Dealer: folds 
Small Blind: calls $2.50
Hero: checks 
*** FLOP *** [4c 5d 3c]
Small Blind: checks 
Hero: checks 
*** TURN *** [4c 5d 3c] [5h]
Small Blind: bets $9.50
Hero: calls $9.50
*** RIVER *** [4c 5d 3c 5h] [Td]
Small Blind: bets $27.55
Hero: calls $27.55
*** SHOW DOWN ***
Small Blind: shows [4s 3h] (a hand...)
Dealer: shows [3s 6s] (a hand...)
Hero: shows [4h Js] (a hand...)
Hero collected $82.10 from pot
*** SUMMARY ***
Total pot $84.10 | Rake $2.00
Board [4c 5d 3c 5h Td]
Seat 1: Hero showed [4h Js] and won ($82.10)
Seat 2: Dealer folded
Seat 3: Small Blind showed [4s 3h] and lost with...



PokerStars Hand #3961743867:  Hold'em No Limit ($2.50/$5) - 2020/06/16 14:52:03 ET
Table 'Zone Poker ID 1612' 9-max Seat #2 is the button
Seat 1: Big Blind ($507.50 in chips) 
Seat 2: Dealer ($687.13 in chips) 
Seat 3: Hero ($813.86 in chips) 
Hero: posts small blind $2.50
Big Blind: posts big blind $5
*** HOLE CARDS ***
Dealt to Hero [Kc Ac]
Dealer: folds 
Hero: raises $10.00 to $15
Big Blind: calls $10
*** FLOP *** [3h 4h 9h]
Hero: checks 
Big Blind: checks 
*** TURN *** [3h 4h 9h] [As]
Hero: checks 
Big Blind: bets $20
Hero: calls $20
*** RIVER *** [3h 4h 9h As] [3s]
Hero: checks 
Big Blind: bets $47.38
Hero: calls $47.38
*** SHOW DOWN ***
Dealer: shows [6s 3c] (a hand...)
Big Blind: shows [Tc Ad] (a hand...)
Hero: shows [Kc Ac] (a hand...)
Hero collected $162.76 from pot
*** SUMMARY ***
Total pot $164.76 | Rake $2.00
Board [3h 4h 9h As 3s]
Seat 1: Big Blind showed [Tc Ad] and lost with...
Seat 2: Dealer folded
Seat 3: Hero showed [Kc Ac] and won ($162.76)



PokerStars Hand #3961740881:  Hold'em No Limit ($2.50/$5) - 2020/06/16 14:43:13 ET
Table 'Zone Poker ID 1612' 9-max Seat #1 is the button
Seat 1: Hero ($486.79 in chips) 
Seat 2: Small Blind ($797.62 in chips) 
Seat 3: Big Blind ($507.50 in chips) 
Seat 4: UTG ($331.09 in chips) 
Small Blind: posts small blind $2.50
Big Blind: posts big blind $5
*** HOLE CARDS ***
Dealt to Hero [7d 6d]
UTG: folds 
Hero: raises $7.50 to $12.50
Small Blind: folds 
Big Blind: raises $42.50 to $55
Hero: calls $42.50
*** FLOP *** [8s 4h As]
Big Blind: bets $30
Hero: calls $30
*** TURN *** [8s 4h As] [Qs]
Big Blind: checks 
Hero: checks 
*** RIVER *** [8s 4h As Qs] [9h]
Big Blind: bets $55
Hero: folds 
*** SHOW DOWN ***
Small Blind: shows [3s 8h] (a hand...)
UTG: shows [6c Kh] (a hand...)
Big Blind: shows [Ad Ac] (a hand...)
Hero: shows [7d 6d] (a hand...)
Uncalled bet ($55.00) returned to Big Blind
Big Blind collected $169.50 from pot
*** SUMMARY ***
Total pot $172.50 | Rake $3.00
Board [8s 4h As Qs 9h]
Seat 1: Hero folded
Seat 2: Small Blind folded
Seat 3: Big Blind collected ($169.50)
Seat 4: UTG folded



PokerStars Hand #3961740813:  Hold'em No Limit ($2.50/$5) - 2020/06/16 14:42:57 ET
Table 'Zone Poker ID 1612' 9-max Seat #3 is the button
Seat 1: Hero ($702.35 in chips) 
Seat 2: UTG ($513.80 in chips) 
Seat 3: Dealer ($599.59 in chips) 
Seat 4: Small Blind ($791.52 in chips) 
Small Blind: posts small blind $2.50
Hero: posts big blind $5
*** HOLE CARDS ***
Dealt to Hero [Ac 5s]
UTG: folds 
Dealer: folds 
Small Blind: raises $10.00 to $15
Hero: calls $10
*** FLOP *** [5h 9h 3d]
Small Blind: checks 
Hero: bets $8.55
Small Blind: calls $8.55
*** TURN *** [5h 9h 3d] [9d]
Small Blind: checks 
Hero: checks 
*** RIVER *** [5h 9h 3d 9d] [7c]
Small Blind: bets $38.56
Hero: calls $38.56
*** SHOW DOWN ***
Small Blind: shows [6c 4c] (a hand...)
UTG: shows [6h 4s] (a hand...)
Dealer: shows [Tc 4h] (a hand...)
Hero: shows [Ac 5s] (a hand...)
Small Blind collected $121.22 from pot
*** SUMMARY ***
Total pot $124.22 | Rake $3.00
Board [5h 9h 3d 9d 7c]
Seat 1: Hero showed [Ac 5s] and lost with...
Seat 2: UTG folded
Seat 3: Dealer folded
Seat 4: Small Blind showed [6c 4c] and won ($121.22)



PokerStars Hand #3961739268:  Hold'em No Limit ($2.50/$5) - 2020/06/16 14:38:25 ET
Table 'Zone Poker ID 1612' 9-max Seat #2 is the button
Seat 1: Big Blind ($495.00 in chips) 
Seat 2: Hero ($599.85 in chips) 
Seat 3: Small Blind ($518.00 in chips) 
Small Blind: posts small blind $2.50
Big Blind: posts big blind $5
*** HOLE CARDS ***
Dealt to Hero [9h Js]
Hero: raises $7.50 to $12.50
Small Blind: folds 
Big Blind: calls $7.50
*** FLOP *** [9d 8h Ac]
Big Blind: checks 
Hero: checks 
*** TURN *** [9d 8h Ac] [Ts]
Big Blind: bets $8.07
Hero: calls $8.07
*** RIVER *** [9d 8h Ac Ts] [Kh]
Big Blind: bets $112.26
Hero: folds 
*** SHOW DOWN ***
Small Blind: shows [Ks 2s] (a hand...)
Big Blind: shows [Jh 4h] (a hand...)
Hero: shows [9h Js] (a hand...)
Uncalled bet ($112.26) returned to Big Blind
Big Blind collected $41.64 from pot
*** SUMMARY ***
Total pot $43.64 | Rake $2.00
Board [9d 8h Ac Ts Kh]
Seat 1: Big Blind collected ($41.64)
Seat 2: Hero folded
Seat 3: Small Blind folded



PokerStars Hand #3961738308:  Hold'em No Limit ($2.50/$5) - 2020/06/16 14:35:29 ET
Table 'Zone Poker ID 1612' 9-max Seat #3 is the button
Seat 1: Small Blind ($943.00 in chips) 
Seat 2: Big Blind ($654.79 in chips) 
Seat 3: Hero ($662.26 in chips) 
Small Blind: posts small blind $2.50
Big Blind: posts big blind $5
*** HOLE CARDS ***
Dealt to Hero [8s 9c]
Hero: raises $7.50 to $12.50
Small Blind: folds 
Big Blind: calls $7.50
*** FLOP *** [Qs 9s 2d]
Big Blind: checks 
Hero: checks 
*** TURN *** [Qs 9s 2d] [4h]
Big Blind: bets $13.07
Hero: calls $13.07
*** RIVER *** [Qs 9s 2d 4h] [2c]
Big Blind: bets $25.82
Hero: calls $25.82
*** SHOW DOWN ***
Small Blind: shows [8d 6s] (a hand...)
Big Blind: shows [Kd 4d] (a hand...)
Hero: shows [8s 9c] (a hand...)
Hero collected $103.28 from pot
*** SUMMARY ***
Total pot $105.28 | Rake $2.00
Board [Qs 9s 2d 4h 2c]
Seat 1: Small Blind folded
Seat 2: Big Blind showed [Kd 4d] and lost with...
Seat 3: Hero showed [8s 9c] and won ($103.28)



PokerStars Hand #3961737626:  Hold'em No Limit ($2.50/$5) - 2020/06/16 14:33:26 ET
Table 'Zone Poker ID 1612' 9-max Seat #2 is the button
Seat 1: Big Blind ($485.00 in chips) 
Seat 2: Hero ($645.31 in chips) 
Seat 3: Small Blind ($1545.86 in chips) 
Small Blind: posts small blind $2.50
Big Blind: posts big blind $5
*** HOLE CARDS ***
Dealt to Hero [Jd Ah]
Hero: raises $7.50 to $12.50
Small Blind: calls $10
Big Blind: folds 
*** FLOP *** [8h Qd Qs]
Small Blind: checks 
Hero: bets $8.55
Small Blind: calls $8.55
*** TURN *** [8h Qd Qs] [7h]
Small Blind: checks 
Hero: checks 
*** RIVER *** [8h Qd Qs 7h] [6c]
Small Blind: bets $33.83
Hero: folds 
*** SHOW DOWN ***
Small Blind: shows [Ts Ks] (a hand...)
Big Blind: shows [6h 2s] (a hand...)
Hero: shows [Jd Ah] (a hand...)
Uncalled bet ($33.83) returned to Small Blind
Small Blind collected $45.10 from pot
*** SUMMARY ***
Total pot $47.10 | Rake $2.00
Board [8h Qd Qs 7h 6c]
Seat 1: Big Blind folded
Seat 2: Hero folded
Seat 3: Small Blind collected ($45.10)



PokerStars Hand #3961735969:  Hold'em No Limit ($2.50/$5) - 2020/06/16 14:28:28 ET
Table 'Zone Poker ID 1612' 9-max Seat #1 is the button
Seat 1: Dealer ($1309.30 in chips) 
Seat 2: Hero ($497.50 in chips) 
Seat 3: Big Blind ($758.05 in chips) 
Hero: posts small blind $2.50
Big Blind: posts big blind $5
*** HOLE CARDS ***
Dealt to Hero [Ac Jh]
Dealer: raises $10 to $15
Hero: raises $50.00 to $65
Big Blind: folds 
Dealer: calls $50
*** FLOP *** [8d 4c 2h]
Hero: bets $73.15
Dealer: calls $73.15
*** TURN *** [8d 4c 2h] [Ks]
Hero: bets $112.16
Dealer: calls $112.16
*** RIVER *** [8d 4c 2h Ks] [Kh]
Hero: checks 
Dealer: bets $503.62
Hero: folds 
*** SHOW DOWN ***
Dealer: shows [5s 3s] (a hand...)
Big Blind: shows [4s 5h] (a hand...)
Hero: shows [Ac Jh] (a hand...)
Uncalled bet ($503.62) returned to Dealer
Dealer collected $503.62 from pot
*** SUMMARY ***
Total pot $505.62 | Rake $2.00
Board [8d 4c 2h Ks Kh]
Seat 1: Dealer collected ($503.62)
Seat 2: Hero folded
Seat 3: Big Blind folded



PokerStars Hand #3961735725:  Hold'em No Limit ($2.50/$5) - 2020/06/16 14:27:45 ET
Table 'Zone Poker ID 1612' 9-max Seat #2 is the button
Seat 1: Big Blind ($529.50 in chips) 
Seat 2: Hero ($502.50 in chips) 
Seat 3: Small Blind ($1269.92 in chips) 
Small Blind: posts small blind $2.50
Big Blind: posts big blind $5
*** HOLE CARDS ***
Dealt to Hero [Ad 5d]
Hero: raises $7.50 to $12.50
Small Blind: calls $10
Big Blind: folds 
*** FLOP *** [Qs 8h 4c]
Small Blind: checks 
Hero: checks 
*** TURN *** [Qs 8h 4c] [2d]
Small Blind: bets $21.38
Hero: calls $21.38
*** RIVER *** [Qs 8h 4c 2d] [5h]
Small Blind: bets $70.76
Hero: folds 
*** SHOW DOWN ***
Small Blind: shows [Td Ac] (a hand...)
Big Blind: shows [7d Tc] (a hand...)
Hero: shows [Ad 5d] (a hand...)
Uncalled bet ($70.76) returned to Small Blind
Small Blind collected $70.76 from pot
*** SUMMARY ***
Total pot $72.76 | Rake $2.00
Board [Qs 8h 4c 2d 5h]
Seat 1: Big Blind folded
Seat 2: Hero folded
Seat 3: Small Blind collected ($70.76)



PokerStars Hand #3961697491:  Hold'em No Limit ($2.50/$5) - 2020/06/16 12:22:50 ET
Table 'Zone Poker ID 1612' 9-max Seat #1 is the button
Seat 1: Hero ($862.42 in chips) 
Seat 2: Small Blind ($1066.40 in chips) 
Seat 3: Big Blind ($524.00 in chips) 
Small Blind: posts small blind $2.50
Big Blind: posts big blind $5
*** HOLE CARDS ***
Dealt to Hero [Qc Qh]
Hero: raises $7.50 to $12.50
Small Blind: folds 
Big Blind: raises $42.50 to $55
Hero: calls $42.50
*** FLOP *** [Kd Ks 7h]
Big Blind: bets $37
Hero: calls $37
*** TURN *** [Kd Ks 7h] [Ts]
Big Blind: bets $97.25
Hero: calls $97.25
*** RIVER *** [Kd Ks 7h Ts] [6s]
Big Blind: bets $334.75 and is all-in
Hero: calls $334.75
*** SHOW DOWN ***
Small Blind: shows [9s 4d] (a hand...)
Big Blind: shows [9c 8c] (a hand...)
Hero: shows [Qc Qh] (a hand...)
Big Blind collected $1048.50 from pot
*** SUMMARY ***
Total pot $1050.50 | Rake $2.00
Board [Kd Ks 7h Ts 6s]
Seat 1: Hero showed [Qc Qh] and lost with...
Seat 2: Small Blind folded
Seat 3: Big Blind showed [9c 8c] and won ($1048.50)



PokerStars Hand #3961697306:  Hold'em No Limit ($2.50/$5) - 2020/06/16 12:22:11 ET
Table 'Zone Poker ID 1612' 9-max Seat #1 is the button
Seat 1: Hero ($882.76 in chips) 
Seat 2: Small Blind ($1063.13 in chips) 
Seat 3: Big Blind ($1045.56 in chips) 
Small Blind: posts small blind $2.50
Big Blind: posts big blind $5
*** HOLE CARDS ***
Dealt to Hero [8s Jc]
Hero: raises $7.50 to $12.50
Small Blind: folds 
Big Blind: calls $7.50
*** FLOP *** [3c Ks 5s]
Big Blind: checks 
Hero: bets $7.84
Big Blind: calls $7.84
*** TURN *** [3c Ks 5s] [Kc]
Big Blind: checks 
Hero: checks 
*** RIVER *** [3c Ks 5s Kc] [7d]
Big Blind: bets $30.89
Hero: folds 
*** SHOW DOWN ***
Small Blind: shows [5h 3s] (a hand...)
Big Blind: shows [Qd 3h] (a hand...)
Hero: shows [8s Jc] (a hand...)
Uncalled bet ($30.89) returned to Big Blind
Big Blind collected $41.18 from pot
*** SUMMARY ***
Total pot $43.18 | Rake $2.00
Board [3c Ks 5s Kc 7d]
Seat 1: Hero folded
Seat 2: Small Blind folded
Seat 3: Big Blind collected ($41.18)



PokerStars Hand #3961697298:  Hold'em No Limit ($2.50/$5) - 2020/06/16 12:22:09 ET
Table 'Zone Poker ID 1612' 9-max Seat #2 is the button
Seat 1: Hero ($703.13 in chips) 
Seat 2: Dealer ($497.50 in chips) 
Seat 3: Small Blind ($536.50 in chips) 
Small Blind: posts small blind $2.50
Hero: posts big blind $5
*** HOLE CARDS ***
Dealt to Hero [Qh 9d]
Dealer: raises $7.50 to $12.50
Small Blind: folds 
Hero: calls $7.50
*** FLOP *** [2d Ad 2s]
Hero: checks 
Dealer: bets $8.07
Hero: calls $8.07
*** TURN *** [2d Ad 2s] [Qc]
Hero: checks 
Dealer: bets $31.23
Hero: calls $31.23
*** RIVER *** [2d Ad 2s Qc] [2h]
Hero: checks 
Dealer: bets $27.05
Hero: folds 
*** SHOW DOWN ***
Small Blind: shows [3c Jc] (a hand...)
Dealer: shows [Qs Ah] (a hand...)
Hero: shows [Qh 9d] (a hand...)
Uncalled bet ($27.05) returned to Dealer
Dealer collected $104.10 from pot
*** SUMMARY ***
Total pot $106.10 | Rake $2.00
Board [2d Ad 2s Qc 2h]
Seat 1: Hero folded
Seat 2: Dealer collected ($104.10)
Seat 3: Small Blind folded



PokerStars Hand #3961695627:  Hold'em No Limit ($2.50/$5) - 2020/06/16 12:16:15 ET
Table 'Zone Poker ID 1612' 9-max Seat #2 is the button
Seat 1: Big Blind ($492.50 in chips) 
Seat 2: Dealer ($442.62 in chips) 
Seat 3: Hero ($1078.55 in chips) 
Hero: posts small blind $2.50
Big Blind: posts big blind $5
*** HOLE CARDS ***
Dealt to Hero [7c 7h]
Dealer: folds 
Hero: raises $10.00 to $15
Big Blind: raises $35 to $50
Hero: calls $35
*** FLOP *** [5d 5c Kh]
Hero: checks 
Big Blind: bets $33
Hero: calls $33
*** TURN *** [5d 5c Kh] [2s]
Hero: checks 
Big Blind: checks 
*** RIVER *** [5d 5c Kh 2s] [Jh]
Hero: checks 
Big Blind: bets $123
Hero: folds 
*** SHOW DOWN ***
Dealer: shows [6s 2d] (a hand...)
Big Blind: shows [Ks 6c] (a hand...)
Hero: shows [7c 7h] (a hand...)
Uncalled bet ($123.00) returned to Big Blind
Big Blind collected $164 from pot
*** SUMMARY ***
Total pot $166.00 | Rake $2.00
Board [5d 5c Kh 2s Jh]
Seat 1: Big Blind collected ($164)
Seat 2: Dealer folded
Seat 3: Hero folded



PokerStars Hand #3961694682:  Hold'em No Limit ($2.50/$5) - 2020/06/16 12:12:46 ET
Table 'Zone Poker ID 1612' 9-max Seat #2 is the button
Seat 1: Hero ($673.88 in chips) 
Seat 2: Dealer ($636.50 in chips) 
Dealer: posts small blind $2.50
Hero: posts big blind $5
*** HOLE CARDS ***
Dealt to Hero [Jd Kh]
Dealer: raises $7.50 to $12.50
Hero: calls $7.50
*** FLOP *** [7c 6d Kc]
Hero: checks 
Dealer: checks 
*** TURN *** [7c 6d Kc] [Ac]
Hero: checks 
Dealer: checks 
*** RIVER *** [7c 6d Kc Ac] [Tc]
Hero: checks 
Dealer: bets $18
Hero: calls $18
*** SHOW DOWN ***
Dealer: shows [Jh 2h] (a hand...)
Hero: shows [Jd Kh] (a hand...)
Hero collected $60 from pot
*** SUMMARY ***
Total pot $61.00 | Rake $1.00
Board [7c 6d Kc Ac Tc]
Seat 1: Hero showed [Jd Kh] and won ($60)
Seat 2: Dealer showed [Jh 2h] and lost with...



PokerStars Hand #3961691386:  Hold'em No Limit ($2.50/$5) - 2020/06/16 11:59:12 ET
Table 'Zone Poker ID 1612' 9-max Seat #2 is the button
Seat 1: Big Blind ($451.50 in chips) 
Seat 2: Hero ($897.40 in chips) 
Hero: posts small blind $2.50
Big Blind: posts big blind $5
*** HOLE CARDS ***
Dealt to Hero [2s Ac]
Hero: raises $7.50 to $12.50
Big Blind: calls $7.50
*** FLOP *** [Ah Th 6d]
Big Blind: checks 
Hero: checks 
*** TURN *** [Ah Th 6d] [3h]
Big Blind: bets $18
Hero: calls $18
*** RIVER *** [Ah Th 6d 3h] [Ad]
Big Blind: bets $30
Hero: calls $30
*** SHOW DOWN ***
Big Blind: shows [3d 4h] (a hand...)
Hero: shows [2s Ac] (a hand...)
Hero collected $120 from pot
*** SUMMARY ***
Total pot $121.00 | Rake $1.00
Board [Ah Th 6d 3h Ad]
Seat 1: Big Blind showed [3d 4h] and lost with...
Seat 2: Hero showed [2s Ac] and won ($120)



PokerStars Hand #3961691039:  Hold'em No Limit ($2.50/$5) - 2020/06/16 11:57:44 ET
Table 'Zone Poker ID 1612' 9-max Seat #1 is the button
Seat 1: Hero ($491.50 in chips) 
Seat 2: Big Blind ($500.00 in chips) 
Hero: posts small blind $2.50
Big Blind: posts big blind $5
*** HOLE CARDS ***
Dealt to Hero [Qc Ac]
Hero: raises $7.50 to $12.50
Big Blind: calls $7.50
*** FLOP *** [4s 8d 7c]
Big Blind: checks 
Hero: checks 
*** TURN *** [4s 8d 7c] [Jc]
Big Blind: checks 
Hero: checks 
*** RIVER *** [4s 8d 7c Jc] [3h]
Big Blind: bets $24
Hero: folds 
*** SHOW DOWN ***
Big Blind: shows [Ts 9h] (a hand...)
Hero: shows [Qc Ac] (a hand...)
Uncalled bet ($24.00) returned to Big Blind
Big Blind collected $24 from pot
*** SUMMARY ***
Total pot $25.00 | Rake $1.00
Board [4s 8d 7c Jc 3h]
Seat 1: Hero folded
Seat 2: Big Blind collected ($24)



PokerStars Hand #3961690705:  Hold'em No Limit ($2.50/$5) - 2020/06/16 11:56:21 ET
Table 'Zone Poker ID 1612' 9-max Seat #2 is the button
Seat 1: Big Blind ($413.08 in chips) 
Seat 2: Hero ($961.00 in chips) 
Hero: posts small blind $2.50
Big Blind: posts big blind $5
*** HOLE CARDS ***
Dealt to Hero [6c Ah]
Hero: raises $7.50 to $12.50
Big Blind: calls $7.50
*** FLOP *** [3c 3s 7c]
Big Blind: checks 
Hero: bets $7.20
Big Blind: calls $7.20
*** TURN *** [3c 3s 7c] [5s]
Big Blind: checks 
Hero: bets $28.80
Big Blind: calls $28.80
*** RIVER *** [3c 3s 7c 5s] [Kd]
Big Blind: checks 
Hero: bets $81.60
Big Blind: raises $282.98 to $364.58 and is all-in
Hero: folds 
*** SHOW DOWN ***
Big Blind: shows [3h 3d] (a hand...)
Hero: shows [6c Ah] (a hand...)
Uncalled bet ($282.98) returned to Big Blind
Big Blind collected $259.20 from pot
*** SUMMARY ***
Total pot $260.20 | Rake $1.00
Board [3c 3s 7c 5s Kd]
Seat 1: Big Blind collected ($259.20)
Seat 2: Hero folded



PokerStars Hand #3961688218:  Hold'em No Limit ($2.50/$5) - 2020/06/16 11:46:12 ET
Table 'Zone Poker ID 1612' 9-max Seat #3 is the button
Seat 1: Small Blind ($468.00 in chips) 
Seat 2: Hero ($838.06 in chips) 
Seat 3: Dealer ($505.08 in chips) 
Small Blind: posts small blind $2.50
Hero: posts big blind $5
*** HOLE CARDS ***
Dealt to Hero [Jc 8d]
Dealer: folds 
Small Blind: calls $2.50
Hero: checks 
*** FLOP *** [6h Tc 7h]
Small Blind: bets $7.13
Hero: calls $7.13
*** TURN *** [6h Tc 7h] [4d]
Small Blind: bets $11.53
Hero: calls $11.53
*** RIVER *** [6h Tc 7h 4d] [Ad]
Small Blind: bets $22.66
Hero: folds 
*** SHOW DOWN ***
Small Blind: shows [7c Qc] (a hand...)
Dealer: shows [8c 9s] (a hand...)
Hero: shows [Jc 8d] (a hand...)
Uncalled bet ($22.66) returned to Small Blind
Small Blind collected $45.32 from pot
*** SUMMARY ***
Total pot $47.32 | Rake $2.00
Board [6h Tc 7h 4d Ad]
Seat 1: Small Blind collected ($45.32)
Seat 2: Hero folded
Seat 3: Dealer folded



PokerStars Hand #3961687527:  Hold'em No Limit ($2.50/$5) - 2020/06/16 11:43:22 ET
Table 'Zone Poker ID 1612' 9-max Seat #3 is the button
Seat 1: Hero ($510.10 in chips) 
Seat 2: Big Blind ($713.33 in chips) 
Seat 3: Dealer ($300.26 in chips) 
Hero: posts small blind $2.50
Big Blind: posts big blind $5
*** HOLE CARDS ***
Dealt to Hero [Jd As]
Dealer: folds 
Hero: raises $10.00 to $15
Big Blind: calls $10
*** FLOP *** [Kc Js Th]
Hero: checks 
Big Blind: checks 
*** TURN *** [Kc Js Th] [Kd]
Hero: bets $8.55
Big Blind: calls $8.55
*** RIVER *** [Kc Js Th Kd] [4h]
Hero: bets $33.83
Big Blind: raises $91.38 to $125.21
Hero: folds 
*** SHOW DOWN ***
Dealer: shows [7s Qc] (a hand...)
Big Blind: shows [4s 4d] (a hand...)
Hero: shows [Jd As] (a hand...)
Uncalled bet ($91.38) returned to Big Blind
Big Blind collected $112.76 from pot
*** SUMMARY ***
Total pot $114.76 | Rake $2.00
Board [Kc Js Th Kd 4h]
Seat 1: Hero folded
Seat 2: Big Blind collected ($112.76)
Seat 3: Dealer folded



PokerStars Hand #3961687297:  Hold'em No Limit ($2.50/$5) - 2020/06/16 11:42:24 ET
Table 'Zone Poker ID 1612' 9-max Seat #2 is the button
Seat 1: Hero ($581.73 in chips) 
Seat 2: Dealer ($250.00 in chips) 
Seat 3: Small Blind ($643.70 in chips) 
Small Blind: posts small blind $2.50
Hero: posts big blind $5
*** HOLE CARDS ***
Dealt to Hero [7s Jc]
Dealer: folds 
Small Blind: raises $10.00 to $15
Hero: calls $10
*** FLOP *** [Jd 5c Qh]
Small Blind: bets $14.25
Hero: calls $14.25
*** TURN *** [Jd 5c Qh] [6s]
Small Blind: bets $42.38
Hero: calls $42.38
*** RIVER *** [Jd 5c Qh 6s] [3c]
Small Blind: bets $282
Hero: folds 
*** SHOW DOWN ***
Small Blind: shows [Qc Qd] (a hand...)
Dealer: shows [3s Th] (a hand...)
Hero: shows [7s Jc] (a hand...)
Uncalled bet ($282.00) returned to Small Blind
Small Blind collected $141.26 from pot
*** SUMMARY ***
Total pot $143.26 | Rake $2.00
Board [Jd 5c Qh 6s 3c]
Seat 1: Hero folded
Seat 2: Dealer folded
Seat 3: Small Blind collected ($141.26)



PokerStars Hand #3961684483:  Hold'em No Limit ($2.50/$5) - 2020/06/16 11:30:06 ET
Table 'Zone Poker ID 1612' 9-max Seat #2 is the button
Seat 1: Big Blind ($841.21 in chips) 
Seat 2: Hero ($513.48 in chips) 
Seat 3: Small Blind ($900.77 in chips) 
Small Blind: posts small blind $2.50
Big Blind: posts big blind $5
*** HOLE CARDS ***
Dealt to Hero [Ac 5h]
Hero: raises $7.50 to $12.50
Small Blind: folds 
Big Blind: calls $7.50
*** FLOP *** [4h 7s 6h]
Big Blind: checks 
Hero: checks 
*** TURN *** [4h 7s 6h] [8c]
Big Blind: bets $19.60
Hero: calls $19.60
*** RIVER *** [4h 7s 6h 8c] [8d]
Big Blind: bets $48.53
Hero: calls $48.53
*** SHOW DOWN ***
Small Blind: shows [3d 6c] (a hand...)
Big Blind: shows [5d 5s] (a hand...)
Hero: shows [Ac 5h] (a hand...)
Big Blind collected $80.88 from pot
Hero collected $80.88 from pot
*** SUMMARY ***
Total pot $163.76 | Rake $2.00
Board [4h 7s 6h 8c 8d]
Seat 1: Big Blind showed [5d 5s] and won ($80.88)
Seat 2: Hero showed [Ac 5h] and won ($80.88)
Seat 3: Small Blind folded



PokerStars Hand #3961447758:  Hold'em No Limit ($2.50/$5) - 2020/06/15 22:09:43 ET
Table 'Zone Poker ID 1612' 9-max Seat #3 is the button
Seat 1: Big Blind ($828.43 in chips) 
Seat 2: UTG ($530.21 in chips) 
Seat 3: Hero ($707.93 in chips) 
Seat 4: Small Blind ($634.72 in chips) 
Small Blind: posts small blind $2.50
Big Blind: posts big blind $5
*** HOLE CARDS ***
Dealt to Hero [Jc Kh]
UTG: folds 
Hero: raises $7.50 to $12.50
Small Blind: folds 
Big Blind: calls $7.50
*** FLOP *** [4h 2s Ks]
Big Blind: checks 
Hero: bets $7.84
Big Blind: raises $26.36 to $34.20
Hero: calls $26.36
*** TURN *** [4h 2s Ks] [4c]
Big Blind: bets $64.68
Hero: calls $64.68
*** RIVER *** [4h 2s Ks 4c] [Ah]
Big Blind: bets $291.70
Hero: folds 
*** SHOW DOWN ***
Small Blind: shows [Jd 2c] (a hand...)
UTG: shows [7s Kd] (a hand...)
Big Blind: shows [3h 5h] (a hand...)
Hero: shows [Jc Kh] (a hand...)
Uncalled bet ($291.70) returned to Big Blind
Big Blind collected $222.26 from pot
*** SUMMARY ***
Total pot $225.26 | Rake $3.00
Board [4h 2s Ks 4c Ah]
Seat 1: Big Blind collected ($222.26)
Seat 2: UTG folded
Seat 3: Hero folded
Seat 4: Small Blind folded



PokerStars Hand #3961447188:  Hold'em No Limit ($2.50/$5) - 2020/06/15 22:08:40 ET
Table 'Zone Poker ID 1612' 9-max Seat #4 is the button
Seat 1: Small Blind ($538.39 in chips) 
Seat 2: Hero ($747.45 in chips) 
Seat 3: UTG ($350.00 in chips) 
Seat 4: Dealer ($522.71 in chips) 
Small Blind: posts small blind $2.50
Hero: posts big blind $5
*** HOLE CARDS ***
Dealt to Hero [9d 9s]
UTG: folds 
Dealer: folds 
Small Blind: raises $10.00 to $15
Hero: raises $30 to $45
Small Blind: calls $30
*** FLOP *** [Qh 5c Ah]
Small Blind: checks 
Hero: checks 
*** TURN *** [Qh 5c Ah] [3c]
Small Blind: checks 
Hero: checks 
*** RIVER *** [Qh 5c Ah 3c] [Ac]
Small Blind: bets $120
Hero: folds 
*** SHOW DOWN ***
Small Blind: shows [8c 8s] (a hand...)
UTG: shows [7c 4s] (a hand...)
Dealer: shows [5s 2h] (a hand...)
Hero: shows [9d 9s] (a hand...)
Uncalled bet ($120.00) returned to Small Blind
Small Blind collected $87 from pot
*** SUMMARY ***
Total pot $90.00 | Rake $3.00
Board [Qh 5c Ah 3c Ac]
Seat 1: Small Blind collected ($87)
Seat 2: Hero folded
Seat 3: UTG folded
Seat 4: Dealer folded



PokerStars Hand #3961446343:  Hold'em No Limit ($2.50/$5) - 2020/06/15 22:07:07 ET
Table 'Zone Poker ID 1612' 9-max Seat #3 is the button
Seat 1: Hero ($583.67 in chips) 
Seat 2: UTG ($542.50 in chips) 
Seat 3: Dealer ($530.21 in chips) 
Seat 4: Small Blind ($177.90 in chips) 
Small Blind: posts small blind $2.50
Hero: posts big blind $5
*** HOLE CARDS ***
Dealt to Hero [Kd 2d]
UTG: folds 
Dealer: folds 
Small Blind: raises $10.00 to $15
Hero: calls $10
*** FLOP *** [7s Qd Kh]
Small Blind: bets $21.38
Hero: calls $21.38
*** TURN *** [7s Qd Kh] [5c]
Small Blind: bets $34.88
Hero: calls $34.88
*** RIVER *** [7s Qd Kh 5c] [8h]
Small Blind: bets $66
Hero: calls $66
*** SHOW DOWN ***
Small Blind: shows [5h Ac] (a hand...)
UTG: shows [4c 8d] (a hand...)
Dealer: shows [9d 3s] (a hand...)
Hero: shows [Kd 2d] (a hand...)
Hero collected $271.52 from pot
*** SUMMARY ***
Total pot $274.52 | Rake $3.00
Board [7s Qd Kh 5c 8h]
Seat 1: Hero showed [Kd 2d] and won ($271.52)
Seat 2: UTG folded
Seat 3: Dealer folded
Seat 4: Small Blind showed [5h Ac] and lost with...



PokerStars Hand #3961444882:  Hold'em No Limit ($2.50/$5) - 2020/06/15 22:04:23 ET
Table 'Zone Poker ID 1612' 9-max Seat #1 is the button
Seat 1: Dealer ($793.93 in chips) 
Seat 2: Hero ($799.20 in chips) 
Seat 3: Big Blind ($507.50 in chips) 
Seat 4: UTG ($523.13 in chips) 
Seat 5: UTG+1 ($517.50 in chips) 
Hero: posts small blind $2.50
Big Blind: posts big blind $5
*** HOLE CARDS ***
Dealt to Hero [Kc Kd]
UTG: folds 
UTG+1: folds 
Dealer: folds 
Hero: raises $10.00 to $15
Big Blind: calls $10
*** FLOP *** [8c 9s Td]
Hero: checks 
Big Blind: bets $9.25
Hero: calls $9.25
*** TURN *** [8c 9s Td] [9h]
Hero: checks 
Big Blind: checks 
*** RIVER *** [8c 9s Td 9h] [Jd]
Hero: checks 
Big Blind: bets $56.23
Hero: folds 
*** SHOW DOWN ***
Big Blind: shows [7c Qh] (a hand...)
Hero: shows [Kc Kd] (a hand...)
Dealer: shows [Qc 7h] (a hand...)
UTG: shows [Ah 4d] (a hand...)
UTG+1: shows [7s 3s] (a hand...)
Uncalled bet ($56.23) returned to Big Blind
Big Blind collected $46.08 from pot
*** SUMMARY ***
Total pot $48.50 | Rake $2.42
Board [8c 9s Td 9h Jd]
Seat 1: Dealer folded
Seat 2: Hero folded
Seat 3: Big Blind collected ($46.08)
Seat 4: UTG folded
Seat 5: UTG+1 folded



PokerStars Hand #3961444851:  Hold'em No Limit ($2.50/$5) - 2020/06/15 22:04:19 ET
Table 'Zone Poker ID 1612' 9-max Seat #1 is the button
Seat 1: Hero ($601.29 in chips) 
Seat 2: Small Blind ($515.63 in chips) 
Seat 3: Big Blind ($674.09 in chips) 
Seat 4: UTG ($631.49 in chips) 
Seat 5: UTG+1 ($291.25 in chips) 
Small Blind: posts small blind $2.50
Big Blind: posts big blind $5
*** HOLE CARDS ***
Dealt to Hero [Th Jd]
UTG: folds 
UTG+1: calls $5
Hero: raises $15 to $20
Small Blind: folds 
Big Blind: folds 
UTG+1: calls $15
*** FLOP *** [2h As Ts]
UTG+1: checks 
Hero: checks 
*** TURN *** [2h As Ts] [3c]
UTG+1: checks 
Hero: bets $15
UTG+1: calls $15
*** RIVER *** [2h As Ts 3c] [4c]
UTG+1: bets $74.50
Hero: folds 
*** SHOW DOWN ***
Small Blind: shows [Ad Jh] (a hand...)
Big Blind: shows [5h 3h] (a hand...)
Hero: shows [Th Jd] (a hand...)
UTG: shows [7d Ks] (a hand...)
UTG+1: shows [3s 4s] (a hand...)
Uncalled bet ($74.50) returned to UTG+1
UTG+1 collected $74.50 from pot
*** SUMMARY ***
Total pot $77.50 | Rake $3.00
Board [2h As Ts 3c 4c]
Seat 1: Hero folded
Seat 2: Small Blind folded
Seat 3: Big Blind folded
Seat 4: UTG folded
Seat 5: UTG+1 collected ($74.50)



PokerStars Hand #3961440303:  Hold'em No Limit ($2.50/$5) - 2020/06/15 21:56:08 ET
Table 'Zone Poker ID 1612' 9-max Seat #4 is the button
Seat 1: Small Blind ($767.57 in chips) 
Seat 2: Hero ($590.79 in chips) 
Seat 3: UTG ($663.82 in chips) 
Seat 4: Dealer ($521.88 in chips) 
Small Blind: posts small blind $2.50
Hero: posts big blind $5
*** HOLE CARDS ***
Dealt to Hero [5d Jc]
UTG: folds 
Dealer: folds 
Small Blind: calls $2.50
Hero: checks 
*** FLOP *** [5s Ac Th]
Small Blind: checks 
Hero: checks 
*** TURN *** [5s Ac Th] [3d]
Small Blind: checks 
Hero: checks 
*** RIVER *** [5s Ac Th 3d] [Kc]
Small Blind: bets $10
Hero: folds 
*** SHOW DOWN ***
Small Blind: shows [6s Ks] (a hand...)
UTG: shows [Td 2h] (a hand...)
Dealer: shows [4s 5h] (a hand...)
Hero: shows [5d Jc] (a hand...)
Uncalled bet ($10.00) returned to Small Blind
Small Blind collected $9.50 from pot
*** SUMMARY ***
Total pot $10.00 | Rake $0.50
Board [5s Ac Th 3d Kc]
Seat 1: Small Blind collected ($9.50)
Seat 2: Hero folded
Seat 3: UTG folded
Seat 4: Dealer folded



PokerStars Hand #3961435883:  Hold'em No Limit ($2.50/$5) - 2020/06/15 21:47:49 ET
Table 'Zone Poker ID 1612' 9-max Seat #2 is the button
Seat 1: Hero ($983.96 in chips) 
Seat 2: Dealer ($515.00 in chips) 
Seat 3: Small Blind ($666.47 in chips) 
Small Blind: posts small blind $2.50
Hero: posts big blind $5
*** HOLE CARDS ***
Dealt to Hero [Td Kh]
Dealer: folds 
Small Blind: raises $10.00 to $15
Hero: calls $10
*** FLOP *** [Ts 5h 5d]
Small Blind: checks 
Hero: bets $8.55
Small Blind: calls $8.55
*** TURN *** [Ts 5h 5d] [As]
Small Blind: checks 
Hero: checks 
*** RIVER *** [Ts 5h 5d As] [8c]
Small Blind: bets $36.98
Hero: calls $36.98
*** SHOW DOWN ***
Small Blind: shows [Js 7s] (a hand...)
Dealer: shows [9d 5c] (a hand...)
Hero: shows [Td Kh] (a hand...)
Hero collected $119.06 from pot
*** SUMMARY ***
Total pot $121.06 | Rake $2.00
Board [Ts 5h 5d As 8c]
Seat 1: Hero showed [Td Kh] and won ($119.06)
Seat 2: Dealer folded
Seat 3: Small Blind showed [Js 7s] and lost with...



PokerStars Hand #3961435861:  Hold'em No Limit ($2.50/$5) - 2020/06/15 21:47:47 ET
Table 'Zone Poker ID 1612' 9-max Seat #3 is the button
Seat 1: Small Blind ($489.50 in chips) 
Seat 2: Hero ($551.89 in chips) 
Seat 3: Dealer ($688.79 in chips) 
Small Blind: posts small blind $2.50
Hero: posts big blind $5
*** HOLE CARDS ***
Dealt to Hero [4h 2h]
Dealer: folds 
Small Blind: raises $10.00 to $15
Hero: calls $10
*** FLOP *** [7c 3h Qd]
Small Blind: bets $10
Hero: raises $24.25 to $34.25
Small Blind: calls $24.25
*** TURN *** [7c 3h Qd] [3s]
Small Blind: checks 
Hero: checks 
*** RIVER *** [7c 3h Qd 3s] [9s]
Small Blind: bets $72.38
Hero: folds 
*** SHOW DOWN ***
Small Blind: shows [5c Ac] (a hand...)
Dealer: shows [9h 4d] (a hand...)
Hero: shows [4h 2h] (a hand...)
Uncalled bet ($72.38) returned to Small Blind
Small Blind collected $96.50 from pot
*** SUMMARY ***
Total pot $98.50 | Rake $2.00
Board [7c 3h Qd 3s 9s]
Seat 1: Small Blind collected ($96.50)
Seat 2: Hero folded
Seat 3: Dealer folded



PokerStars Hand #3961430170:  Hold'em No Limit ($2.50/$5) - 2020/06/15 21:36:52 ET
Table 'Zone Poker ID 1612' 9-max Seat #1 is the button
Seat 1: Hero ($535.29 in chips) 
Seat 2: Small Blind ($508.88 in chips) 
Seat 3: Big Blind ($634.38 in chips) 
Small Blind: posts small blind $2.50
Big Blind: posts big blind $5
*** HOLE CARDS ***
Dealt to Hero [4d Qd]
Hero: raises $7.50 to $12.50
Small Blind: calls $10
Big Blind: folds 
*** FLOP *** [Jd Ts 4s]
Small Blind: checks 
Hero: bets $8.55
Small Blind: calls $8.55
*** TURN *** [Jd Ts 4s] [2h]
Small Blind: checks 
Hero: checks 
*** RIVER *** [Jd Ts 4s 2h] [Ac]
Small Blind: bets $10
Hero: calls $10
*** SHOW DOWN ***
Small Blind: shows [Qc Tc] (a hand...)
Big Blind: shows [7s Qh] (a hand...)
Hero: shows [4d Qd] (a hand...)
Small Blind collected $65.10 from pot
*** SUMMARY ***
Total pot $67.10 | Rake $2.00
Board [Jd Ts 4s 2h Ac]
Seat 1: Hero showed [4d Qd] and lost with...
Seat 2: Small Blind showed [Qc Tc] and won ($65.10)
Seat 3: Big Blind folded



PokerStars Hand #3961424224:  Hold'em No Limit ($2.50/$5) - 2020/06/15 21:25:30 ET
Table 'Zone Poker ID 1612' 9-max Seat #3 is the button
Seat 1: Small Blind ($350.75 in chips) 
Seat 2: Big Blind ($617.46 in chips) 
Seat 3: Hero ($457.50 in chips) 
Small Blind: posts small blind $2.50
Big Blind: posts big blind $5
*** HOLE CARDS ***
Dealt to Hero [Qc Kh]
Hero: raises $7.50 to $12.50
Small Blind: calls $10
Big Blind: calls $7.50
*** FLOP *** [8h 7h Jc]
Small Blind: checks 
Big Blind: checks 
Hero: checks 
*** TURN *** [8h 7h Jc] [Tc]
Small Blind: checks 
Big Blind: bets $26.72
Hero: calls $26.72
Small Blind: folds 
*** RIVER *** [8h 7h Jc Tc] [Js]
Big Blind: bets $66.71
Hero: folds 
*** SHOW DOWN ***
Small Blind: shows [6h 6c] (a hand...)
Big Blind: shows [9h Qh] (a hand...)
Hero: shows [Qc Kh] (a hand...)
Uncalled bet ($66.71) returned to Big Blind
Big Blind collected $88.94 from pot
*** SUMMARY ***
Total pot $90.94 | Rake $2.00
Board [8h 7h Jc Tc Js]
Seat 1: Small Blind folded
Seat 2: Big Blind collected ($88.94)
Seat 3: Hero folded



PokerStars Hand #3961418146:  Hold'em No Limit ($2.50/$5) - 2020/06/15 21:13:31 ET
Table 'Zone Poker ID 1612' 9-max Seat #2 is the button
Seat 1: Big Blind ($478.95 in chips) 
Seat 2: Hero ($484.87 in chips) 
Seat 3: Small Blind ($949.88 in chips) 
Small Blind: posts small blind $2.50
Big Blind: posts big blind $5
*** HOLE CARDS ***
Dealt to Hero [2d Kd]
Hero: raises $7.50 to $12.50
Small Blind: calls $10
Big Blind: calls $7.50
*** FLOP *** [8d Ac 6d]
Small Blind: checks 
Big Blind: checks 
Hero: checks 
*** TURN *** [8d Ac 6d] [5d]
Small Blind: checks 
Big Blind: bets $17.82
Hero: calls $17.82
Small Blind: calls $17.82
*** RIVER *** [8d Ac 6d 5d] [6s]
Small Blind: checks 
Big Blind: bets $64.48
Hero: calls $64.48
Small Blind: folds 
*** SHOW DOWN ***
Small Blind: shows [Ts Ad] (a hand...)
Big Blind: shows [6h 8c] (a hand...)
Hero: shows [2d Kd] (a hand...)
Big Blind collected $217.92 from pot
*** SUMMARY ***
Total pot $219.92 | Rake $2.00
Board [8d Ac 6d 5d 6s]
Seat 1: Big Blind showed [6h 8c] and won ($217.92)
Seat 2: Hero showed [2d Kd] and lost with...
Seat 3: Small Blind folded



PokerStars Hand #3961416102:  Hold'em No Limit ($2.50/$5) - 2020/06/15 21:09:23 ET
Table 'Zone Poker ID 1612' 9-max Seat #2 is the button
Seat 1: Hero ($830.98 in chips) 
Seat 2: Dealer ($505.00 in chips) 
Seat 3: Small Blind ($764.87 in chips) 
Small Blind: posts small blind $2.50
Hero: posts big blind $5
*** HOLE CARDS ***
Dealt to Hero [8h Td]
Dealer: folds 
Small Blind: raises $10.00 to $15
Hero: calls $10
*** FLOP *** [2d 6s Qd]
Small Blind: bets $15
Hero: calls $15
*** TURN *** [2d 6s Qd] [6c]
Small Blind: checks 
Hero: checks 
*** RIVER *** [2d 6s Qd 6c] [3c]
Small Blind: bets $58
Hero: folds 
*** SHOW DOWN ***
Small Blind: shows [Qc Qh] (a hand...)
Dealer: shows [3h Js] (a hand...)
Hero: shows [8h Td] (a hand...)
Uncalled bet ($58.00) returned to Small Blind
Small Blind collected $58 from pot
*** SUMMARY ***
Total pot $60.00 | Rake $2.00
Board [2d 6s Qd 6c 3c]
Seat 1: Hero folded
Seat 2: Dealer folded
Seat 3: Small Blind collected ($58)



PokerStars Hand #3961414606:  Hold'em No Limit ($2.50/$5) - 2020/06/15 21:06:27 ET
Table 'Zone Poker ID 1612' 9-max Seat #2 is the button
Seat 1: Big Blind ($725.86 in chips) 
Seat 2: Dealer ($685.13 in chips) 
Seat 3: Hero ($502.50 in chips) 
Hero: posts small blind $2.50
Big Blind: posts big blind $5
*** HOLE CARDS ***
Dealt to Hero [Js Qh]
Dealer: folds 
Hero: raises $10.00 to $15
Big Blind: calls $10
*** FLOP *** [Ts 2c 8d]
Hero: bets $20
Big Blind: calls $20
*** TURN *** [Ts 2c 8d] [7s]
Hero: bets $51
Big Blind: calls $51
*** RIVER *** [Ts 2c 8d 7s] [Jd]
Hero: checks 
Big Blind: bets $127.50
Hero: folds 
*** SHOW DOWN ***
Dealer: shows [Td 3d] (a hand...)
Big Blind: shows [6h 6d] (a hand...)
Hero: shows [Js Qh] (a hand...)
Uncalled bet ($127.50) returned to Big Blind
Big Blind collected $170 from pot
*** SUMMARY ***
Total pot $172.00 | Rake $2.00
Board [Ts 2c 8d 7s Jd]
Seat 1: Big Blind collected ($170)
Seat 2: Dealer folded
Seat 3: Hero folded



PokerStars Hand #3961413896:  Hold'em No Limit ($2.50/$5) - 2020/06/15 21:04:58 ET
Table 'Zone Poker ID 1612' 9-max Seat #2 is the button
Seat 1: Big Blind ($670.76 in chips) 
Seat 2: Hero ($487.50 in chips) 
Seat 3: Small Blind ($417.50 in chips) 
Small Blind: posts small blind $2.50
Big Blind: posts big blind $5
*** HOLE CARDS ***
Dealt to Hero [Tc Ad]
Hero: raises $7.50 to $12.50
Small Blind: folds 
Big Blind: calls $7.50
*** FLOP *** [Qc 7s Th]
Big Blind: checks 
Hero: bets $7.84
Big Blind: calls $7.84
*** TURN *** [Qc 7s Th] [6h]
Big Blind: checks 
Hero: checks 
*** RIVER *** [Qc 7s Th 6h] [4c]
Big Blind: checks 
Hero: bets $30.89
Big Blind: raises $102.96 to $133.85
Hero: folds 
*** SHOW DOWN ***
Small Blind: shows [Jh 6s] (a hand...)
Big Blind: shows [6d 6c] (a hand...)
Hero: shows [Tc Ad] (a hand...)
Uncalled bet ($102.96) returned to Big Blind
Big Blind collected $102.96 from pot
*** SUMMARY ***
Total pot $104.96 | Rake $2.00
Board [Qc 7s Th 6h 4c]
Seat 1: Big Blind collected ($102.96)
Seat 2: Hero folded
Seat 3: Small Blind folded



PokerStars Hand #3961412278:  Hold'em No Limit ($2.50/$5) - 2020/06/15 21:01:39 ET
Table 'Zone Poker ID 1612' 9-max Seat #1 is the button
Seat 1: Dealer ($500.00 in chips) 
Seat 2: Hero ($510.63 in chips) 
Seat 3: Big Blind ($331.42 in chips) 
Hero: posts small blind $2.50
Big Blind: posts big blind $5
*** HOLE CARDS ***
Dealt to Hero [7s Ad]
Dealer: folds 
Hero: raises $10.00 to $15
Big Blind: calls $10
*** FLOP *** [6s Kc 8h]
Hero: bets $8.55
Big Blind: calls $8.55
*** TURN *** [6s Kc 8h] [9d]
Hero: bets $33.83
Big Blind: calls $33.83
*** RIVER *** [6s Kc 8h 9d] [5c]
Hero: bets $84.57
Big Blind: raises $189.47 to $274.04 and is all-in
Hero: calls $189.47
*** SHOW DOWN ***
Dealer: shows [5h 2h] (a hand...)
Big Blind: shows [Ah 6d] (a hand...)
Hero: shows [7s Ad] (a hand...)
Hero collected $660.84 from pot
*** SUMMARY ***
Total pot $662.84 | Rake $2.00
Board [6s Kc 8h 9d 5c]
Seat 1: Dealer folded
Seat 2: Hero showed [7s Ad] and won ($660.84)
Seat 3: Big Blind showed [Ah 6d] and lost with...



PokerStars Hand #3961298159:  Hold'em No Limit ($2.50/$5) - 2020/06/15 16:44:11 ET
Table 'Zone Poker ID 1612' 9-max Seat #1 is the button
Seat 1: Hero ($972.78 in chips) 
Seat 2: Small Blind ($500.00 in chips) 
Seat 3: Big Blind ($613.98 in chips) 
Small Blind: posts small blind $2.50
Big Blind: posts big blind $5
*** HOLE CARDS ***
Dealt to Hero [2c Kc]
Hero: raises $7.50 to $12.50
Small Blind: folds 
Big Blind: calls $7.50
*** FLOP *** [9s 5s 6c]
Big Blind: checks 
Hero: checks 
*** TURN *** [9s 5s 6c] [Td]
Big Blind: checks 
Hero: checks 
*** RIVER *** [9s 5s 6c Td] [Tc]
Big Blind: bets $19.60
Hero: folds 
*** SHOW DOWN ***
Small Blind: shows [7s 3d] (a hand...)
Big Blind: shows [9h Qc] (a hand...)
Hero: shows [2c Kc] (a hand...)
Uncalled bet ($19.60) returned to Big Blind
Big Blind collected $26.13 from pot
*** SUMMARY ***
Total pot $27.50 | Rake $1.37
Board [9s 5s 6c Td Tc]
Seat 1: Hero folded
Seat 2: Small Blind folded
Seat 3: Big Blind collected ($26.13)



PokerStars Hand #3961296366:  Hold'em No Limit ($2.50/$5) - 2020/06/15 16:39:34 ET
Table 'Zone Poker ID 1612' 9-max Seat #2 is the button
Seat 1: Hero ($556.07 in chips) 
Seat 2: Dealer ($507.50 in chips) 
Seat 3: Small Blind ($1051.52 in chips) 
Small Blind: posts small blind $2.50
Hero: posts big blind $5
*** HOLE CARDS ***
Dealt to Hero [As Ts]
Dealer: folds 
Small Blind: raises $10.00 to $15
Hero: raises $30 to $45
Small Blind: calls $30
*** FLOP *** [Js Jc 2s]
Small Blind: checks 
Hero: bets $26.40
Small Blind: raises $50.40 to $76.80
Hero: calls $50.40
*** TURN *** [Js Jc 2s] [5d]
Small Blind: bets $80.80
Hero: calls $80.80
*** RIVER *** [Js Jc 2s 5d] [8c]
Small Blind: bets $848.92 and is all-in
Hero: folds 
*** SHOW DOWN ***
Small Blind: shows [Jh Kd] (a hand...)
Dealer: shows [Ah 2d] (a hand...)
Hero: shows [As Ts] (a hand...)
Uncalled bet ($848.92) returned to Small Blind
Small Blind collected $403.20 from pot
*** SUMMARY ***
Total pot $405.20 | Rake $2.00
Board [Js Jc 2s 5d 8c]
Seat 1: Hero folded
Seat 2: Dealer folded
Seat 3: Small Blind collected ($403.20)



PokerStars Hand #3961295047:  Hold'em No Limit ($2.50/$5) - 2020/06/15 16:36:14 ET
Table 'Zone Poker ID 1612' 9-max Seat #3 is the button
Seat 1: Small Blind ($2217.75 in chips) 
Seat 2: Big Blind ($505.00 in chips) 
Seat 3: Hero ($619.68 in chips) 
Small Blind: posts small blind $2.50
Big Blind: posts big blind $5
*** HOLE CARDS ***
Dealt to Hero [Tc 8c]
Hero: raises $7.50 to $12.50
Small Blind: raises $37.50 to $50
Big Blind: folds 
Hero: calls $37.50
*** FLOP *** [Qc 2d Js]
Small Blind: bets $30
Hero: calls $30
*** TURN *** [Qc 2d Js] [Qh]
Small Blind: checks 
Hero: checks 
*** RIVER *** [Qc 2d Js Qh] [Ts]
Small Blind: bets $122.25
Hero: folds 
*** SHOW DOWN ***
Small Blind: shows [Ac Ah] (a hand...)
Big Blind: shows [3s 4h] (a hand...)
Hero: shows [Tc 8c] (a hand...)
Uncalled bet ($122.25) returned to Small Blind
Small Blind collected $163 from pot
*** SUMMARY ***
Total pot $165.00 | Rake $2.00
Board [Qc 2d Js Qh Ts]
Seat 1: Small Blind collected ($163)
Seat 2: Big Blind folded
Seat 3: Hero folded



PokerStars Hand #3961272755:  Hold'em No Limit ($2.50/$5) - 2020/06/15 15:35:51 ET
Table 'Zone Poker ID 1612' 9-max Seat #2 is the button
Seat 1: Big Blind ($517.50 in chips) 
Seat 2: Hero ($1139.91 in chips) 
Seat 3: Small Blind ($2072.50 in chips) 
Small Blind: posts small blind $2.50
Big Blind: posts big blind $5
*** HOLE CARDS ***
Dealt to Hero [Ad Kd]
Hero: raises $7.50 to $12.50
Small Blind: folds 
Big Blind: raises $22.50 to $35
Hero: raises $57.50 to $92.50
Big Blind: calls $57.50
*** FLOP *** [4h 9d Ac]
Big Blind: checks 
Hero: bets $55.65
Big Blind: raises $55.65 to $111.30
Hero: calls $55.65
*** TURN *** [4h 9d Ac] [5d]
Big Blind: checks 
Hero: checks 
*** RIVER *** [4h 9d Ac 5d] [Jc]
Big Blind: bets $313.70 and is all-in
Hero: calls $313.70
*** SHOW DOWN ***
Small Blind: shows [Qc 7c] (a hand...)
Big Blind: shows [7s 7h] (a hand...)
Hero: shows [Ad Kd] (a hand...)
Hero collected $1035.50 from pot
*** SUMMARY ***
Total pot $1037.50 | Rake $2.00
Board [4h 9d Ac 5d Jc]
Seat 1: Big Blind showed [7s 7h] and lost with...
Seat 2: Hero showed [Ad Kd] and won ($1035.50)
Seat 3: Small Blind folded



PokerStars Hand #3961271575:  Hold'em No Limit ($2.50/$5) - 2020/06/15 15:32:30 ET
Table 'Zone Poker ID 1612' 9-max Seat #3 is the button
Seat 1: Small Blind ($432.50 in chips) 
Seat 2: Big Blind ($605.48 in chips) 
Seat 3: Hero ($1140.66 in chips) 
Small Blind: posts small blind $2.50
Big Blind: posts big blind $5
*** HOLE CARDS ***
Dealt to Hero [4h 5h]
Hero: raises $7.50 to $12.50
Small Blind: folds 
Big Blind: calls $7.50
*** FLOP *** [7s 5d Qc]
Big Blind: checks 
Hero: bets $7.84
Big Blind: raises $20.91 to $28.75
Hero: calls $20.91
*** TURN *** [7s 5d Qc] [Kh]
Big Blind: checks 
Hero: checks 
*** RIVER *** [7s 5d Qc Kh] [9s]
Big Blind: bets $21.50
Hero: folds 
*** SHOW DOWN ***
Small Blind: shows [3s 5s] (a hand...)
Big Blind: shows [Qs Jd] (a hand...)
Hero: shows [4h 5h] (a hand...)
Uncalled bet ($21.50) returned to Big Blind
Big Blind collected $83 from pot
*** SUMMARY ***
Total pot $85.00 | Rake $2.00
Board [7s 5d Qc Kh 9s]
Seat 1: Small Blind folded
Seat 2: Big Blind collected ($83)
Seat 3: Hero folded



PokerStars Hand #3961269242:  Hold'em No Limit ($2.50/$5) - 2020/06/15 15:25:47 ET
Table 'Zone Poker ID 1612' 9-max Seat #3 is the button
Seat 1: Hero ($432.20 in chips) 
Seat 2: Big Blind ($1388.61 in chips) 
Seat 3: Dealer ($497.50 in chips) 
Hero: posts small blind $2.50
Big Blind: posts big blind $5
*** HOLE CARDS ***
Dealt to Hero [As 9s]
Dealer: folds 
Hero: raises $10.00 to $15
Big Blind: calls $10
*** FLOP *** [Jd 7d 4c]
Hero: checks 
Big Blind: bets $9.25
Hero: calls $9.25
*** TURN *** [Jd 7d 4c] [9d]
Hero: checks 
Big Blind: bets $34.88
Hero: calls $34.88
*** RIVER *** [Jd 7d 4c 9d] [5h]
Hero: checks 
Big Blind: bets $82.20
Hero: calls $82.20
*** SHOW DOWN ***
Dealer: shows [2s 4d] (a hand...)
Big Blind: shows [7s 9h] (a hand...)
Hero: shows [As 9s] (a hand...)
Big Blind collected $280.66 from pot
*** SUMMARY ***
Total pot $282.66 | Rake $2.00
Board [Jd 7d 4c 9d 5h]
Seat 1: Hero showed [As 9s] and lost with...
Seat 2: Big Blind showed [7s 9h] and won ($280.66)
Seat 3: Dealer folded



PokerStars Hand #3961268853:  Hold'em No Limit ($2.50/$5) - 2020/06/15 15:24:40 ET
Table 'Zone Poker ID 1612' 9-max Seat #2 is the button
Seat 1: Hero ($484.00 in chips) 
Seat 2: Dealer ($1336.31 in chips) 
Seat 3: Small Blind ($909.76 in chips) 
Small Blind: posts small blind $2.50
Hero: posts big blind $5
*** HOLE CARDS ***
Dealt to Hero [Ad 2d]
Dealer: raises $7.50 to $12.50
Small Blind: folds 
Hero: calls $7.50
*** FLOP *** [Jh 8c Ac]
Hero: checks 
Dealer: bets $8.07
Hero: calls $8.07
*** TURN *** [Jh 8c Ac] [7h]
Hero: checks 
Dealer: bets $31.23
Hero: calls $31.23
*** RIVER *** [Jh 8c Ac 7h] [Qs]
Hero: checks 
Dealer: bets $149.10
Hero: folds 
*** SHOW DOWN ***
Small Blind: shows [5c 7d] (a hand...)
Dealer: shows [Jd Jc] (a hand...)
Hero: shows [Ad 2d] (a hand...)
Uncalled bet ($149.10) returned to Dealer
Dealer collected $104.10 from pot
*** SUMMARY ***
Total pot $106.10 | Rake $2.00
Board [Jh 8c Ac 7h Qs]
Seat 1: Hero folded
Seat 2: Dealer collected ($104.10)
Seat 3: Small Blind folded



PokerStars Hand #3961268372:  Hold'em No Limit ($2.50/$5) - 2020/06/15 15:23:15 ET
Table 'Zone Poker ID 1612' 9-max Seat #2 is the button
Seat 1: Hero ($500.00 in chips) 
Seat 2: Dealer ($689.52 in chips) 
Seat 3: Small Blind ($1352.31 in chips) 
Small Blind: posts small blind $2.50
Hero: posts big blind $5
*** HOLE CARDS ***
Dealt to Hero [Qd As]
Dealer: folds 
Small Blind: raises $10.00 to $15
Hero: raises $30 to $45
Small Blind: calls $30
*** FLOP *** [Th Jh Qs]
Small Blind: checks 
Hero: checks 
*** TURN *** [Th Jh Qs] [Ks]
Small Blind: checks 
Hero: checks 
*** RIVER *** [Th Jh Qs Ks] [8s]
Small Blind: bets $64
Hero: calls $64
*** SHOW DOWN ***
Small Blind: shows [Jc Ac] (a hand...)
Dealer: shows [9s 6d] (a hand...)
Hero: shows [Qd As] (a hand...)
Hero collected $108 from pot
Small Blind collected $108 from pot
*** SUMMARY ***
Total pot $218.00 | Rake $2.00
Board [Th Jh Qs Ks 8s]
Seat 1: Hero showed [Qd As] and won ($108)
Seat 2: Dealer folded
Seat 3: Small Blind showed [Jc Ac] and won ($108)



PokerStars Hand #3961267727:  Hold'em No Limit ($2.50/$5) - 2020/06/15 15:21:22 ET
Table 'Zone Poker ID 1612' 9-max Seat #1 is the button
Seat 1: Dealer ($505.00 in chips) 
Seat 2: Hero ($487.50 in chips) 
Seat 3: Big Blind ($502.50 in chips) 
Hero: posts small blind $2.50
Big Blind: posts big blind $5
*** HOLE CARDS ***
Dealt to Hero [Qc Ad]
Dealer: raises $7.50 to $12.50
Hero: raises $40.00 to $52.50
Big Blind: folds 
Dealer: calls $40
*** FLOP *** [6h 7s Ac]
Hero: bets $32.40
Dealer: calls $32.40
*** TURN *** [6h 7s Ac] [7h]
Hero: checks 
Dealer: bets $86.40
Hero: calls $86.40
*** RIVER *** [6h 7s Ac 7h] [2d]
Hero: checks 
Dealer: bets $333.70 and is all-in
Hero: calls $316.20 and is all-in
*** SHOW DOWN ***
Dealer: shows [As Jc] (a hand...)
Big Blind: shows [3h 9s] (a hand...)
Hero: shows [Qc Ad] (a hand...)
Uncalled bet ($17.50) returned to Dealer
Hero collected $978 from pot
*** SUMMARY ***
Total pot $980.00 | Rake $2.00
Board [6h 7s Ac 7h 2d]
Seat 1: Dealer showed [As Jc] and lost with...
Seat 2: Hero showed [Qc Ad] and won ($978)
Seat 3: Big Blind folded



PokerStars Hand #3961267712:  Hold'em No Limit ($2.50/$5) - 2020/06/15 15:21:20 ET
Table 'Zone Poker ID 1612' 9-max Seat #3 is the button
Seat 1: Small Blind ($764.01 in chips) 
Seat 2: Big Blind ($500.00 in chips) 
Seat 3: Hero ($490.00 in chips) 
Small Blind: posts small blind $2.50
Big Blind: posts big blind $5
*** HOLE CARDS ***
Dealt to Hero [7c 5c]
Hero: raises $7.50 to $12.50
Small Blind: raises $35.00 to $47.50
Big Blind: folds 
Hero: calls $35
*** FLOP *** [Qd Td Th]
Small Blind: checks 
Hero: checks 
*** TURN *** [Qd Td Th] [6h]
Small Blind: checks 
Hero: checks 
*** RIVER *** [Qd Td Th 6h] [2d]
Small Blind: bets $58.50
Hero: folds 
*** SHOW DOWN ***
Small Blind: shows [Jd Js] (a hand...)
Big Blind: shows [Ts 4d] (a hand...)
Hero: shows [7c 5c] (a hand...)
Uncalled bet ($58.50) returned to Small Blind
Small Blind collected $98 from pot
*** SUMMARY ***
Total pot $100.00 | Rake $2.00
Board [Qd Td Th 6h 2d]
Seat 1: Small Blind collected ($98)
Seat 2: Big Blind folded
Seat 3: Hero folded



PokerStars Hand #3961267287:  Hold'em No Limit ($2.50/$5) - 2020/06/15 15:20:04 ET
Table 'Zone Poker ID 1612' 9-max Seat #3 is the button
Seat 1: Small Blind ($1199.17 in chips) 
Seat 2: Big Blind ($497.50 in chips) 
Seat 3: Hero ($502.50 in chips) 
Small Blind: posts small blind $2.50
Big Blind: posts big blind $5
*** HOLE CARDS ***
Dealt to Hero [Ah 4d]
Hero: raises $7.50 to $12.50
Small Blind: folds 
Big Blind: calls $7.50
*** FLOP *** [8c 6d 3c]
Big Blind: checks 
Hero: checks 
*** TURN *** [8c 6d 3c] [2d]
Big Blind: checks 
Hero: checks 
*** RIVER *** [8c 6d 3c 2d] [8h]
Big Blind: bets $19.60
Hero: folds 
*** SHOW DOWN ***
Small Blind: shows [6s Js] (a hand...)
Big Blind: shows [8d Kd] (a hand...)
Hero: shows [Ah 4d] (a hand...)
Uncalled bet ($19.60) returned to Big Blind
Big Blind collected $26.13 from pot
*** SUMMARY ***
Total pot $27.50 | Rake $1.37
Board [8c 6d 3c 2d 8h]
Seat 1: Small Blind folded
Seat 2: Big Blind collected ($26.13)
Seat 3: Hero folded



PokerStars Hand #3961266890:  Hold'em No Limit ($2.50/$5) - 2020/06/15 15:18:55 ET
Table 'Zone Poker ID 1612' 9-max Seat #1 is the button
Seat 1: Dealer ($497.50 in chips) 
Seat 2: Small Blind ($764.46 in chips) 
Seat 3: Hero ($594.85 in chips) 
Small Blind: posts small blind $2.50
Hero: posts big blind $5
*** HOLE CARDS ***
Dealt to Hero [As Ks]
Dealer: folds 
Small Blind: raises $10.00 to $15
Hero: raises $30 to $45
Small Blind: calls $30
*** FLOP *** [2c 5h 4h]
Small Blind: checks 
Hero: bets $26.40
Small Blind: calls $26.40
*** TURN *** [2c 5h 4h] [Td]
Small Blind: checks 
Hero: checks 
*** RIVER *** [2c 5h 4h Td] [Ad]
Small Blind: bets $693.06 and is all-in
Hero: calls $523.45 and is all-in
*** SHOW DOWN ***
Small Blind: shows [Ac Ts] (a hand...)
Dealer: shows [9c 6d] (a hand...)
Hero: shows [As Ks] (a hand...)
Uncalled bet ($169.61) returned to Small Blind
Small Blind collected $1187.70 from pot
*** SUMMARY ***
Total pot $1189.70 | Rake $2.00
Board [2c 5h 4h Td Ad]
Seat 1: Dealer folded
Seat 2: Small Blind showed [Ac Ts] and won ($1187.70)
Seat 3: Hero showed [As Ks] and lost with...



PokerStars Hand #3961266816:  Hold'em No Limit ($2.50/$5) - 2020/06/15 15:18:42 ET
Table 'Zone Poker ID 1612' 9-max Seat #3 is the button
Seat 1: Hero ($472.50 in chips) 
Seat 2: Big Blind ($512.50 in chips) 
Seat 3: Dealer ($638.70 in chips) 
Hero: posts small blind $2.50
Big Blind: posts big blind $5
*** HOLE CARDS ***
Dealt to Hero [Ad Ks]
Dealer: folds 
Hero: raises $10.00 to $15
Big Blind: calls $10
*** FLOP *** [7c 8c 8h]
Hero: checks 
Big Blind: checks 
*** TURN *** [7c 8c 8h] [Qs]
Hero: checks 
Big Blind: bets $26.38
Hero: calls $26.38
*** RIVER *** [7c 8c 8h Qs] [3h]
Hero: checks 
Big Blind: bets $30.76
Hero: calls $30.76
*** SHOW DOWN ***
Dealer: shows [3d 9d] (a hand...)
Big Blind: shows [8d Qc] (a hand...)
Hero: shows [Ad Ks] (a hand...)
Big Blind collected $142.28 from pot
*** SUMMARY ***
Total pot $144.28 | Rake $2.00
Board [7c 8c 8h Qs 3h]
Seat 1: Hero showed [Ad Ks] and lost with...
Seat 2: Big Blind showed [8d Qc] and won ($142.28)
Seat 3: Dealer folded



PokerStars Hand #3961265948:  Hold'em No Limit ($2.50/$5) - 2020/06/15 15:16:15 ET
Table 'Zone Poker ID 1612' 9-max Seat #3 is the button
Seat 1: Small Blind ($544.60 in chips) 
Seat 2: Hero ($500.00 in chips) 
Seat 3: Dealer ($732.83 in chips) 
Small Blind: posts small blind $2.50
Hero: posts big blind $5
*** HOLE CARDS ***
Dealt to Hero [8d 7h]
Dealer: raises $7.50 to $12.50
Small Blind: folds 
Hero: calls $7.50
*** FLOP *** [2d 5c Ac]
Hero: checks 
Dealer: checks 
*** TURN *** [2d 5c Ac] [9s]
Hero: checks 
Dealer: checks 
*** RIVER *** [2d 5c Ac 9s] [4d]
Hero: checks 
Dealer: bets $31.13
Hero: folds 
*** SHOW DOWN ***
Small Blind: shows [Th 6h] (a hand...)
Dealer: shows [Td Ks] (a hand...)
Hero: shows [8d 7h] (a hand...)
Uncalled bet ($31.13) returned to Dealer
Dealer collected $26.13 from pot
*** SUMMARY ***
Total pot $27.50 | Rake $1.37
Board [2d 5c Ac 9s 4d]
Seat 1: Small Blind folded
Seat 2: Hero folded
Seat 3: Dealer collected ($26.13)



PokerStars Hand #3961265887:  Hold'em No Limit ($2.50/$5) - 2020/06/15 15:16:06 ET
Table 'Zone Poker ID 1612' 9-max Seat #1 is the button
Seat 1: Dealer ($754.79 in chips) 
Seat 2: Small Blind ($117.41 in chips) 
Seat 3: Hero ($519.44 in chips) 
Small Blind: posts small blind $2.50
Hero: posts big blind $5
*** HOLE CARDS ***
Dealt to Hero [5s 6h]
Dealer: folds 
Small Blind: raises $10.00 to $15
Hero: calls $10
*** FLOP *** [9d 3c 9c]
Small Blind: checks 
Hero: checks 
*** TURN *** [9d 3c 9c] [7s]
Small Blind: bets $28.50
Hero: calls $28.50
*** RIVER *** [9d 3c 9c 7s] [4s]
Small Blind: bets $73.91 and is all-in
Hero: calls $73.91
*** SHOW DOWN ***
Small Blind: shows [Jd Jh] (a hand...)
Dealer: shows [2s 4c] (a hand...)
Hero: shows [5s 6h] (a hand...)
Hero collected $232.82 from pot
*** SUMMARY ***
Total pot $234.82 | Rake $2.00
Board [9d 3c 9c 7s 4s]
Seat 1: Dealer folded
Seat 2: Small Blind showed [Jd Jh] and lost with...
Seat 3: Hero showed [5s 6h] and won ($232.82)



PokerStars Hand #3961264453:  Hold'em No Limit ($2.50/$5) - 2020/06/15 15:11:55 ET
Table 'Zone Poker ID 1612' 9-max Seat #2 is the button
Seat 1: Hero ($486.75 in chips) 
Seat 2: Dealer ($1632.41 in chips) 
Seat 3: Small Blind ($231.31 in chips) 
Small Blind: posts small blind $2.50
Hero: posts big blind $5
*** HOLE CARDS ***
Dealt to Hero [7h 2h]
Dealer: folds 
Small Blind: calls $2.50
Hero: checks 
*** FLOP *** [8d 7d Kd]
Small Blind: checks 
Hero: checks 
*** TURN *** [8d 7d Kd] [Ts]
Small Blind: checks 
Hero: checks 
*** RIVER *** [8d 7d Kd Ts] [Kh]
Small Blind: bets $9.50
Hero: folds 
*** SHOW DOWN ***
Small Blind: shows [4d 2d] (a hand...)
Dealer: shows [Th 3h] (a hand...)
Hero: shows [7h 2h] (a hand...)
Uncalled bet ($9.50) returned to Small Blind
Small Blind collected $9.50 from pot
*** SUMMARY ***
Total pot $10.00 | Rake $0.50
Board [8d 7d Kd Ts Kh]
Seat 1: Hero folded
Seat 2: Dealer folded
Seat 3: Small Blind collected ($9.50)



PokerStars Hand #3961264183:  Hold'em No Limit ($2.50/$5) - 2020/06/15 15:11:10 ET
Table 'Zone Poker ID 1612' 9-max Seat #3 is the button
Seat 1: Small Blind ($1610.86 in chips) 
Seat 2: Hero ($497.50 in chips) 
Seat 3: Dealer ($391.35 in chips) 
Small Blind: posts small blind $2.50
Hero: posts big blind $5
*** HOLE CARDS ***
Dealt to Hero [Kd 7h]
Dealer: folds 
Small Blind: raises $10.00 to $15
Hero: calls $10
*** FLOP *** [3c 4h 3d]
Small Blind: checks 
Hero: bets $8.55
Small Blind: calls $8.55
*** TURN *** [3c 4h 3d] [As]
Small Blind: checks 
Hero: checks 
*** RIVER *** [3c 4h 3d As] [6c]
Small Blind: bets $65.10
Hero: folds 
*** SHOW DOWN ***
Small Blind: shows [Ac 6s] (a hand...)
Dealer: shows [3s 7d] (a hand...)
Hero: shows [Kd 7h] (a hand...)
Uncalled bet ($65.10) returned to Small Blind
Small Blind collected $45.10 from pot
*** SUMMARY ***
Total pot $47.10 | Rake $2.00
Board [3c 4h 3d As 6c]
Seat 1: Small Blind collected ($45.10)
Seat 2: Hero folded
Seat 3: Dealer folded



PokerStars Hand #3959872320:  Hold'em No Limit ($2.50/$5) - 2020/06/12 18:21:14 ET
Table 'Zone Poker ID 1612' 9-max Seat #3 is the button
Seat 1: Small Blind ($500.00 in chips) 
Seat 2: Big Blind ($512.50 in chips) 
Seat 3: Hero ($502.50 in chips) 
Small Blind: posts small blind $2.50
Big Blind: posts big blind $5
*** HOLE CARDS ***
Dealt to Hero [Jd As]
Hero: raises $7.50 to $12.50
Small Blind: folds 
Big Blind: calls $7.50
*** FLOP *** [Jh 8s 3d]
Big Blind: checks 
Hero: bets $8.07
Big Blind: raises $31.70 to $39.77
Hero: calls $31.70
*** TURN *** [Jh 8s 3d] [2c]
Big Blind: bets $78.78
Hero: calls $78.78
*** RIVER *** [Jh 8s 3d 2c] [Ac]
Big Blind: bets $262.60
Hero: calls $262.60
*** SHOW DOWN ***
Small Blind: shows [Jc 9h] (a hand...)
Big Blind: shows [6c 8c] (a hand...)
Hero: shows [Jd As] (a hand...)
Hero collected $787.80 from pot
*** SUMMARY ***
Total pot $789.80 | Rake $2.00
Board [Jh 8s 3d 2c Ac]
Seat 1: Small Blind folded
Seat 2: Big Blind showed [6c 8c] and lost with...
Seat 3: Hero showed [Jd As] and won ($787.80)



PokerStars Hand #3959857463:  Hold'em No Limit ($2.50/$5) - 2020/06/12 17:46:52 ET
Table 'Zone Poker ID 1612' 9-max Seat #3 is the button
Seat 1: Small Blind ($1562.89 in chips) 
Seat 2: Big Blind ($636.02 in chips) 
Seat 3: Hero ($779.57 in chips) 
Small Blind: posts small blind $2.50
Big Blind: posts big blind $5
*** HOLE CARDS ***
Dealt to Hero [As Td]
Hero: raises $7.50 to $12.50
Small Blind: folds 
Big Blind: raises $42.50 to $55
Hero: raises $70.00 to $125
Big Blind: calls $70
*** FLOP *** [2d 9c Jh]
Big Blind: checks 
Hero: checks 
*** TURN *** [2d 9c Jh] [Ts]
Big Blind: checks 
Hero: checks 
*** RIVER *** [2d 9c Jh Ts] [7s]
Big Blind: bets $50
Hero: calls $50
*** SHOW DOWN ***
Small Blind: shows [Ks 9d] (a hand...)
Big Blind: shows [Qc Tc] (a hand...)
Hero: shows [As Td] (a hand...)
Hero collected $350.50 from pot
*** SUMMARY ***
Total pot $352.50 | Rake $2.00
Board [2d 9c Jh Ts 7s]
Seat 1: Small Blind folded
Seat 2: Big Blind showed [Qc Tc] and lost with...
Seat 3: Hero showed [As Td] and won ($350.50)



PokerStars Hand #3959855654:  Hold'em No Limit ($2.50/$5) - 2020/06/12 17:42:33 ET
Table 'Zone Poker ID 1612' 9-max Seat #3 is the button
Seat 1: Small Blind ($554.55 in chips) 
Seat 2: Hero ($561.81 in chips) 
Seat 3: Dealer ($1400.78 in chips) 
Small Blind: posts small blind $2.50
Hero: posts big blind $5
*** HOLE CARDS ***
Dealt to Hero [7h Ks]
Dealer: folds 
Small Blind: raises $10.00 to $15
Hero: calls $10
*** FLOP *** [Ad 8h Ts]
Small Blind: checks 
Hero: checks 
*** TURN *** [Ad 8h Ts] [Qc]
Small Blind: checks 
Hero: checks 
*** RIVER *** [Ad 8h Ts Qc] [3s]
Small Blind: bets $5
Hero: folds 
*** SHOW DOWN ***
Small Blind: shows [9s Th] (a hand...)
Dealer: shows [4d 5s] (a hand...)
Hero: shows [7h Ks] (a hand...)
Uncalled bet ($5.00) returned to Small Blind
Small Blind collected $28.50 from pot
*** SUMMARY ***
Total pot $30.00 | Rake $1.50
Board [Ad 8h Ts Qc 3s]
Seat 1: Small Blind collected ($28.50)
Seat 2: Hero folded
Seat 3: Dealer folded



PokerStars Hand #3959855324:  Hold'em No Limit ($2.50/$5) - 2020/06/12 17:41:45 ET
Table 'Zone Poker ID 1612' 9-max Seat #2 is the button
Seat 1: Big Blind ($531.25 in chips) 
Seat 2: Hero ($581.50 in chips) 
Seat 3: Small Blind ($443.07 in chips) 
Small Blind: posts small blind $2.50
Big Blind: posts big blind $5
*** HOLE CARDS ***
Dealt to Hero [7s Qs]
Hero: raises $7.50 to $12.50
Small Blind: folds 
Big Blind: calls $7.50
*** FLOP *** [8d Qh Kd]
Big Blind: checks 
Hero: bets $8.07
Big Blind: calls $8.07
*** TURN *** [8d Qh Kd] [2s]
Big Blind: checks 
Hero: checks 
*** RIVER *** [8d Qh Kd 2s] [4c]
Big Blind: bets $20.82
Hero: calls $20.82
*** SHOW DOWN ***
Small Blind: shows [7h Js] (a hand...)
Big Blind: shows [Th 9c] (a hand...)
Hero: shows [7s Qs] (a hand...)
Hero collected $83.28 from pot
*** SUMMARY ***
Total pot $85.28 | Rake $2.00
Board [8d Qh Kd 2s 4c]
Seat 1: Big Blind showed [Th 9c] and lost with...
Seat 2: Hero showed [7s Qs] and won ($83.28)
Seat 3: Small Blind folded



PokerStars Hand #3959853790:  Hold'em No Limit ($2.50/$5) - 2020/06/12 17:38:11 ET
Table 'Zone Poker ID 1612' 9-max Seat #2 is the button
Seat 1: Hero ($481.50 in chips) 
Seat 2: Dealer ($252.50 in chips) 
Seat 3: Small Blind ($538.00 in chips) 
Small Blind: posts small blind $2.50
Hero: posts big blind $5
*** HOLE CARDS ***
Dealt to Hero [Kd 4d]
Dealer: folds 
Small Blind: raises $10.00 to $15
Hero: calls $10
*** FLOP *** [7h 3c Td]
Small Blind: checks 
Hero: bets $8.55
Small Blind: calls $8.55
*** TURN *** [7h 3c Td] [3s]
Small Blind: checks 
Hero: checks 
*** RIVER *** [7h 3c Td 3s] [8h]
Small Blind: bets $22.55
Hero: folds 
*** SHOW DOWN ***
Small Blind: shows [Ad 8d] (a hand...)
Dealer: shows [Tc 5c] (a hand...)
Hero: shows [Kd 4d] (a hand...)
Uncalled bet ($22.55) returned to Small Blind
Small Blind collected $45.10 from pot
*** SUMMARY ***
Total pot $47.10 | Rake $2.00
Board [7h 3c Td 3s 8h]
Seat 1: Hero folded
Seat 2: Dealer folded
Seat 3: Small Blind collected ($45.10)



PokerStars Hand #3959823235:  Hold'em No Limit ($2.50/$5) - 2020/06/12 16:22:31 ET
Table 'Zone Poker ID 1612' 9-max Seat #1 is the button
Seat 1: Dealer ($691.06 in chips) 
Seat 2: Small Blind ($551.91 in chips) 
Seat 3: Hero ($950.63 in chips) 
Small Blind: posts small blind $2.50
Hero: posts big blind $5
*** HOLE CARDS ***
Dealt to Hero [Ks Qc]
Dealer: raises $7.50 to $12.50
Small Blind: folds 
Hero: calls $7.50
*** FLOP *** [9s 7h Qs]
Hero: checks 
Dealer: bets $8.07
Hero: raises $26.14 to $34.21
Dealer: calls $26.14
*** TURN *** [9s 7h Qs] [3c]
Hero: bets $70.44
Dealer: calls $70.44
*** RIVER *** [9s 7h Qs 3c] [2d]
Hero: checks 
Dealer: bets $117.40
Hero: calls $117.40
*** SHOW DOWN ***
Small Blind: shows [5d 3h] (a hand...)
Dealer: shows [6s Js] (a hand...)
Hero: shows [Ks Qc] (a hand...)
Hero collected $469.60 from pot
*** SUMMARY ***
Total pot $471.60 | Rake $2.00
Board [9s 7h Qs 3c 2d]
Seat 1: Dealer showed [6s Js] and lost with...
Seat 2: Small Blind folded
Seat 3: Hero showed [Ks Qc] and won ($469.60)



PokerStars Hand #3959822704:  Hold'em No Limit ($2.50/$5) - 2020/06/12 16:21:09 ET
Table 'Zone Poker ID 1612' 9-max Seat #2 is the button
Seat 1: Big Blind ($492.50 in chips) 
Seat 2: Dealer ($415.66 in chips) 
Seat 3: Hero ($956.68 in chips) 
Hero: posts small blind $2.50
Big Blind: posts big blind $5
*** HOLE CARDS ***
Dealt to Hero [Ts As]
Dealer: folds 
Hero: raises $10.00 to $15
Big Blind: calls $10
*** FLOP *** [Kd 7h Qs]
Hero: bets $8.55
Big Blind: calls $8.55
*** TURN *** [Kd 7h Qs] [7d]
Hero: checks 
Big Blind: checks 
*** RIVER *** [Kd 7h Qs 7d] [Td]
Hero: checks 
Big Blind: bets $22.55
Hero: folds 
*** SHOW DOWN ***
Dealer: shows [2h 3h] (a hand...)
Big Blind: shows [4h 5c] (a hand...)
Hero: shows [Ts As] (a hand...)
Uncalled bet ($22.55) returned to Big Blind
Big Blind collected $45.10 from pot
*** SUMMARY ***
Total pot $47.10 | Rake $2.00
Board [Kd 7h Qs 7d Td]
Seat 1: Big Blind collected ($45.10)
Seat 2: Dealer folded
Seat 3: Hero folded



PokerStars Hand #3959818931:  Hold'em No Limit ($2.50/$5) - 2020/06/12 16:10:52 ET
Table 'Zone Poker ID 1612' 9-max Seat #2 is the button
Seat 1: Hero ($876.51 in chips) 
Seat 2: Dealer ($502.50 in chips) 
Seat 3: Small Blind ($687.77 in chips) 
Small Blind: posts small blind $2.50
Hero: posts big blind $5
*** HOLE CARDS ***
Dealt to Hero [Qs Jd]
Dealer: raises $7.50 to $12.50
Small Blind: folds 
Hero: calls $7.50
*** FLOP *** [8c 8s Ah]
Hero: checks 
Dealer: bets $8.07
Hero: calls $8.07
*** TURN *** [8c 8s Ah] [Kc]
Hero: checks 
Dealer: checks 
*** RIVER *** [8c 8s Ah Kc] [As]
Hero: bets $20.82
Dealer: raises $30.82 to $51.64
Hero: folds 
*** SHOW DOWN ***
Small Blind: shows [4d 8d] (a hand...)
Dealer: shows [7c Ad] (a hand...)
Hero: shows [Qs Jd] (a hand...)
Uncalled bet ($30.82) returned to Dealer
Dealer collected $83.28 from pot
*** SUMMARY ***
Total pot $85.28 | Rake $2.00
Board [8c 8s Ah Kc As]
Seat 1: Hero folded
Seat 2: Dealer collected ($83.28)
Seat 3: Small Blind folded



PokerStars Hand #3959818234:  Hold'em No Limit ($2.50/$5) - 2020/06/12 16:08:58 ET
Table 'Zone Poker ID 1612' 9-max Seat #2 is the button
Seat 1: Big Blind ($498.50 in chips) 
Seat 2: Hero ($939.91 in chips) 
Seat 3: Small Blind ($300.86 in chips) 
Small Blind: posts small blind $2.50
Big Blind: posts big blind $5
*** HOLE CARDS ***
Dealt to Hero [7d 9d]
Hero: raises $7.50 to $12.50
Small Blind: raises $25.00 to $37.50
Big Blind: folds 
Hero: calls $25
*** FLOP *** [2h Th 9s]
Small Blind: bets $25.90
Hero: calls $25.90
*** TURN *** [2h Th 9s] [Tc]
Small Blind: checks 
Hero: checks 
*** RIVER *** [2h Th 9s Tc] [Kc]
Small Blind: bets $85
Hero: folds 
*** SHOW DOWN ***
Small Blind: shows [Ad Jc] (a hand...)
Big Blind: shows [Td 2c] (a hand...)
Hero: shows [7d 9d] (a hand...)
Uncalled bet ($85.00) returned to Small Blind
Small Blind collected $129.80 from pot
*** SUMMARY ***
Total pot $131.80 | Rake $2.00
Board [2h Th 9s Tc Kc]
Seat 1: Big Blind folded
Seat 2: Hero folded
Seat 3: Small Blind collected ($129.80)



PokerStars Hand #3959814410:  Hold'em No Limit ($2.50/$5) - 2020/06/12 15:58:21 ET
Table 'Zone Poker ID 1612' 9-max Seat #2 is the button
Seat 1: Big Blind ($2715.12 in chips) 
Seat 2: Hero ($574.47 in chips) 
Seat 3: Small Blind ($380.99 in chips) 
Small Blind: posts small blind $2.50
Big Blind: posts big blind $5
*** HOLE CARDS ***
Dealt to Hero [Jc 9c]
Hero: raises $7.50 to $12.50
Small Blind: folds 
Big Blind: calls $7.50
*** FLOP *** [Ts Ks 2d]
Big Blind: checks 
Hero: bets $8.07
Big Blind: calls $8.07
*** TURN *** [Ts Ks 2d] [8h]
Big Blind: checks 
Hero: bets $62.46
Big Blind: calls $62.46
*** RIVER *** [Ts Ks 2d 8h] [8d]
Big Blind: bets $111
Hero: folds 
*** SHOW DOWN ***
Small Blind: shows [2s 4c] (a hand...)
Big Blind: shows [Jd 8s] (a hand...)
Hero: shows [Jc 9c] (a hand...)
Uncalled bet ($111.00) returned to Big Blind
Big Blind collected $166.56 from pot
*** SUMMARY ***
Total pot $168.56 | Rake $2.00
Board [Ts Ks 2d 8h 8d]
Seat 1: Big Blind collected ($166.56)
Seat 2: Hero folded
Seat 3: Small Blind folded



PokerStars Hand #3959813127:  Hold'em No Limit ($2.50/$5) - 2020/06/12 15:54:51 ET
Table 'Zone Poker ID 1612' 9-max Seat #3 is the button
Seat 1: Small Blind ($635.00 in chips) 
Seat 2: Hero ($504.00 in chips) 
Seat 3: Dealer ($721.26 in chips) 
Small Blind: posts small blind $2.50
Hero: posts big blind $5
*** HOLE CARDS ***
Dealt to Hero [7s Ks]
Dealer: raises $5 to $10
Small Blind: folds 
Hero: calls $5
*** FLOP *** [Jc Ts Jh]
Hero: checks 
Dealer: bets $7
Hero: calls $7
*** TURN *** [Jc Ts Jh] [Tc]
Hero: checks 
Dealer: checks 
*** RIVER *** [Jc Ts Jh Tc] [3h]
Hero: checks 
Dealer: bets $17
Hero: calls $17
*** SHOW DOWN ***
Small Blind: shows [5d 4c] (a hand...)
Dealer: shows [Qc Qh] (a hand...)
Hero: shows [7s Ks] (a hand...)
Dealer collected $68.50 from pot
*** SUMMARY ***
Total pot $70.50 | Rake $2.00
Board [Jc Ts Jh Tc 3h]
Seat 1: Small Blind folded
Seat 2: Hero showed [7s Ks] and lost with...
Seat 3: Dealer showed [Qc Qh] and won ($68.50)



PokerStars Hand #3959810491:  Hold'em No Limit ($2.50/$5) - 2020/06/12 15:47:30 ET
Table 'Zone Poker ID 1612' 9-max Seat #3 is the button
Seat 1: Small Blind ($495.00 in chips) 
Seat 2: Hero ($476.00 in chips) 
Seat 3: Dealer ($627.38 in chips) 
Small Blind: posts small blind $2.50
Hero: posts big blind $5
*** HOLE CARDS ***
Dealt to Hero [Th 8c]
Dealer: raises $5 to $10
Small Blind: folds 
Hero: calls $5
*** FLOP *** [8d 2d Jh]
Hero: checks 
Dealer: bets $9
Hero: calls $9
*** TURN *** [8d 2d Jh] [Ad]
Hero: checks 
Dealer: checks 
*** RIVER *** [8d 2d Jh Ad] [9d]
Hero: checks 
Dealer: bets $16
Hero: folds 
*** SHOW DOWN ***
Small Blind: shows [Jc 6s] (a hand...)
Dealer: shows [6h Qh] (a hand...)
Hero: shows [Th 8c] (a hand...)
Uncalled bet ($16) returned to Dealer
Dealer collected $38.50 from pot
*** SUMMARY ***
Total pot $40.50 | Rake $2.00
Board [8d 2d Jh Ad 9d]
Seat 1: Small Blind folded
Seat 2: Hero folded
Seat 3: Dealer collected ($38.50)



PokerStars Hand #3959770463:  Hold'em No Limit ($2.50/$5) - 2020/06/12 13:47:19 ET
Table 'Zone Poker ID 1612' 9-max Seat #2 is the button
Seat 1: Hero ($686.29 in chips) 
Seat 2: Dealer ($290.01 in chips) 
Dealer: posts small blind $2.50
Hero: posts big blind $5
*** HOLE CARDS ***
Dealt to Hero [8h 6c]
Dealer: raises $10.00 to $15
Hero: calls $10
*** FLOP *** [Qs 8s 4d]
Hero: checks 
Dealer: checks 
*** TURN *** [Qs 8s 4d] [Tc]
Hero: checks 
Dealer: checks 
*** RIVER *** [Qs 8s 4d Tc] [As]
Hero: checks 
Dealer: bets $20
Hero: folds 
*** SHOW DOWN ***
Dealer: shows [2d Ad] (a hand...)
Hero: shows [8h 6c] (a hand...)
Uncalled bet ($20.00) returned to Dealer
Dealer collected $29 from pot
*** SUMMARY ***
Total pot $30.00 | Rake $1.00
Board [Qs 8s 4d Tc As]
Seat 1: Hero folded
Seat 2: Dealer collected ($29)



PokerStars Hand #3959769932:  Hold'em No Limit ($2.50/$5) - 2020/06/12 13:45:36 ET
Table 'Zone Poker ID 1612' 9-max Seat #2 is the button
Seat 1: Hero ($493.50 in chips) 
Seat 2: Dealer ($484.80 in chips) 
Dealer: posts small blind $2.50
Hero: posts big blind $5
*** HOLE CARDS ***
Dealt to Hero [7c Kd]
Dealer: raises $10.00 to $15
Hero: calls $10
*** FLOP *** [Ah Ks 7d]
Hero: checks 
Dealer: bets $10
Hero: calls $10
*** TURN *** [Ah Ks 7d] [Jd]
Hero: checks 
Dealer: bets $34.50
Hero: calls $34.50
*** RIVER *** [Ah Ks 7d Jd] [Kc]
Hero: checks 
Dealer: bets $158.99
Hero: calls $158.99
*** SHOW DOWN ***
Dealer: shows [7h 7s] (a hand...)
Hero: shows [7c Kd] (a hand...)
Hero collected $435.98 from pot
*** SUMMARY ***
Total pot $436.98 | Rake $1.00
Board [Ah Ks 7d Jd Kc]
Seat 1: Hero showed [7c Kd] and won ($435.98)
Seat 2: Dealer showed [7h 7s] and lost with...



PokerStars Hand #3959768825:  Hold'em No Limit ($2.50/$5) - 2020/06/12 13:41:48 ET
Table 'Zone Poker ID 1612' 9-max Seat #1 is the button
Seat 1: Dealer ($420.80 in chips) 
Seat 2: Hero ($540.00 in chips) 
Dealer: posts small blind $2.50
Hero: posts big blind $5
*** HOLE CARDS ***
Dealt to Hero [Ah Th]
Dealer: raises $10.00 to $15
Hero: raises $45 to $60
Dealer: calls $45
*** FLOP *** [2c 6h 4s]
Hero: bets $70
Dealer: calls $70
*** TURN *** [2c 6h 4s] [3c]
Hero: checks 
Dealer: checks 
*** RIVER *** [2c 6h 4s 3c] [7c]
Hero: checks 
Dealer: bets $129.50
Hero: folds 
*** SHOW DOWN ***
Dealer: shows [6d 6c] (a hand...)
Hero: shows [Ah Th] (a hand...)
Uncalled bet ($129.50) returned to Dealer
Dealer collected $259 from pot
*** SUMMARY ***
Total pot $260.00 | Rake $1.00
Board [2c 6h 4s 3c 7c]
Seat 1: Dealer collected ($259)
Seat 2: Hero folded



PokerStars Hand #3959733370:  Hold'em No Limit ($2.50/$5) - 2020/06/12 11:25:22 ET
Table 'Zone Poker ID 1612' 9-max Seat #1 is the button
Seat 1: Hero ($500.00 in chips) 
Seat 2: Big Blind ($626.60 in chips) 
Hero: posts small blind $2.50
Big Blind: posts big blind $5
*** HOLE CARDS ***
Dealt to Hero [Kd 2s]
Hero: raises $7.50 to $12.50
Big Blind: calls $7.50
*** FLOP *** [5s 8d 7d]
Big Blind: checks 
Hero: bets $18
Big Blind: calls $18
*** TURN *** [5s 8d 7d] [Ah]
Big Blind: checks 
Hero: checks 
*** RIVER *** [5s 8d 7d Ah] [Qc]
Big Blind: bets $120
Hero: folds 
*** SHOW DOWN ***
Big Blind: shows [8s Qs] (a hand...)
Hero: shows [Kd 2s] (a hand...)
Uncalled bet ($120.00) returned to Big Blind
Big Blind collected $60 from pot
*** SUMMARY ***
Total pot $61.00 | Rake $1.00
Board [5s 8d 7d Ah Qc]
Seat 1: Hero folded
Seat 2: Big Blind collected ($60)



PokerStars Hand #3959733140:  Hold'em No Limit ($2.50/$5) - 2020/06/12 11:24:24 ET
Table 'Zone Poker ID 1612' 9-max Seat #1 is the button
Seat 1: Hero ($509.14 in chips) 
Seat 2: Big Blind ($529.30 in chips) 
Hero: posts small blind $2.50
Big Blind: posts big blind $5
*** HOLE CARDS ***
Dealt to Hero [6d 8c]
Hero: raises $7.50 to $12.50
Big Blind: calls $7.50
*** FLOP *** [6s 2c 4h]
Big Blind: checks 
Hero: bets $7.20
Big Blind: raises $27.20 to $34.40
Hero: calls $27.20
*** TURN *** [6s 2c 4h] [Ac]
Big Blind: checks 
Hero: checks 
*** RIVER *** [6s 2c 4h Ac] [7c]
Big Blind: bets $46.40
Hero: calls $46.40
*** SHOW DOWN ***
Big Blind: shows [As 5d] (a hand...)
Hero: shows [6d 8c] (a hand...)
Big Blind collected $185.60 from pot
*** SUMMARY ***
Total pot $186.60 | Rake $1.00
Board [6s 2c 4h Ac 7c]
Seat 1: Hero showed [6d 8c] and lost with...
Seat 2: Big Blind showed [As 5d] and won ($185.60)



PokerStars Hand #3959732039:  Hold'em No Limit ($2.50/$5) - 2020/06/12 11:19:57 ET
Table 'Zone Poker ID 1612' 9-max Seat #1 is the button
Seat 1: Dealer ($500.00 in chips) 
Seat 2: Hero ($704.84 in chips) 
Dealer: posts small blind $2.50
Hero: posts big blind $5
*** HOLE CARDS ***
Dealt to Hero [Kd 8s]
Dealer: raises $10.00 to $15
Hero: calls $10
*** FLOP *** [Ad Td Kh]
Hero: checks 
Dealer: bets $10
Hero: calls $10
*** TURN *** [Ad Td Kh] [6c]
Hero: checks 
Dealer: checks 
*** RIVER *** [Ad Td Kh 6c] [7c]
Hero: checks 
Dealer: bets $99
Hero: folds 
*** SHOW DOWN ***
Dealer: shows [Ks 7s] (a hand...)
Hero: shows [Kd 8s] (a hand...)
Uncalled bet ($99.00) returned to Dealer
Dealer collected $49 from pot
*** SUMMARY ***
Total pot $50.00 | Rake $1.00
Board [Ad Td Kh 6c 7c]
Seat 1: Dealer collected ($49)
Seat 2: Hero folded



PokerStars Hand #3959730812:  Hold'em No Limit ($2.50/$5) - 2020/06/12 11:14:45 ET
Table 'Zone Poker ID 1612' 9-max Seat #2 is the button
Seat 1: Hero ($487.50 in chips) 
Seat 2: Dealer ($493.00 in chips) 
Dealer: posts small blind $2.50
Hero: posts big blind $5
*** HOLE CARDS ***
Dealt to Hero [Qh Kh]
Dealer: raises $7.50 to $12.50
Hero: raises $37.50 to $50
Dealer: raises $75.00 to $125
Hero: calls $75
*** FLOP *** [Ts 8d Jh]
Hero: checks 
Dealer: checks 
*** TURN *** [Ts 8d Jh] [Qs]
Hero: checks 
Dealer: bets $55
Hero: calls $55
*** RIVER *** [Ts 8d Jh Qs] [Ah]
Hero: checks 
Dealer: bets $313 and is all-in
Hero: calls $307.50 and is all-in
*** SHOW DOWN ***
Dealer: shows [Ad Ks] (a hand...)
Hero: shows [Qh Kh] (a hand...)
Uncalled bet ($5.50) returned to Dealer
Hero collected $487 from pot
Dealer collected $487 from pot
*** SUMMARY ***
Total pot $975.00 | Rake $1.00
Board [Ts 8d Jh Qs Ah]
Seat 1: Hero showed [Qh Kh] and won ($487)
Seat 2: Dealer showed [Ad Ks] and won ($487)



PokerStars Hand #3959511335:  Hold'em No Limit ($2.50/$5) - 2020/06/11 22:45:02 ET
Table 'Zone Poker ID 1612' 9-max Seat #2 is the button
Seat 1: Big Blind ($1678.11 in chips) 
Seat 2: Hero ($1855.13 in chips) 
Seat 3: Small Blind ($525.21 in chips) 
Small Blind: posts small blind $2.50
Big Blind: posts big blind $5
*** HOLE CARDS ***
Dealt to Hero [3c Jc]
Hero: raises $7.50 to $12.50
Small Blind: folds 
Big Blind: calls $7.50
*** FLOP *** [Qs 4c 2d]
Big Blind: checks 
Hero: bets $7.84
Big Blind: calls $7.84
*** TURN *** [Qs 4c 2d] [Jh]
Big Blind: checks 
Hero: checks 
*** RIVER *** [Qs 4c 2d Jh] [6h]
Big Blind: bets $13.98
Hero: calls $13.98
*** SHOW DOWN ***
Small Blind: shows [6s 5d] (a hand...)
Big Blind: shows [Qh 8h] (a hand...)
Hero: shows [3c Jc] (a hand...)
Big Blind collected $69.14 from pot
*** SUMMARY ***
Total pot $71.14 | Rake $2.00
Board [Qs 4c 2d Jh 6h]
Seat 1: Big Blind showed [Qh 8h] and won ($69.14)
Seat 2: Hero showed [3c Jc] and lost with...
Seat 3: Small Blind folded



PokerStars Hand #3959504415:  Hold'em No Limit ($2.50/$5) - 2020/06/11 22:32:47 ET
Table 'Zone Poker ID 1612' 9-max Seat #2 is the button
Seat 1: Hero ($550.21 in chips) 
Seat 2: Dealer ($482.50 in chips) 
Seat 3: Small Blind ($849.95 in chips) 
Small Blind: posts small blind $2.50
Hero: posts big blind $5
*** HOLE CARDS ***
Dealt to Hero [Ah 9s]
Dealer: raises $5 to $10
Small Blind: folds 
Hero: calls $5
*** FLOP *** [Th Ks 4s]
Hero: checks 
Dealer: bets $6
Hero: calls $6
*** TURN *** [Th Ks 4s] [Ad]
Hero: checks 
Dealer: bets $23
Hero: calls $23
*** RIVER *** [Th Ks 4s Ad] [7c]
Hero: checks 
Dealer: bets $60.35
Hero: calls $60.35
*** SHOW DOWN ***
Small Blind: shows [Td 6c] (a hand...)
Dealer: shows [4h Ac] (a hand...)
Hero: shows [Ah 9s] (a hand...)
Dealer collected $199.20 from pot
*** SUMMARY ***
Total pot $201.20 | Rake $2.00
Board [Th Ks 4s Ad 7c]
Seat 1: Hero showed [Ah 9s] and lost with...
Seat 2: Dealer showed [4h Ac] and won ($199.20)
Seat 3: Small Blind folded



PokerStars Hand #3959502593:  Hold'em No Limit ($2.50/$5) - 2020/06/11 22:29:24 ET
Table 'Zone Poker ID 1612' 9-max Seat #3 is the button
Seat 1: Small Blind ($495.00 in chips) 
Seat 2: Hero ($487.50 in chips) 
Seat 3: Dealer ($1069.20 in chips) 
Small Blind: posts small blind $2.50
Hero: posts big blind $5
*** HOLE CARDS ***
Dealt to Hero [9c Th]
Dealer: folds 
Small Blind: raises $10.00 to $15
Hero: calls $10
*** FLOP *** [Tc 3s Jd]
Small Blind: checks 
Hero: checks 
*** TURN *** [Tc 3s Jd] [4h]
Small Blind: checks 
Hero: checks 
*** RIVER *** [Tc 3s Jd 4h] [7c]
Small Blind: bets $21.38
Hero: calls $21.38
*** SHOW DOWN ***
Small Blind: shows [Qs Jh] (a hand...)
Dealer: shows [6s 5d] (a hand...)
Hero: shows [9c Th] (a hand...)
Small Blind collected $70.76 from pot
*** SUMMARY ***
Total pot $72.76 | Rake $2.00
Board [Tc 3s Jd 4h 7c]
Seat 1: Small Blind showed [Qs Jh] and won ($70.76)
Seat 2: Hero showed [9c Th] and lost with...
Seat 3: Dealer folded



PokerStars Hand #3959500468:  Hold'em No Limit ($2.50/$5) - 2020/06/11 22:25:29 ET
Table 'Zone Poker ID 1612' 9-max Seat #3 is the button
Seat 1: Hero ($437.50 in chips) 
Seat 2: Big Blind ($936.81 in chips) 
Seat 3: Dealer ($634.75 in chips) 
Hero: posts small blind $2.50
Big Blind: posts big blind $5
*** HOLE CARDS ***
Dealt to Hero [Jd 9d]
Dealer: folds 
Hero: raises $10.00 to $15
Big Blind: calls $10
*** FLOP *** [Jc 3s 2d]
Hero: bets $8.55
Big Blind: calls $8.55
*** TURN *** [Jc 3s 2d] [Td]
Hero: bets $30
Big Blind: calls $30
*** RIVER *** [Jc 3s 2d Td] [Tc]
Hero: checks 
Big Blind: bets $87.56
Hero: calls $87.56
*** SHOW DOWN ***
Dealer: shows [Qs 3d] (a hand...)
Big Blind: shows [Ac Th] (a hand...)
Hero: shows [Jd 9d] (a hand...)
Big Blind collected $280.22 from pot
*** SUMMARY ***
Total pot $282.22 | Rake $2.00
Board [Jc 3s 2d Td Tc]
Seat 1: Hero showed [Jd 9d] and lost with...
Seat 2: Big Blind showed [Ac Th] and won ($280.22)
Seat 3: Dealer folded



PokerStars Hand #3959499231:  Hold'em No Limit ($2.50/$5) - 2020/06/11 22:23:11 ET
Table 'Zone Poker ID 1612' 9-max Seat #3 is the button
Seat 1: Hero ($626.71 in chips) 
Seat 2: Big Blind ($813.42 in chips) 
Seat 3: Dealer ($460.00 in chips) 
Hero: posts small blind $2.50
Big Blind: posts big blind $5
*** HOLE CARDS ***
Dealt to Hero [5c 5s]
Dealer: raises $7.50 to $12.50
Hero: raises $40.00 to $52.50
Big Blind: folds 
Dealer: calls $40
*** FLOP *** [2d 6c 8d]
Hero: checks 
Dealer: checks 
*** TURN *** [2d 6c 8d] [9d]
Hero: checks 
Dealer: bets $71
Hero: calls $71
*** RIVER *** [2d 6c 8d 9d] [6h]
Hero: checks 
Dealer: bets $75
Hero: calls $75
*** SHOW DOWN ***
Dealer: shows [Qh 9h] (a hand...)
Big Blind: shows [5d Ks] (a hand...)
Hero: shows [5c 5s] (a hand...)
Dealer collected $400 from pot
*** SUMMARY ***
Total pot $402.00 | Rake $2.00
Board [2d 6c 8d 9d 6h]
Seat 1: Hero showed [5c 5s] and lost with...
Seat 2: Big Blind folded
Seat 3: Dealer showed [Qh 9h] and won ($400)



PokerStars Hand #3959404511:  Hold'em No Limit ($2.50/$5) - 2020/06/11 19:09:44 ET
Table 'Zone Poker ID 1612' 9-max Seat #4 is the button
Seat 1: Small Blind ($525.42 in chips) 
Seat 2: Big Blind ($795.77 in chips) 
Seat 3: Hero ($626.60 in chips) 
Seat 4: Dealer ($586.13 in chips) 
Small Blind: posts small blind $2.50
Big Blind: posts big blind $5
*** HOLE CARDS ***
Dealt to Hero [9c Kc]
Hero: raises $7.50 to $12.50
Dealer: calls $12.50
Small Blind: folds 
Big Blind: calls $7.50
*** FLOP *** [9d 3h 8c]
Big Blind: checks 
Hero: bets $25
Dealer: calls $25
Big Blind: folds 
*** TURN *** [9d 3h 8c] [4h]
Hero: bets $69.60
Dealer: calls $69.60
*** RIVER *** [9d 3h 8c 4h] [7c]
Hero: checks 
Dealer: bets $479.03 and is all-in
Hero: folds 
*** SHOW DOWN ***
Small Blind: shows [Ac 3s] (a hand...)
Dealer: shows [8h 8d] (a hand...)
Big Blind: shows [As 5s] (a hand...)
Hero: shows [9c Kc] (a hand...)
Uncalled bet ($479.03) returned to Dealer
Dealer collected $226.20 from pot
*** SUMMARY ***
Total pot $229.20 | Rake $3.00
Board [9d 3h 8c 4h 7c]
Seat 1: Small Blind folded
Seat 2: Big Blind folded
Seat 3: Hero folded
Seat 4: Dealer collected ($226.20)



PokerStars Hand #3959402106:  Hold'em No Limit ($2.50/$5) - 2020/06/11 19:04:13 ET
Table 'Zone Poker ID 1612' 9-max Seat #3 is the button
Seat 1: Hero ($465.00 in chips) 
Seat 2: UTG ($563.23 in chips) 
Seat 3: Dealer ($952.17 in chips) 
Seat 4: Small Blind ($516.48 in chips) 
Small Blind: posts small blind $2.50
Hero: posts big blind $5
*** HOLE CARDS ***
Dealt to Hero [3c 3h]
UTG: folds 
Dealer: raises $7.50 to $12.50
Small Blind: folds 
Hero: calls $7.50
*** FLOP *** [Ts Jd Ac]
Hero: checks 
Dealer: checks 
*** TURN *** [Ts Jd Ac] [6h]
Hero: checks 
Dealer: checks 
*** RIVER *** [Ts Jd Ac 6h] [7d]
Hero: checks 
Dealer: bets $18.07
Hero: folds 
*** SHOW DOWN ***
Small Blind: shows [As 5c] (a hand...)
UTG: shows [4c 2d] (a hand...)
Dealer: shows [Jc 7c] (a hand...)
Hero: shows [3c 3h] (a hand...)
Uncalled bet ($18.07) returned to Dealer
Dealer collected $26.13 from pot
*** SUMMARY ***
Total pot $27.50 | Rake $1.37
Board [Ts Jd Ac 6h 7d]
Seat 1: Hero folded
Seat 2: UTG folded
Seat 3: Dealer collected ($26.13)
Seat 4: Small Blind folded



PokerStars Hand #3959399438:  Hold'em No Limit ($2.50/$5) - 2020/06/11 18:58:10 ET
Table 'Zone Poker ID 1612' 9-max Seat #4 is the button
Seat 1: Small Blind ($775.49 in chips) 
Seat 2: Big Blind ($496.00 in chips) 
Seat 3: Hero ($629.70 in chips) 
Seat 4: Dealer ($535.12 in chips) 
Small Blind: posts small blind $2.50
Big Blind: posts big blind $5
*** HOLE CARDS ***
Dealt to Hero [4c Kc]
Hero: raises $7.50 to $12.50
Dealer: folds 
Small Blind: folds 
Big Blind: calls $7.50
*** FLOP *** [4s 8d Td]
Big Blind: checks 
Hero: checks 
*** TURN *** [4s 8d Td] [Js]
Big Blind: checks 
Hero: checks 
*** RIVER *** [4s 8d Td Js] [3s]
Big Blind: bets $8.12
Hero: calls $8.12
*** SHOW DOWN ***
Small Blind: shows [7h 6c] (a hand...)
Dealer: shows [6h Qd] (a hand...)
Big Blind: shows [8c Ah] (a hand...)
Hero: shows [4c Kc] (a hand...)
Big Blind collected $41.56 from pot
*** SUMMARY ***
Total pot $43.74 | Rake $2.18
Board [4s 8d Td Js 3s]
Seat 1: Small Blind folded
Seat 2: Big Blind showed [8c Ah] and won ($41.56)
Seat 3: Hero showed [4c Kc] and lost with...
Seat 4: Dealer folded



PokerStars Hand #3959398768:  Hold'em No Limit ($2.50/$5) - 2020/06/11 18:56:40 ET
Table 'Zone Poker ID 1612' 9-max Seat #2 is the button
Seat 1: UTG ($594.60 in chips) 
Seat 2: Dealer ($775.93 in chips) 
Seat 3: Small Blind ($508.50 in chips) 
Seat 4: Hero ($492.50 in chips) 
Small Blind: posts small blind $2.50
Hero: posts big blind $5
*** HOLE CARDS ***
Dealt to Hero [Ks Qc]
UTG: folds 
Dealer: raises $7.50 to $12.50
Small Blind: folds 
Hero: calls $7.50
*** FLOP *** [Jc Js 3h]
Hero: checks 
Dealer: bets $6.82
Hero: raises $19.89 to $26.71
Dealer: calls $19.89
*** TURN *** [Jc Js 3h] [5h]
Hero: checks 
Dealer: checks 
*** RIVER *** [Jc Js 3h 5h] [9d]
Hero: checks 
Dealer: bets $38.96
Hero: folds 
*** SHOW DOWN ***
Small Blind: shows [7c Td] (a hand...)
UTG: shows [3s Ad] (a hand...)
Dealer: shows [Th Ts] (a hand...)
Hero: shows [Ks Qc] (a hand...)
Uncalled bet ($38.96) returned to Dealer
Dealer collected $77.92 from pot
*** SUMMARY ***
Total pot $80.92 | Rake $3.00
Board [Jc Js 3h 5h 9d]
Seat 1: UTG folded
Seat 2: Dealer collected ($77.92)
Seat 3: Small Blind folded
Seat 4: Hero folded



PokerStars Hand #3959308076:  Hold'em No Limit ($2.50/$5) - 2020/06/11 15:06:22 ET
Table 'Zone Poker ID 1612' 9-max Seat #3 is the button
Seat 1: Hero ($490.71 in chips) 
Seat 2: Big Blind ($572.20 in chips) 
Seat 3: Dealer ($530.18 in chips) 
Hero: posts small blind $2.50
Big Blind: posts big blind $5
*** HOLE CARDS ***
Dealt to Hero [Qd Jc]
Dealer: folds 
Hero: raises $10.00 to $15
Big Blind: calls $10
*** FLOP *** [5h Qs Jd]
Hero: checks 
Big Blind: checks 
*** TURN *** [5h Qs Jd] [Ks]
Hero: bets $20
Big Blind: calls $20
*** RIVER *** [5h Qs Jd Ks] [7h]
Hero: checks 
Big Blind: bets $51
Hero: calls $51
*** SHOW DOWN ***
Dealer: shows [2h Td] (a hand...)
Big Blind: shows [5s 7s] (a hand...)
Hero: shows [Qd Jc] (a hand...)
Hero collected $170 from pot
*** SUMMARY ***
Total pot $172.00 | Rake $2.00
Board [5h Qs Jd Ks 7h]
Seat 1: Hero showed [Qd Jc] and won ($170)
Seat 2: Big Blind showed [5s 7s] and lost with...
Seat 3: Dealer folded



PokerStars Hand #3959307259:  Hold'em No Limit ($2.50/$5) - 2020/06/11 15:04:09 ET
Table 'Zone Poker ID 1612' 9-max Seat #3 is the button
Seat 1: Small Blind ($485.00 in chips) 
Seat 2: Big Blind ($594.49 in chips) 
Seat 3: Hero ($525.53 in chips) 
Small Blind: posts small blind $2.50
Big Blind: posts big blind $5
*** HOLE CARDS ***
Dealt to Hero [8d 8h]
Hero: raises $7.50 to $12.50
Small Blind: calls $10
Big Blind: calls $7.50
*** FLOP *** [9d Tc 7c]
Small Blind: checks 
Big Blind: checks 
Hero: checks 
*** TURN *** [9d Tc 7c] [7s]
Small Blind: bets $17.82
Big Blind: folds 
Hero: calls $17.82
*** RIVER *** [9d Tc 7c 7s] [Th]
Small Blind: bets $146.14
Hero: folds 
*** SHOW DOWN ***
Small Blind: shows [2c 2s] (a hand...)
Big Blind: shows [3s 3c] (a hand...)
Hero: shows [8d 8h] (a hand...)
Uncalled bet ($146.14) returned to Small Blind
Small Blind collected $71.14 from pot
*** SUMMARY ***
Total pot $73.14 | Rake $2.00
Board [9d Tc 7c 7s Th]
Seat 1: Small Blind collected ($71.14)
Seat 2: Big Blind folded
Seat 3: Hero folded



PokerStars Hand #3959305966:  Hold'em No Limit ($2.50/$5) - 2020/06/11 15:00:34 ET
Table 'Zone Poker ID 1612' 9-max Seat #3 is the button
Seat 1: Small Blind ($500.00 in chips) 
Seat 2: Big Blind ($327.21 in chips) 
Seat 3: Hero ($537.77 in chips) 
Small Blind: posts small blind $2.50
Big Blind: posts big blind $5
*** HOLE CARDS ***
Dealt to Hero [9s Kh]
Hero: raises $7.50 to $12.50
Small Blind: folds 
Big Blind: calls $7.50
*** FLOP *** [Js 9h Th]
Big Blind: checks 
Hero: checks 
*** TURN *** [Js 9h Th] [5c]
Big Blind: bets $5
Hero: calls $5
*** RIVER *** [Js 9h Th 5c] [2d]
Big Blind: bets $5
Hero: calls $5
*** SHOW DOWN ***
Small Blind: shows [Qd 3c] (a hand...)
Big Blind: shows [4s 5h] (a hand...)
Hero: shows [9s Kh] (a hand...)
Hero collected $45.50 from pot
*** SUMMARY ***
Total pot $47.50 | Rake $2.00
Board [Js 9h Th 5c 2d]
Seat 1: Small Blind folded
Seat 2: Big Blind showed [4s 5h] and lost with...
Seat 3: Hero showed [9s Kh] and won ($45.50)



PokerStars Hand #3959305297:  Hold'em No Limit ($2.50/$5) - 2020/06/11 14:58:39 ET
Table 'Zone Poker ID 1612' 9-max Seat #2 is the button
Seat 1: Hero ($497.50 in chips) 
Seat 2: Dealer ($1937.63 in chips) 
Seat 3: Small Blind ($274.62 in chips) 
Small Blind: posts small blind $2.50
Hero: posts big blind $5
*** HOLE CARDS ***
Dealt to Hero [3d 5c]
Dealer: folds 
Small Blind: raises $5.00 to $10
Hero: calls $5
*** FLOP *** [3c 6h Th]
Small Blind: bets $5
Hero: raises $14.50 to $19.50
Small Blind: calls $14.50
*** TURN *** [3c 6h Th] [Td]
Small Blind: bets $10
Hero: calls $10
*** RIVER *** [3c 6h Th Td] [7d]
Small Blind: bets $122
Hero: folds 
*** SHOW DOWN ***
Small Blind: shows [6c 6s] (a hand...)
Dealer: shows [4s Qc] (a hand...)
Hero: shows [3d 5c] (a hand...)
Uncalled bet ($122.00) returned to Small Blind
Small Blind collected $77 from pot
*** SUMMARY ***
Total pot $79.00 | Rake $2.00
Board [3c 6h Th Td 7d]
Seat 1: Hero folded
Seat 2: Dealer folded
Seat 3: Small Blind collected ($77)



PokerStars Hand #3959305135:  Hold'em No Limit ($2.50/$5) - 2020/06/11 14:58:12 ET
Table 'Zone Poker ID 1612' 9-max Seat #2 is the button
Seat 1: Big Blind ($497.50 in chips) 
Seat 2: Hero ($495.00 in chips) 
Seat 3: Small Blind ($668.05 in chips) 
Small Blind: posts small blind $2.50
Big Blind: posts big blind $5
*** HOLE CARDS ***
Dealt to Hero [7d Ah]
Hero: raises $7.50 to $12.50
Small Blind: calls $10
Big Blind: folds 
*** FLOP *** [5s 4h 2d]
Small Blind: checks 
Hero: checks 
*** TURN *** [5s 4h 2d] [Qs]
Small Blind: checks 
Hero: checks 
*** RIVER *** [5s 4h 2d Qs] [9s]
Small Blind: bets $21.38
Hero: folds 
*** SHOW DOWN ***
Small Blind: shows [6c 3c] (a hand...)
Big Blind: shows [9h 2h] (a hand...)
Hero: shows [7d Ah] (a hand...)
Uncalled bet ($21.38) returned to Small Blind
Small Blind collected $28.50 from pot
*** SUMMARY ***
Total pot $30.00 | Rake $1.50
Board [5s 4h 2d Qs 9s]
Seat 1: Big Blind folded
Seat 2: Hero folded
Seat 3: Small Blind collected ($28.50)



PokerStars Hand #3959303743:  Hold'em No Limit ($2.50/$5) - 2020/06/11 14:54:15 ET
Table 'Zone Poker ID 1612' 9-max Seat #2 is the button
Seat 1: Big Blind ($1876.00 in chips) 
Seat 2: Hero ($597.19 in chips) 
Seat 3: Small Blind ($123.12 in chips) 
Small Blind: posts small blind $2.50
Big Blind: posts big blind $5
*** HOLE CARDS ***
Dealt to Hero [Qc 9h]
Hero: raises $7.50 to $12.50
Small Blind: calls $10
Big Blind: folds 
*** FLOP *** [Th 7d Ad]
Small Blind: checks 
Hero: bets $10
Small Blind: calls $10
*** TURN *** [Th 7d Ad] [3d]
Small Blind: checks 
Hero: checks 
*** RIVER *** [Th 7d Ad 3d] [Kh]
Small Blind: bets $100.62 and is all-in
Hero: folds 
*** SHOW DOWN ***
Small Blind: shows [Kc Tc] (a hand...)
Big Blind: shows [3h Qs] (a hand...)
Hero: shows [Qc 9h] (a hand...)
Uncalled bet ($100.62) returned to Small Blind
Small Blind collected $48 from pot
*** SUMMARY ***
Total pot $50.00 | Rake $2.00
Board [Th 7d Ad 3d Kh]
Seat 1: Big Blind folded
Seat 2: Hero folded
Seat 3: Small Blind collected ($48)



PokerStars Hand #3959303493:  Hold'em No Limit ($2.50/$5) - 2020/06/11 14:53:34 ET
Table 'Zone Poker ID 1612' 9-max Seat #2 is the button
Seat 1: Big Blind ($492.50 in chips) 
Seat 2: Hero ($1083.42 in chips) 
Seat 3: Small Blind ($517.42 in chips) 
Small Blind: posts small blind $2.50
Big Blind: posts big blind $5
*** HOLE CARDS ***
Dealt to Hero [As Ts]
Hero: raises $7.50 to $12.50
Small Blind: folds 
Big Blind: calls $7.50
*** FLOP *** [7h Jd 2h]
Big Blind: checks 
Hero: checks 
*** TURN *** [7h Jd 2h] [8s]
Big Blind: checks 
Hero: checks 
*** RIVER *** [7h Jd 2h 8s] [6s]
Big Blind: bets $19.60
Hero: calls $19.60
*** SHOW DOWN ***
Small Blind: shows [3s Ah] (a hand...)
Big Blind: shows [6h 8h] (a hand...)
Hero: shows [As Ts] (a hand...)
Big Blind collected $64.70 from pot
*** SUMMARY ***
Total pot $66.70 | Rake $2.00
Board [7h Jd 2h 8s 6s]
Seat 1: Big Blind showed [6h 8h] and won ($64.70)
Seat 2: Hero showed [As Ts] and lost with...
Seat 3: Small Blind folded



PokerStars Hand #3959302682:  Hold'em No Limit ($2.50/$5) - 2020/06/11 14:51:10 ET
Table 'Zone Poker ID 1612' 9-max Seat #1 is the button
Seat 1: Dealer ($500.00 in chips) 
Seat 2: Hero ($589.74 in chips) 
Seat 3: Big Blind ($402.98 in chips) 
Hero: posts small blind $2.50
Big Blind: posts big blind $5
*** HOLE CARDS ***
Dealt to Hero [Kd 9d]
Dealer: folds 
Hero: raises $10.00 to $15
Big Blind: calls $10
*** FLOP *** [Kh 7c 6d]
Hero: bets $8.55
Big Blind: calls $8.55
*** TURN *** [Kh 7c 6d] [3c]
Hero: checks 
Big Blind: bets $22
Hero: calls $22
*** RIVER *** [Kh 7c 6d 3c] [Qh]
Hero: checks 
Big Blind: bets $32
Hero: calls $32
*** SHOW DOWN ***
Dealer: shows [Td 6h] (a hand...)
Big Blind: shows [7h 7d] (a hand...)
Hero: shows [Kd 9d] (a hand...)
Big Blind collected $153.10 from pot
*** SUMMARY ***
Total pot $155.10 | Rake $2.00
Board [Kh 7c 6d 3c Qh]
Seat 1: Dealer folded
Seat 2: Hero showed [Kd 9d] and lost with...
Seat 3: Big Blind showed [7h 7d] and won ($153.10)



PokerStars Hand #3959301491:  Hold'em No Limit ($2.50/$5) - 2020/06/11 14:47:39 ET
Table 'Zone Poker ID 1612' 9-max Seat #3 is the button
Seat 1: Small Blind ($1071.60 in chips) 
Seat 2: Hero ($637.40 in chips) 
Seat 3: Dealer ($502.50 in chips) 
Small Blind: posts small blind $2.50
Hero: posts big blind $5
*** HOLE CARDS ***
Dealt to Hero [7c 8d]
Dealer: folds 
Small Blind: raises $10.00 to $15
Hero: calls $10
*** FLOP *** [Ts 5h Td]
Small Blind: checks 
Hero: checks 
*** TURN *** [Ts 5h Td] [7s]
Small Blind: bets $10
Hero: calls $10
*** RIVER *** [Ts 5h Td 7s] [Jd]
Small Blind: bets $19
Hero: calls $19
*** SHOW DOWN ***
Small Blind: shows [Jh 8c] (a hand...)
Dealer: shows [3c 4c] (a hand...)
Hero: shows [7c 8d] (a hand...)
Small Blind collected $86 from pot
*** SUMMARY ***
Total pot $88.00 | Rake $2.00
Board [Ts 5h Td 7s Jd]
Seat 1: Small Blind showed [Jh 8c] and won ($86)
Seat 2: Hero showed [7c 8d] and lost with...
Seat 3: Dealer folded



PokerStars Hand #3959298929:  Hold'em No Limit ($2.50/$5) - 2020/06/11 14:40:06 ET
Table 'Zone Poker ID 1612' 9-max Seat #2 is the button
Seat 1: Big Blind ($367.12 in chips) 
Seat 2: Hero ($490.00 in chips) 
Seat 3: Small Blind ($388.88 in chips) 
Small Blind: posts small blind $2.50
Big Blind: posts big blind $5
*** HOLE CARDS ***
Dealt to Hero [Td 9c]
Hero: raises $7.50 to $12.50
Small Blind: folds 
Big Blind: calls $7.50
*** FLOP *** [5h 4d Qs]
Big Blind: checks 
Hero: bets $7.84
Big Blind: calls $7.84
*** TURN *** [5h 4d Qs] [Ah]
Big Blind: checks 
Hero: checks 
*** RIVER *** [5h 4d Qs Ah] [9d]
Big Blind: bets $20.59
Hero: calls $20.59
*** SHOW DOWN ***
Small Blind: shows [9h Tc] (a hand...)
Big Blind: shows [4s 5s] (a hand...)
Hero: shows [Td 9c] (a hand...)
Big Blind collected $82.36 from pot
*** SUMMARY ***
Total pot $84.36 | Rake $2.00
Board [5h 4d Qs Ah 9d]
Seat 1: Big Blind showed [4s 5s] and won ($82.36)
Seat 2: Hero showed [Td 9c] and lost with...
Seat 3: Small Blind folded



PokerStars Hand #3959297969:  Hold'em No Limit ($2.50/$5) - 2020/06/11 14:37:20 ET
Table 'Zone Poker ID 1612' 9-max Seat #1 is the button
Seat 1: Dealer ($365.93 in chips) 
Seat 2: Hero ($661.96 in chips) 
Seat 3: Big Blind ($1124.90 in chips) 
Hero: posts small blind $2.50
Big Blind: posts big blind $5
*** HOLE CARDS ***
Dealt to Hero [Th Qs]
Dealer: folds 
Hero: raises $10.00 to $15
Big Blind: calls $10
*** FLOP *** [Jd 2d 7c]
Hero: checks 
Big Blind: checks 
*** TURN *** [Jd 2d 7c] [9c]
Hero: bets $20
Big Blind: calls $20
*** RIVER *** [Jd 2d 7c 9c] [5s]
Hero: bets $51
Big Blind: raises $127.50 to $178.50
Hero: folds 
*** SHOW DOWN ***
Dealer: shows [8h 9d] (a hand...)
Big Blind: shows [8c 6h] (a hand...)
Hero: shows [Th Qs] (a hand...)
Uncalled bet ($127.50) returned to Big Blind
Big Blind collected $170 from pot
*** SUMMARY ***
Total pot $172.00 | Rake $2.00
Board [Jd 2d 7c 9c 5s]
Seat 1: Dealer folded
Seat 2: Hero folded
Seat 3: Big Blind collected ($170)



PokerStars Hand #3959296269:  Hold'em No Limit ($2.50/$5) - 2020/06/11 14:32:24 ET
Table 'Zone Poker ID 1612' 9-max Seat #2 is the button
Seat 1: Hero ($575.99 in chips) 
Seat 2: Dealer ($502.19 in chips) 
Seat 3: Small Blind ($781.79 in chips) 
Small Blind: posts small blind $2.50
Hero: posts big blind $5
*** HOLE CARDS ***
Dealt to Hero [3s Ks]
Dealer: raises $10 to $15
Small Blind: folds 
Hero: calls $10
*** FLOP *** [2c 2h Qh]
Hero: checks 
Dealer: checks 
*** TURN *** [2c 2h Qh] [Kd]
Hero: checks 
Dealer: checks 
*** RIVER *** [2c 2h Qh Kd] [5c]
Hero: bets $20
Dealer: raises $25 to $45
Hero: calls $25
*** SHOW DOWN ***
Small Blind: shows [3h Qd] (a hand...)
Dealer: shows [3c 6s] (a hand...)
Hero: shows [3s Ks] (a hand...)
Hero collected $120.50 from pot
*** SUMMARY ***
Total pot $122.50 | Rake $2.00
Board [2c 2h Qh Kd 5c]
Seat 1: Hero showed [3s Ks] and won ($120.50)
Seat 2: Dealer showed [3c 6s] and lost with...
Seat 3: Small Blind folded



PokerStars Hand #3959295908:  Hold'em No Limit ($2.50/$5) - 2020/06/11 14:31:23 ET
Table 'Zone Poker ID 1612' 9-max Seat #3 is the button
Seat 1: Small Blind ($502.50 in chips) 
Seat 2: Big Blind ($568.18 in chips) 
Seat 3: Hero ($435.00 in chips) 
Small Blind: posts small blind $2.50
Big Blind: posts big blind $5
*** HOLE CARDS ***
Dealt to Hero [Ks Kc]
Hero: raises $7.50 to $12.50
Small Blind: folds 
Big Blind: calls $7.50
*** FLOP *** [6h 2c 9h]
Big Blind: checks 
Hero: bets $7.84
Big Blind: calls $7.84
*** TURN *** [6h 2c 9h] [Jc]
Big Blind: checks 
Hero: bets $61.77
Big Blind: calls $61.77
*** RIVER *** [6h 2c 9h Jc] [5h]
Big Blind: bets $131
Hero: calls $131
*** SHOW DOWN ***
Small Blind: shows [Ts 4c] (a hand...)
Big Blind: shows [3h Kh] (a hand...)
Hero: shows [Ks Kc] (a hand...)
Big Blind collected $426.72 from pot
*** SUMMARY ***
Total pot $428.72 | Rake $2.00
Board [6h 2c 9h Jc 5h]
Seat 1: Small Blind folded
Seat 2: Big Blind showed [3h Kh] and won ($426.72)
Seat 3: Hero showed [Ks Kc] and lost with...



PokerStars Hand #3959295215:  Hold'em No Limit ($2.50/$5) - 2020/06/11 14:29:18 ET
Table 'Zone Poker ID 1612' 9-max Seat #3 is the button
Seat 1: Small Blind ($1724.41 in chips) 
Seat 2: Hero ($620.24 in chips) 
Seat 3: Dealer ($481.06 in chips) 
Small Blind: posts small blind $2.50
Hero: posts big blind $5
*** HOLE CARDS ***
Dealt to Hero [Ah 5d]
Dealer: raises $5 to $10
Small Blind: calls $7.50
Hero: calls $5
*** FLOP *** [5c 4s Jh]
Small Blind: checks 
Hero: checks 
Dealer: bets $14.25
Small Blind: folds 
Hero: calls $14.25
*** TURN *** [5c 4s Jh] [8s]
Hero: checks 
Dealer: checks 
*** RIVER *** [5c 4s Jh 8s] [4c]
Hero: checks 
Dealer: bets $91.50
Hero: folds 
*** SHOW DOWN ***
Small Blind: shows [Kc Td] (a hand...)
Dealer: shows [4h Ad] (a hand...)
Hero: shows [Ah 5d] (a hand...)
Uncalled bet ($91.50) returned to Dealer
Dealer collected $56.50 from pot
*** SUMMARY ***
Total pot $58.50 | Rake $2.00
Board [5c 4s Jh 8s 4c]
Seat 1: Small Blind folded
Seat 2: Hero folded
Seat 3: Dealer collected ($56.50)



PokerStars Hand #3959294529:  Hold'em No Limit ($2.50/$5) - 2020/06/11 14:27:16 ET
Table 'Zone Poker ID 1612' 9-max Seat #2 is the button
Seat 1: Hero ($530.64 in chips) 
Seat 2: Dealer ($1746.91 in chips) 
Seat 3: Small Blind ($510.88 in chips) 
Small Blind: posts small blind $2.50
Hero: posts big blind $5
*** HOLE CARDS ***
Dealt to Hero [Ad 3h]
Dealer: folds 
Small Blind: raises $10.00 to $15
Hero: calls $10
*** FLOP *** [4d 2s 4s]
Small Blind: checks 
Hero: bets $10
Small Blind: raises $20 to $30
Hero: calls $20
*** TURN *** [4d 2s 4s] [7h]
Small Blind: bets $44
Hero: calls $44
*** RIVER *** [4d 2s 4s 7h] [6c]
Small Blind: bets $421.88 and is all-in
Hero: folds 
*** SHOW DOWN ***
Small Blind: shows [4c 2d] (a hand...)
Dealer: shows [7s 4h] (a hand...)
Hero: shows [Ad 3h] (a hand...)
Uncalled bet ($421.88) returned to Small Blind
Small Blind collected $176 from pot
*** SUMMARY ***
Total pot $178.00 | Rake $2.00
Board [4d 2s 4s 7h 6c]
Seat 1: Hero folded
Seat 2: Dealer folded
Seat 3: Small Blind collected ($176)



PokerStars Hand #3959293423:  Hold'em No Limit ($2.50/$5) - 2020/06/11 14:24:01 ET
Table 'Zone Poker ID 1612' 9-max Seat #2 is the button
Seat 1: Hero ($490.58 in chips) 
Seat 2: Dealer ($717.94 in chips) 
Seat 3: Small Blind ($1324.00 in chips) 
Small Blind: posts small blind $2.50
Hero: posts big blind $5
*** HOLE CARDS ***
Dealt to Hero [4s 8s]
Dealer: raises $5 to $10
Small Blind: folds 
Hero: calls $5
*** FLOP *** [Kc 8d Ts]
Hero: checks 
Dealer: checks 
*** TURN *** [Kc 8d Ts] [Ad]
Hero: checks 
Dealer: bets $5
Hero: calls $5
*** RIVER *** [Kc 8d Ts Ad] [Th]
Hero: checks 
Dealer: bets $30.88
Hero: folds 
*** SHOW DOWN ***
Small Blind: shows [3d 7s] (a hand...)
Dealer: shows [Js Qs] (a hand...)
Hero: shows [4s 8s] (a hand...)
Uncalled bet ($30.88) returned to Dealer
Dealer collected $30.88 from pot
*** SUMMARY ***
Total pot $32.50 | Rake $1.62
Board [Kc 8d Ts Ad Th]
Seat 1: Hero folded
Seat 2: Dealer collected ($30.88)
Seat 3: Small Blind folded



PokerStars Hand #3959291546:  Hold'em No Limit ($2.50/$5) - 2020/06/11 14:18:40 ET
Table 'Zone Poker ID 1612' 9-max Seat #1 is the button
Seat 1: Hero ($525.50 in chips) 
Seat 2: Small Blind ($664.54 in chips) 
Seat 3: Big Blind ($504.71 in chips) 
Small Blind: posts small blind $2.50
Big Blind: posts big blind $5
*** HOLE CARDS ***
Dealt to Hero [Ah 7h]
Hero: raises $7.50 to $12.50
Small Blind: calls $10
Big Blind: calls $7.50
*** FLOP *** [2h 2c Ks]
Small Blind: checks 
Big Blind: checks 
Hero: bets $12.50
Small Blind: raises $12.50 to $25
Big Blind: folds 
Hero: calls $12.50
*** TURN *** [2h 2c Ks] [6d]
Small Blind: checks 
Hero: checks 
*** RIVER *** [2h 2c Ks 6d] [4s]
Small Blind: bets $85.50
Hero: folds 
*** SHOW DOWN ***
Small Blind: shows [4h Kd] (a hand...)
Big Blind: shows [Ac 9h] (a hand...)
Hero: shows [Ah 7h] (a hand...)
Uncalled bet ($85.50) returned to Small Blind
Small Blind collected $85.50 from pot
*** SUMMARY ***
Total pot $87.50 | Rake $2.00
Board [2h 2c Ks 6d 4s]
Seat 1: Hero folded
Seat 2: Small Blind collected ($85.50)
Seat 3: Big Blind folded



PokerStars Hand #3959284033:  Hold'em No Limit ($2.50/$5) - 2020/06/11 13:56:34 ET
Table 'Zone Poker ID 1612' 9-max Seat #2 is the button
Seat 1: Hero ($866.97 in chips) 
Seat 2: Dealer ($480.00 in chips) 
Seat 3: Small Blind ($495.00 in chips) 
Small Blind: posts small blind $2.50
Hero: posts big blind $5
*** HOLE CARDS ***
Dealt to Hero [7h 4h]
Dealer: raises $5 to $10
Small Blind: calls $7.50
Hero: calls $5
*** FLOP *** [3d 6h 4d]
Small Blind: checks 
Hero: checks 
Dealer: checks 
*** TURN *** [3d 6h 4d] [5s]
Small Blind: checks 
Hero: bets $21.38
Dealer: folds 
Small Blind: raises $35.63 to $57.01
Hero: calls $35.63
*** RIVER *** [3d 6h 4d 5s] [3h]
Small Blind: checks 
Hero: bets $71.01
Small Blind: raises $356.98 to $427.99 and is all-in
Hero: folds 
*** SHOW DOWN ***
Small Blind: shows [8c 7s] (a hand...)
Dealer: shows [Ac Td] (a hand...)
Hero: shows [7h 4h] (a hand...)
Uncalled bet ($356.98) returned to Small Blind
Small Blind collected $284.04 from pot
*** SUMMARY ***
Total pot $286.04 | Rake $2.00
Board [3d 6h 4d 5s 3h]
Seat 1: Hero folded
Seat 2: Dealer folded
Seat 3: Small Blind collected ($284.04)



PokerStars Hand #3959278987:  Hold'em No Limit ($2.50/$5) - 2020/06/11 13:41:27 ET
Table 'Zone Poker ID 1612' 9-max Seat #3 is the button
Seat 1: Hero ($857.28 in chips) 
Seat 2: Big Blind ($746.22 in chips) 
Seat 3: Dealer ($546.79 in chips) 
Hero: posts small blind $2.50
Big Blind: posts big blind $5
*** HOLE CARDS ***
Dealt to Hero [Ks Jd]
Dealer: folds 
Hero: raises $10.00 to $15
Big Blind: calls $10
*** FLOP *** [Kd Qc As]
Hero: checks 
Big Blind: bets $28.50
Hero: calls $28.50
*** TURN *** [Kd Qc As] [8d]
Hero: checks 
Big Blind: checks 
*** RIVER *** [Kd Qc As 8d] [3c]
Hero: checks 
Big Blind: bets $35
Hero: calls $35
*** SHOW DOWN ***
Dealer: shows [9d 8h] (a hand...)
Big Blind: shows [5c Ad] (a hand...)
Hero: shows [Ks Jd] (a hand...)
Big Blind collected $155 from pot
*** SUMMARY ***
Total pot $157.00 | Rake $2.00
Board [Kd Qc As 8d 3c]
Seat 1: Hero showed [Ks Jd] and lost with...
Seat 2: Big Blind showed [5c Ad] and won ($155)
Seat 3: Dealer folded



PokerStars Hand #3959278543:  Hold'em No Limit ($2.50/$5) - 2020/06/11 13:40:06 ET
Table 'Zone Poker ID 1612' 9-max Seat #3 is the button
Seat 1: Small Blind ($723.75 in chips) 
Seat 2: Big Blind ($500.00 in chips) 
Seat 3: Hero ($519.63 in chips) 
Small Blind: posts small blind $2.50
Big Blind: posts big blind $5
*** HOLE CARDS ***
Dealt to Hero [8h 8d]
Hero: raises $7.50 to $12.50
Small Blind: folds 
Big Blind: raises $37.50 to $50
Hero: calls $37.50
*** FLOP *** [9d 3h Js]
Big Blind: bets $36.83
Hero: calls $36.83
*** TURN *** [9d 3h Js] [7h]
Big Blind: checks 
Hero: checks 
*** RIVER *** [9d 3h Js 7h] [5s]
Big Blind: bets $107.08
Hero: folds 
*** SHOW DOWN ***
Small Blind: shows [6c Qc] (a hand...)
Big Blind: shows [Jh As] (a hand...)
Hero: shows [8h 8d] (a hand...)
Uncalled bet ($107.08) returned to Big Blind
Big Blind collected $174.16 from pot
*** SUMMARY ***
Total pot $176.16 | Rake $2.00
Board [9d 3h Js 7h 5s]
Seat 1: Small Blind folded
Seat 2: Big Blind collected ($174.16)
Seat 3: Hero folded



PokerStars Hand #3959260550:  Hold'em No Limit ($2.50/$5) - 2020/06/11 12:40:08 ET
Table 'Zone Poker ID 1612' 9-max Seat #2 is the button
Seat 1: Hero ($1131.45 in chips) 
Seat 2: Dealer ($1033.25 in chips) 
Seat 3: Small Blind ($500.00 in chips) 
Small Blind: posts small blind $2.50
Hero: posts big blind $5
*** HOLE CARDS ***
Dealt to Hero [4c 3c]
Dealer: raises $5 to $10
Small Blind: calls $7.50
Hero: calls $5
*** FLOP *** [Ts 2s 2c]
Small Blind: checks 
Hero: checks 
Dealer: checks 
*** TURN *** [Ts 2s 2c] [8s]
Small Blind: checks 
Hero: checks 
Dealer: checks 
*** RIVER *** [Ts 2s 2c 8s] [Kh]
Small Blind: checks 
Hero: checks 
Dealer: bets $14.25
Small Blind: folds 
Hero: folds 
*** SHOW DOWN ***
Small Blind: shows [Ah 8c] (a hand...)
Dealer: shows [5s 6h] (a hand...)
Hero: shows [4c 3c] (a hand...)
Uncalled bet ($14.25) returned to Dealer
Dealer collected $28.50 from pot
*** SUMMARY ***
Total pot $30.00 | Rake $1.50
Board [Ts 2s 2c 8s Kh]
Seat 1: Hero folded
Seat 2: Dealer collected ($28.50)
Seat 3: Small Blind folded



PokerStars Hand #3959257836:  Hold'em No Limit ($2.50/$5) - 2020/06/11 12:30:26 ET
Table 'Zone Poker ID 1612' 9-max Seat #1 is the button
Seat 1: Dealer ($1829.84 in chips) 
Seat 2: Hero ($824.36 in chips) 
Seat 3: Big Blind ($898.49 in chips) 
Hero: posts small blind $2.50
Big Blind: posts big blind $5
*** HOLE CARDS ***
Dealt to Hero [Qd As]
Dealer: folds 
Hero: raises $10.00 to $15
Big Blind: calls $10
*** FLOP *** [Th 8s 5c]
Hero: checks 
Big Blind: bets $9.25
Hero: calls $9.25
*** TURN *** [Th 8s 5c] [8c]
Hero: checks 
Big Blind: checks 
*** RIVER *** [Th 8s 5c 8c] [3d]
Hero: checks 
Big Blind: bets $18.25
Hero: calls $18.25
*** SHOW DOWN ***
Dealer: shows [9s 3s] (a hand...)
Big Blind: shows [5h Td] (a hand...)
Hero: shows [Qd As] (a hand...)
Big Blind collected $83 from pot
*** SUMMARY ***
Total pot $85.00 | Rake $2.00
Board [Th 8s 5c 8c 3d]
Seat 1: Dealer folded
Seat 2: Hero showed [Qd As] and lost with...
Seat 3: Big Blind showed [5h Td] and won ($83)



PokerStars Hand #3959256300:  Hold'em No Limit ($2.50/$5) - 2020/06/11 12:24:59 ET
Table 'Zone Poker ID 1612' 9-max Seat #2 is the button
Seat 1: Hero ($855.94 in chips) 
Seat 2: Dealer ($218.87 in chips) 
Seat 3: Small Blind ($647.42 in chips) 
Small Blind: posts small blind $2.50
Hero: posts big blind $5
*** HOLE CARDS ***
Dealt to Hero [7h 6s]
Dealer: folds 
Small Blind: raises $10.00 to $15
Hero: calls $10
*** FLOP *** [Js Qd Td]
Small Blind: checks 
Hero: checks 
*** TURN *** [Js Qd Td] [2c]
Small Blind: checks 
Hero: checks 
*** RIVER *** [Js Qd Td 2c] [9d]
Small Blind: bets $9.25
Hero: folds 
*** SHOW DOWN ***
Small Blind: shows [5s 7d] (a hand...)
Dealer: shows [8h 2d] (a hand...)
Hero: shows [7h 6s] (a hand...)
Uncalled bet ($9.25) returned to Small Blind
Small Blind collected $28.50 from pot
*** SUMMARY ***
Total pot $30.00 | Rake $1.50
Board [Js Qd Td 2c 9d]
Seat 1: Hero folded
Seat 2: Dealer folded
Seat 3: Small Blind collected ($28.50)



PokerStars Hand #3959253824:  Hold'em No Limit ($2.50/$5) - 2020/06/11 12:16:10 ET
Table 'Zone Poker ID 1612' 9-max Seat #3 is the button
Seat 1: Small Blind ($1097.61 in chips) 
Seat 2: Big Blind ($520.94 in chips) 
Seat 3: Hero ($462.06 in chips) 
Small Blind: posts small blind $2.50
Big Blind: posts big blind $5
*** HOLE CARDS ***
Dealt to Hero [9s 9d]
Hero: raises $7.50 to $12.50
Small Blind: raises $37.50 to $50
Big Blind: folds 
Hero: calls $37.50
*** FLOP *** [4h 6h Qc]
Small Blind: bets $30
Hero: calls $30
*** TURN *** [4h 6h Qc] [6c]
Small Blind: checks 
Hero: checks 
*** RIVER *** [4h 6h Qc 6c] [Jd]
Small Blind: bets $111.50
Hero: calls $111.50
*** SHOW DOWN ***
Small Blind: shows [Kd 5d] (a hand...)
Big Blind: shows [2h 5c] (a hand...)
Hero: shows [9s 9d] (a hand...)
Hero collected $386 from pot
*** SUMMARY ***
Total pot $388.00 | Rake $2.00
Board [4h 6h Qc 6c Jd]
Seat 1: Small Blind showed [Kd 5d] and lost with...
Seat 2: Big Blind folded
Seat 3: Hero showed [9s 9d] and won ($386)



PokerStars Hand #3959253448:  Hold'em No Limit ($2.50/$5) - 2020/06/11 12:14:46 ET
Table 'Zone Poker ID 1612' 9-max Seat #2 is the button
Seat 1: Hero ($500.00 in chips) 
Seat 2: Dealer ($495.00 in chips) 
Seat 3: Small Blind ($682.46 in chips) 
Small Blind: posts small blind $2.50
Hero: posts big blind $5
*** HOLE CARDS ***
Dealt to Hero [Ah 5s]
Dealer: raises $10 to $15
Small Blind: folds 
Hero: calls $10
*** FLOP *** [As Qc Jd]
Hero: checks 
Dealer: bets $15.44
Hero: calls $15.44
*** TURN *** [As Qc Jd] [5d]
Hero: checks 
Dealer: checks 
*** RIVER *** [As Qc Jd 5d] [Js]
Hero: checks 
Dealer: bets $119
Hero: folds 
*** SHOW DOWN ***
Small Blind: shows [3h Ad] (a hand...)
Dealer: shows [9c 7c] (a hand...)
Hero: shows [Ah 5s] (a hand...)
Uncalled bet ($119.00) returned to Dealer
Dealer collected $61.38 from pot
*** SUMMARY ***
Total pot $63.38 | Rake $2.00
Board [As Qc Jd 5d Js]
Seat 1: Hero folded
Seat 2: Dealer collected ($61.38)
Seat 3: Small Blind folded



PokerStars Hand #3959253070:  Hold'em No Limit ($2.50/$5) - 2020/06/11 12:13:25 ET
Table 'Zone Poker ID 1612' 9-max Seat #2 is the button
Seat 1: Big Blind ($622.08 in chips) 
Seat 2: Dealer ($198.68 in chips) 
Seat 3: Hero ($502.50 in chips) 
Hero: posts small blind $2.50
Big Blind: posts big blind $5
*** HOLE CARDS ***
Dealt to Hero [Jc Kh]
Dealer: folds 
Hero: raises $10.00 to $15
Big Blind: calls $10
*** FLOP *** [3s 9d 3c]
Hero: bets $8.55
Big Blind: calls $8.55
*** TURN *** [3s 9d 3c] [5d]
Hero: bets $33.83
Big Blind: calls $33.83
*** RIVER *** [3s 9d 3c 5d] [6h]
Hero: checks 
Big Blind: bets $74.57
Hero: folds 
*** SHOW DOWN ***
Dealer: shows [2c 7s] (a hand...)
Big Blind: shows [Qh Td] (a hand...)
Hero: shows [Jc Kh] (a hand...)
Uncalled bet ($74.57) returned to Big Blind
Big Blind collected $112.76 from pot
*** SUMMARY ***
Total pot $114.76 | Rake $2.00
Board [3s 9d 3c 5d 6h]
Seat 1: Big Blind collected ($112.76)
Seat 2: Dealer folded
Seat 3: Hero folded



PokerStars Hand #3959252694:  Hold'em No Limit ($2.50/$5) - 2020/06/11 12:12:06 ET
Table 'Zone Poker ID 1612' 9-max Seat #2 is the button
Seat 1: Big Blind ($557.05 in chips) 
Seat 2: Hero ($507.29 in chips) 
Seat 3: Small Blind ($654.58 in chips) 
Small Blind: posts small blind $2.50
Big Blind: posts big blind $5
*** HOLE CARDS ***
Dealt to Hero [4s 4h]
Hero: raises $7.50 to $12.50
Small Blind: folds 
Big Blind: calls $7.50
*** FLOP *** [6h Tc 3h]
Big Blind: checks 
Hero: bets $7.84
Big Blind: calls $7.84
*** TURN *** [6h Tc 3h] [7s]
Big Blind: checks 
Hero: checks 
*** RIVER *** [6h Tc 3h 7s] [Jd]
Big Blind: bets $30.89
Hero: folds 
*** SHOW DOWN ***
Small Blind: shows [Js 8c] (a hand...)
Big Blind: shows [Qh Ks] (a hand...)
Hero: shows [4s 4h] (a hand...)
Uncalled bet ($30.89) returned to Big Blind
Big Blind collected $41.18 from pot
*** SUMMARY ***
Total pot $43.18 | Rake $2.00
Board [6h Tc 3h 7s Jd]
Seat 1: Big Blind collected ($41.18)
Seat 2: Hero folded
Seat 3: Small Blind folded



PokerStars Hand #3959252366:  Hold'em No Limit ($2.50/$5) - 2020/06/11 12:10:51 ET
Table 'Zone Poker ID 1612' 9-max Seat #2 is the button
Seat 1: Hero ($477.50 in chips) 
Seat 2: Dealer ($509.05 in chips) 
Seat 3: Small Blind ($545.58 in chips) 
Small Blind: posts small blind $2.50
Hero: posts big blind $5
*** HOLE CARDS ***
Dealt to Hero [Ah Qs]
Dealer: folds 
Small Blind: raises $10.00 to $15
Hero: raises $30 to $45
Small Blind: calls $30
*** FLOP *** [6h Tc 2s]
Small Blind: checks 
Hero: checks 
*** TURN *** [6h Tc 2s] [Js]
Small Blind: checks 
Hero: checks 
*** RIVER *** [6h Tc 2s Js] [7d]
Small Blind: bets $66
Hero: calls $66
*** SHOW DOWN ***
Small Blind: shows [Qc Jc] (a hand...)
Dealer: shows [Jh 3c] (a hand...)
Hero: shows [Ah Qs] (a hand...)
Small Blind collected $220 from pot
*** SUMMARY ***
Total pot $222.00 | Rake $2.00
Board [6h Tc 2s Js 7d]
Seat 1: Hero showed [Ah Qs] and lost with...
Seat 2: Dealer folded
Seat 3: Small Blind showed [Qc Jc] and won ($220)



PokerStars Hand #3959251769:  Hold'em No Limit ($2.50/$5) - 2020/06/11 12:08:44 ET
Table 'Zone Poker ID 1612' 9-max Seat #2 is the button
Seat 1: Big Blind ($497.50 in chips) 
Seat 2: Dealer ($525.00 in chips) 
Seat 3: Hero ($507.50 in chips) 
Hero: posts small blind $2.50
Big Blind: posts big blind $5
*** HOLE CARDS ***
Dealt to Hero [9s Jd]
Dealer: folds 
Hero: raises $10.00 to $15
Big Blind: calls $10
*** FLOP *** [6c 4s As]
Hero: bets $8.55
Big Blind: calls $8.55
*** TURN *** [6c 4s As] [5h]
Hero: checks 
Big Blind: checks 
*** RIVER *** [6c 4s As 5h] [8c]
Hero: checks 
Big Blind: bets $33.83
Hero: folds 
*** SHOW DOWN ***
Dealer: shows [9h 4h] (a hand...)
Big Blind: shows [8s Ah] (a hand...)
Hero: shows [9s Jd] (a hand...)
Uncalled bet ($33.83) returned to Big Blind
Big Blind collected $45.10 from pot
*** SUMMARY ***
Total pot $47.10 | Rake $2.00
Board [6c 4s As 5h 8c]
Seat 1: Big Blind collected ($45.10)
Seat 2: Dealer folded
Seat 3: Hero folded



PokerStars Hand #3959246802:  Hold'em No Limit ($2.50/$5) - 2020/06/11 11:50:01 ET
Table 'Zone Poker ID 1612' 9-max Seat #2 is the button
Seat 1: UTG ($577.70 in chips) 
Seat 2: Hero ($500.00 in chips) 
Seat 3: Small Blind ($559.46 in chips) 
Seat 4: Big Blind ($500.00 in chips) 
Small Blind: posts small blind $2.50
Big Blind: posts big blind $5
*** HOLE CARDS ***
Dealt to Hero [9d 9c]
UTG: folds 
Hero: raises $7.50 to $12.50
Small Blind: raises $37.50 to $50
Big Blind: folds 
Hero: calls $37.50
*** FLOP *** [3s Kh 9h]
Small Blind: bets $51
Hero: calls $51
*** TURN *** [3s Kh 9h] [Ah]
Small Blind: bets $102
Hero: calls $102
*** RIVER *** [3s Kh 9h Ah] [Qc]
Small Blind: bets $356.46 and is all-in
Hero: calls $297 and is all-in
*** SHOW DOWN ***
Small Blind: shows [As Ad] (a hand...)
UTG: shows [5s 6d] (a hand...)
Big Blind: shows [8d Ac] (a hand...)
Hero: shows [9d 9c] (a hand...)
Uncalled bet ($59.46) returned to Small Blind
Small Blind collected $1002 from pot
*** SUMMARY ***
Total pot $1005.00 | Rake $3.00
Board [3s Kh 9h Ah Qc]
Seat 1: UTG folded
Seat 2: Hero showed [9d 9c] and lost with...
Seat 3: Small Blind showed [As Ad] and won ($1002)
Seat 4: Big Blind folded



PokerStars Hand #3959244127:  Hold'em No Limit ($2.50/$5) - 2020/06/11 11:39:41 ET
Table 'Zone Poker ID 1612' 9-max Seat #2 is the button
Seat 1: Big Blind ($722.25 in chips) 
Seat 2: Dealer ($500.00 in chips) 
Seat 3: Hero ($482.79 in chips) 
Hero: posts small blind $2.50
Big Blind: posts big blind $5
*** HOLE CARDS ***
Dealt to Hero [Kc Qh]
Dealer: folds 
Hero: raises $10.00 to $15
Big Blind: raises $30 to $45
Hero: calls $30
*** FLOP *** [Ks 4d 3c]
Hero: checks 
Big Blind: checks 
*** TURN *** [Ks 4d 3c] [Ah]
Hero: checks 
Big Blind: checks 
*** RIVER *** [Ks 4d 3c Ah] [Td]
Hero: bets $26.40
Big Blind: raises $76.40 to $102.80
Hero: calls $76.40
*** SHOW DOWN ***
Dealer: shows [6d 3s] (a hand...)
Big Blind: shows [7c Jh] (a hand...)
Hero: shows [Kc Qh] (a hand...)
Hero collected $293.60 from pot
*** SUMMARY ***
Total pot $295.60 | Rake $2.00
Board [Ks 4d 3c Ah Td]
Seat 1: Big Blind showed [7c Jh] and lost with...
Seat 2: Dealer folded
Seat 3: Hero showed [Kc Qh] and won ($293.60)



PokerStars Hand #3959243013:  Hold'em No Limit ($2.50/$5) - 2020/06/11 11:35:25 ET
Table 'Zone Poker ID 1612' 9-max Seat #1 is the button
Seat 1: Dealer ($495.00 in chips) 
Seat 2: Small Blind ($390.27 in chips) 
Seat 3: Hero ($487.50 in chips) 
Small Blind: posts small blind $2.50
Hero: posts big blind $5
*** HOLE CARDS ***
Dealt to Hero [9d 6c]
Dealer: folds 
Small Blind: raises $10.00 to $15
Hero: calls $10
*** FLOP *** [3s As Ac]
Small Blind: checks 
Hero: checks 
*** TURN *** [3s As Ac] [4s]
Small Blind: checks 
Hero: checks 
*** RIVER *** [3s As Ac 4s] [5s]
Small Blind: checks 
Hero: bets $10
Small Blind: raises $20 to $30
Hero: folds 
*** SHOW DOWN ***
Small Blind: shows [Ah Ad] (a hand...)
Dealer: shows [5h 2d] (a hand...)
Hero: shows [9d 6c] (a hand...)
Uncalled bet ($20.00) returned to Small Blind
Small Blind collected $48 from pot
*** SUMMARY ***
Total pot $50.00 | Rake $2.00
Board [3s As Ac 4s 5s]
Seat 1: Dealer folded
Seat 2: Small Blind collected ($48)
Seat 3: Hero folded



PokerStars Hand #3959235269:  Hold'em No Limit ($2.50/$5) - 2020/06/11 11:03:16 ET
Table 'Zone Poker ID 1612' 9-max Seat #3 is the button
Seat 1: Small Blind ($500.00 in chips) 
Seat 2: Hero ($960.64 in chips) 
Seat 3: Dealer ($610.11 in chips) 
Small Blind: posts small blind $2.50
Hero: posts big blind $5
*** HOLE CARDS ***
Dealt to Hero [Kc 2c]
Dealer: raises $10 to $15
Small Blind: folds 
Hero: calls $10
*** FLOP *** [9d 7h 3d]
Hero: checks 
Dealer: checks 
*** TURN *** [9d 7h 3d] [Kh]
Hero: checks 
Dealer: checks 
*** RIVER *** [9d 7h 3d Kh] [Jd]
Hero: bets $23.16
Dealer: raises $58.60 to $81.76
Hero: calls $58.60
*** SHOW DOWN ***
Small Blind: shows [5s 9c] (a hand...)
Dealer: shows [Qd Ts] (a hand...)
Hero: shows [Kc 2c] (a hand...)
Dealer collected $194.02 from pot
*** SUMMARY ***
Total pot $196.02 | Rake $2.00
Board [9d 7h 3d Kh Jd]
Seat 1: Small Blind folded
Seat 2: Hero showed [Kc 2c] and lost with...
Seat 3: Dealer showed [Qd Ts] and won ($194.02)



PokerStars Hand #3959234886:  Hold'em No Limit ($2.50/$5) - 2020/06/11 11:01:37 ET
Table 'Zone Poker ID 1612' 9-max Seat #1 is the button
Seat 1: Dealer ($497.50 in chips) 
Seat 2: Hero ($810.14 in chips) 
Dealer: posts small blind $2.50
Hero: posts big blind $5
*** HOLE CARDS ***
Dealt to Hero [9d As]
Dealer: raises $10.00 to $15
Hero: calls $10
*** FLOP *** [7d Jc 6s]
Hero: checks 
Dealer: bets $10
Hero: calls $10
*** TURN *** [7d Jc 6s] [Ah]
Hero: checks 
Dealer: checks 
*** RIVER *** [7d Jc 6s Ah] [9h]
Hero: bets $24.50
Dealer: raises $74.00 to $98.50
Hero: calls $74
*** SHOW DOWN ***
Dealer: shows [9s 7s] (a hand...)
Hero: shows [9d As] (a hand...)
Hero collected $246 from pot
*** SUMMARY ***
Total pot $247.00 | Rake $1.00
Board [7d Jc 6s Ah 9h]
Seat 1: Dealer showed [9s 7s] and lost with...
Seat 2: Hero showed [9d As] and won ($246)



PokerStars Hand #3959233708:  Hold'em No Limit ($2.50/$5) - 2020/06/11 10:56:25 ET
Table 'Zone Poker ID 1612' 9-max Seat #1 is the button
Seat 1: Dealer ($546.51 in chips) 
Seat 2: Hero ($492.50 in chips) 
Dealer: posts small blind $2.50
Hero: posts big blind $5
*** HOLE CARDS ***
Dealt to Hero [Ks 5h]
Dealer: raises $10.00 to $15
Hero: calls $10
*** FLOP *** [5s Td 8h]
Hero: checks 
Dealer: bets $14.52
Hero: calls $14.52
*** TURN *** [5s Td 8h] [Qc]
Hero: checks 
Dealer: checks 
*** RIVER *** [5s Td 8h Qc] [As]
Hero: checks 
Dealer: bets $34.02
Hero: calls $34.02
*** SHOW DOWN ***
Dealer: shows [8d Ah] (a hand...)
Hero: shows [Ks 5h] (a hand...)
Dealer collected $126.08 from pot
*** SUMMARY ***
Total pot $127.08 | Rake $1.00
Board [5s Td 8h Qc As]
Seat 1: Dealer showed [8d Ah] and won ($126.08)
Seat 2: Hero showed [Ks 5h] and lost with...



PokerStars Hand #3959233556:  Hold'em No Limit ($2.50/$5) - 2020/06/11 10:55:44 ET
Table 'Zone Poker ID 1612' 9-max Seat #2 is the button
Seat 1: Hero ($502.50 in chips) 
Seat 2: Dealer ($396.58 in chips) 
Dealer: posts small blind $2.50
Hero: posts big blind $5
*** HOLE CARDS ***
Dealt to Hero [5s Kd]
Dealer: raises $10.00 to $15
Hero: calls $10
*** FLOP *** [As 4d Ad]
Hero: checks 
Dealer: checks 
*** TURN *** [As 4d Ad] [Js]
Hero: checks 
Dealer: checks 
*** RIVER *** [As 4d Ad Js] [Qc]
Hero: checks 
Dealer: bets $21.75
Hero: folds 
*** SHOW DOWN ***
Dealer: shows [Ah 7s] (a hand...)
Hero: shows [5s Kd] (a hand...)
Uncalled bet ($21.75) returned to Dealer
Dealer collected $29 from pot
*** SUMMARY ***
Total pot $30.00 | Rake $1.00
Board [As 4d Ad Js Qc]
Seat 1: Hero folded
Seat 2: Dealer collected ($29)



PokerStars Hand #3959110296:  Hold'em No Limit ($2.50/$5) - 2020/06/11 01:58:44 ET
Table 'Zone Poker ID 1612' 9-max Seat #2 is the button
Seat 1: Hero ($492.50 in chips) 
Seat 2: Dealer ($518.13 in chips) 
Seat 3: Small Blind ($440.49 in chips) 
Small Blind: posts small blind $2.50
Hero: posts big blind $5
*** HOLE CARDS ***
Dealt to Hero [5s 2s]
Dealer: raises $5 to $10
Small Blind: folds 
Hero: calls $5
*** FLOP *** [8c Qh 5c]
Hero: checks 
Dealer: bets $6
Hero: calls $6
*** TURN *** [8c Qh 5c] [3c]
Hero: checks 
Dealer: checks 
*** RIVER *** [8c Qh 5c 3c] [3h]
Hero: checks 
Dealer: bets $24.59
Hero: folds 
*** SHOW DOWN ***
Small Blind: shows [4d Jd] (a hand...)
Dealer: shows [Qs 4s] (a hand...)
Hero: shows [5s 2s] (a hand...)
Uncalled bet ($24.59) returned to Dealer
Dealer collected $32.78 from pot
*** SUMMARY ***
Total pot $34.50 | Rake $1.72
Board [8c Qh 5c 3c 3h]
Seat 1: Hero folded
Seat 2: Dealer collected ($32.78)
Seat 3: Small Blind folded



PokerStars Hand #3959108368:  Hold'em No Limit ($2.50/$5) - 2020/06/11 01:54:31 ET
Table 'Zone Poker ID 1612' 9-max Seat #3 is the button
Seat 1: Small Blind ($386.88 in chips) 
Seat 2: Hero ($487.50 in chips) 
Seat 3: Dealer ($510.00 in chips) 
Small Blind: posts small blind $2.50
Hero: posts big blind $5
*** HOLE CARDS ***
Dealt to Hero [5h Kc]
Dealer: raises $5 to $10
Small Blind: calls $7.50
Hero: calls $5
*** FLOP *** [Jh 7d 9h]
Small Blind: checks 
Hero: checks 
Dealer: checks 
*** TURN *** [Jh 7d 9h] [Qh]
Small Blind: checks 
Hero: checks 
Dealer: checks 
*** RIVER *** [Jh 7d 9h Qh] [Ac]
Small Blind: checks 
Hero: checks 
Dealer: bets $15
Small Blind: folds 
Hero: folds 
*** SHOW DOWN ***
Small Blind: shows [2s 2d] (a hand...)
Dealer: shows [8s 6s] (a hand...)
Hero: shows [5h Kc] (a hand...)
Uncalled bet ($15.00) returned to Dealer
Dealer collected $28.50 from pot
*** SUMMARY ***
Total pot $30.00 | Rake $1.50
Board [Jh 7d 9h Qh Ac]
Seat 1: Small Blind folded
Seat 2: Hero folded
Seat 3: Dealer collected ($28.50)



PokerStars Hand #3958882944:  Hold'em No Limit ($2.50/$5) - 2020/06/10 18:20:37 ET
Table 'Zone Poker ID 1612' 9-max Seat #2 is the button
Seat 1: Big Blind ($761.93 in chips) 
Seat 2: Hero ($701.47 in chips) 
Seat 3: Small Blind ($574.58 in chips) 
Small Blind: posts small blind $2.50
Big Blind: posts big blind $5
*** HOLE CARDS ***
Dealt to Hero [9s Ad]
Hero: raises $7.50 to $12.50
Small Blind: folds 
Big Blind: calls $7.50
*** FLOP *** [Kh Js Qc]
Big Blind: checks 
Hero: checks 
*** TURN *** [Kh Js Qc] [3s]
Big Blind: checks 
Hero: checks 
*** RIVER *** [Kh Js Qc 3s] [9d]
Big Blind: bets $8.36
Hero: folds 
*** SHOW DOWN ***
Small Blind: shows [7c 4h] (a hand...)
Big Blind: shows [As 6h] (a hand...)
Hero: shows [9s Ad] (a hand...)
Uncalled bet ($8.36) returned to Big Blind
Big Blind collected $26.13 from pot
*** SUMMARY ***
Total pot $27.50 | Rake $1.37
Board [Kh Js Qc 3s 9d]
Seat 1: Big Blind collected ($26.13)
Seat 2: Hero folded
Seat 3: Small Blind folded



PokerStars Hand #3958882040:  Hold'em No Limit ($2.50/$5) - 2020/06/10 18:18:31 ET
Table 'Zone Poker ID 1612' 9-max Seat #3 is the button
Seat 1: Small Blind ($500.00 in chips) 
Seat 2: Hero ($520.63 in chips) 
Seat 3: Dealer ($374.71 in chips) 
Small Blind: posts small blind $2.50
Hero: posts big blind $5
*** HOLE CARDS ***
Dealt to Hero [Ah 6s]
Dealer: folds 
Small Blind: raises $10.00 to $15
Hero: calls $10
*** FLOP *** [Ts 4h Jh]
Small Blind: checks 
Hero: checks 
*** TURN *** [Ts 4h Jh] [7h]
Small Blind: bets $21.38
Hero: calls $21.38
*** RIVER *** [Ts 4h Jh 7h] [Th]
Small Blind: checks 
Hero: bets $53.07
Small Blind: raises $410.55 to $463.62 and is all-in
Hero: folds 
*** SHOW DOWN ***
Small Blind: shows [Js Td] (a hand...)
Dealer: shows [8s 3s] (a hand...)
Hero: shows [Ah 6s] (a hand...)
Uncalled bet ($410.55) returned to Small Blind
Small Blind collected $176.90 from pot
*** SUMMARY ***
Total pot $178.90 | Rake $2.00
Board [Ts 4h Jh 7h Th]
Seat 1: Small Blind collected ($176.90)
Seat 2: Hero folded
Seat 3: Dealer folded



PokerStars Hand #3958881876:  Hold'em No Limit ($2.50/$5) - 2020/06/10 18:18:07 ET
Table 'Zone Poker ID 1612' 9-max Seat #3 is the button
Seat 1: Hero ($478.91 in chips) 
Seat 2: Big Blind ($941.11 in chips) 
Seat 3: Dealer ($372.21 in chips) 
Hero: posts small blind $2.50
Big Blind: posts big blind $5
*** HOLE CARDS ***
Dealt to Hero [Jd As]
Dealer: folds 
Hero: raises $10.00 to $15
Big Blind: raises $30 to $45
Hero: calls $30
*** FLOP *** [Td 5s 5h]
Hero: checks 
Big Blind: bets $28.16
Hero: calls $28.16
*** TURN *** [Td 5s 5h] [3h]
Hero: checks 
Big Blind: checks 
*** RIVER *** [Td 5s 5h 3h] [Kd]
Hero: checks 
Big Blind: bets $101.02
Hero: calls $101.02
*** SHOW DOWN ***
Dealer: shows [4h 8d] (a hand...)
Big Blind: shows [9c 7d] (a hand...)
Hero: shows [Jd As] (a hand...)
Hero collected $346.36 from pot
*** SUMMARY ***
Total pot $348.36 | Rake $2.00
Board [Td 5s 5h 3h Kd]
Seat 1: Hero showed [Jd As] and won ($346.36)
Seat 2: Big Blind showed [9c 7d] and lost with...
Seat 3: Dealer folded



PokerStars Hand #3958881292:  Hold'em No Limit ($2.50/$5) - 2020/06/10 18:16:46 ET
Table 'Zone Poker ID 1612' 9-max Seat #2 is the button
Seat 1: Hero ($561.79 in chips) 
Seat 2: Dealer ($512.46 in chips) 
Seat 3: Small Blind ($860.23 in chips) 
Small Blind: posts small blind $2.50
Hero: posts big blind $5
*** HOLE CARDS ***
Dealt to Hero [Qd 6s]
Dealer: folds 
Small Blind: raises $8.75 to $13.75
Hero: calls $8.75
*** FLOP *** [Qs Jc 5s]
Small Blind: checks 
Hero: checks 
*** TURN *** [Qs Jc 5s] [8h]
Small Blind: checks 
Hero: bets $20
Small Blind: calls $20
*** RIVER *** [Qs Jc 5s 8h] [Kh]
Small Blind: checks 
Hero: bets $49.13
Small Blind: raises $142.56 to $191.69
Hero: folds 
*** SHOW DOWN ***
Small Blind: shows [Th Td] (a hand...)
Dealer: shows [Qh 3s] (a hand...)
Hero: shows [Qd 6s] (a hand...)
Uncalled bet ($142.56) returned to Small Blind
Small Blind collected $163.76 from pot
*** SUMMARY ***
Total pot $165.76 | Rake $2.00
Board [Qs Jc 5s 8h Kh]
Seat 1: Hero folded
Seat 2: Dealer folded
Seat 3: Small Blind collected ($163.76)



PokerStars Hand #3958880359:  Hold'em No Limit ($2.50/$5) - 2020/06/10 18:14:38 ET
Table 'Zone Poker ID 1612' 9-max Seat #1 is the button
Seat 1: Dealer ($603.54 in chips) 
Seat 2: Small Blind ($533.83 in chips) 
Seat 3: Hero ($558.00 in chips) 
Small Blind: posts small blind $2.50
Hero: posts big blind $5
*** HOLE CARDS ***
Dealt to Hero [Th Ks]
Dealer: raises $7 to $12
Small Blind: folds 
Hero: calls $7
*** FLOP *** [Td 4c 8c]
Hero: checks 
Dealer: bets $17.63
Hero: calls $17.63
*** TURN *** [Td 4c 8c] [Kh]
Hero: checks 
Dealer: bets $90.84
Hero: calls $90.84
*** RIVER *** [Td 4c 8c Kh] [Qc]
Hero: checks 
Dealer: bets $169.01
Hero: calls $169.01
*** SHOW DOWN ***
Small Blind: shows [Jc 5d] (a hand...)
Dealer: shows [Ac 3c] (a hand...)
Hero: shows [Th Ks] (a hand...)
Dealer collected $579.46 from pot
*** SUMMARY ***
Total pot $581.46 | Rake $2.00
Board [Td 4c 8c Kh Qc]
Seat 1: Dealer showed [Ac 3c] and won ($579.46)
Seat 2: Small Blind folded
Seat 3: Hero showed [Th Ks] and lost with...



PokerStars Hand #3958840689:  Hold'em No Limit ($2.50/$5) - 2020/06/10 16:36:11 ET
Table 'Zone Poker ID 1612' 9-max Seat #2 is the button
Seat 1: Big Blind ($830.53 in chips) 
Seat 2: Hero ($487.50 in chips) 
Seat 3: Small Blind ($454.63 in chips) 
Small Blind: posts small blind $2.50
Big Blind: posts big blind $5
*** HOLE CARDS ***
Dealt to Hero [Ah Kc]
Hero: raises $7.50 to $12.50
Small Blind: calls $10
Big Blind: folds 
*** FLOP *** [8c 3c 7h]
Small Blind: checks 
Hero: bets $8.55
Small Blind: calls $8.55
*** TURN *** [8c 3c 7h] [9h]
Small Blind: checks 
Hero: checks 
*** RIVER *** [8c 3c 7h 9h] [2s]
Small Blind: bets $22.55
Hero: calls $22.55
*** SHOW DOWN ***
Small Blind: shows [Tc 5c] (a hand...)
Big Blind: shows [7d 2c] (a hand...)
Hero: shows [Ah Kc] (a hand...)
Hero collected $90.20 from pot
*** SUMMARY ***
Total pot $92.20 | Rake $2.00
Board [8c 3c 7h 9h 2s]
Seat 1: Big Blind folded
Seat 2: Hero showed [Ah Kc] and won ($90.20)
Seat 3: Small Blind showed [Tc 5c] and lost with...



PokerStars Hand #3958768458:  Hold'em No Limit ($2.50/$5) - 2020/06/10 12:52:45 ET
Table 'Zone Poker ID 1612' 9-max Seat #2 is the button
Seat 1: Hero ($528.97 in chips) 
Seat 2: Dealer ($1082.63 in chips) 
Seat 3: Small Blind ($222.47 in chips) 
Small Blind: posts small blind $2.50
Hero: posts big blind $5
*** HOLE CARDS ***
Dealt to Hero [8h Js]
Dealer: raises $7.50 to $12.50
Small Blind: calls $10
Hero: calls $7.50
*** FLOP *** [Jh 2d 5s]
Small Blind: checks 
Hero: checks 
Dealer: checks 
*** TURN *** [Jh 2d 5s] [5d]
Small Blind: checks 
Hero: bets $5
Dealer: folds 
Small Blind: raises $34.22 to $39.22
Hero: calls $34.22
*** RIVER *** [Jh 2d 5s 5d] [7h]
Small Blind: bets $170.75 and is all-in
Hero: calls $170.75
*** SHOW DOWN ***
Small Blind: shows [5c Ts] (a hand...)
Dealer: shows [9h Ah] (a hand...)
Hero: shows [8h Js] (a hand...)
Small Blind collected $455.44 from pot
*** SUMMARY ***
Total pot $457.44 | Rake $2.00
Board [Jh 2d 5s 5d 7h]
Seat 1: Hero showed [8h Js] and lost with...
Seat 2: Dealer folded
Seat 3: Small Blind showed [5c Ts] and won ($455.44)



PokerStars Hand #3958767708:  Hold'em No Limit ($2.50/$5) - 2020/06/10 12:50:14 ET
Table 'Zone Poker ID 1612' 9-max Seat #2 is the button
Seat 1: Big Blind ($500.00 in chips) 
Seat 2: Dealer ($332.47 in chips) 
Seat 3: Hero ($519.03 in chips) 
Hero: posts small blind $2.50
Big Blind: posts big blind $5
*** HOLE CARDS ***
Dealt to Hero [Qh Qd]
Dealer: raises $10 to $15
Hero: raises $45.00 to $60
Big Blind: calls $55
Dealer: calls $45
*** FLOP *** [Jc 7h Ad]
Hero: checks 
Big Blind: checks 
Dealer: checks 
*** TURN *** [Jc 7h Ad] [6c]
Hero: checks 
Big Blind: bets $80
Dealer: folds 
Hero: calls $80
*** RIVER *** [Jc 7h Ad 6c] [3d]
Hero: checks 
Big Blind: bets $360 and is all-in
Hero: calls $360
*** SHOW DOWN ***
Dealer: shows [Kd 8c] (a hand...)
Big Blind: shows [Qc Ac] (a hand...)
Hero: shows [Qh Qd] (a hand...)
Big Blind collected $1058 from pot
*** SUMMARY ***
Total pot $1060.00 | Rake $2.00
Board [Jc 7h Ad 6c 3d]
Seat 1: Big Blind showed [Qc Ac] and won ($1058)
Seat 2: Dealer folded
Seat 3: Hero showed [Qh Qd] and lost with...



PokerStars Hand #3958474099:  Hold'em No Limit ($2.50/$5) - 2020/06/09 21:30:48 ET
Table 'Zone Poker ID 1612' 9-max Seat #2 is the button
Seat 1: Hero ($613.06 in chips) 
Seat 2: Dealer ($569.32 in chips) 
Seat 3: Small Blind ($256.58 in chips) 
Small Blind: posts small blind $2.50
Hero: posts big blind $5
*** HOLE CARDS ***
Dealt to Hero [Js 9c]
Dealer: folds 
Small Blind: raises $5.00 to $10
Hero: calls $5
*** FLOP *** [Jc 2c Ts]
Small Blind: checks 
Hero: checks 
*** TURN *** [Jc 2c Ts] [5d]
Small Blind: bets $9.50
Hero: calls $9.50
*** RIVER *** [Jc 2c Ts 5d] [8c]
Small Blind: bets $27.79
Hero: calls $27.79
*** SHOW DOWN ***
Small Blind: shows [Td Th] (a hand...)
Dealer: shows [3s 7d] (a hand...)
Hero: shows [Js 9c] (a hand...)
Small Blind collected $92.58 from pot
*** SUMMARY ***
Total pot $94.58 | Rake $2.00
Board [Jc 2c Ts 5d 8c]
Seat 1: Hero showed [Js 9c] and lost with...
Seat 2: Dealer folded
Seat 3: Small Blind showed [Td Th] and won ($92.58)



PokerStars Hand #3958473807:  Hold'em No Limit ($2.50/$5) - 2020/06/09 21:30:17 ET
Table 'Zone Poker ID 1612' 9-max Seat #2 is the button
Seat 1: Hero ($936.03 in chips) 
Seat 2: Dealer ($654.08 in chips) 
Seat 3: Small Blind ($487.50 in chips) 
Small Blind: posts small blind $2.50
Hero: posts big blind $5
*** HOLE CARDS ***
Dealt to Hero [Jh Qc]
Dealer: folds 
Small Blind: raises $10.00 to $15
Hero: calls $10
*** FLOP *** [Jd 5h Ah]
Small Blind: checks 
Hero: checks 
*** TURN *** [Jd 5h Ah] [Kd]
Small Blind: bets $20
Hero: calls $20
*** RIVER *** [Jd 5h Ah Kd] [7s]
Small Blind: bets $51
Hero: folds 
*** SHOW DOWN ***
Small Blind: shows [As Ks] (a hand...)
Dealer: shows [7d Ts] (a hand...)
Hero: shows [Jh Qc] (a hand...)
Uncalled bet ($51.00) returned to Small Blind
Small Blind collected $68 from pot
*** SUMMARY ***
Total pot $70.00 | Rake $2.00
Board [Jd 5h Ah Kd 7s]
Seat 1: Hero folded
Seat 2: Dealer folded
Seat 3: Small Blind collected ($68)



PokerStars Hand #3958469238:  Hold'em No Limit ($2.50/$5) - 2020/06/09 21:21:59 ET
Table 'Zone Poker ID 1612' 9-max Seat #3 is the button
Seat 1: UTG ($673.99 in chips) 
Seat 2: UTG+1 ($848.06 in chips) 
Seat 3: Hero ($708.00 in chips) 
Seat 4: Small Blind ($2634.89 in chips) 
Seat 5: Big Blind ($200.70 in chips) 
Small Blind: posts small blind $2.50
Big Blind: posts big blind $5
*** HOLE CARDS ***
Dealt to Hero [Jd 4d]
UTG: folds 
UTG+1: folds 
Hero: raises $7.50 to $12.50
Small Blind: folds 
Big Blind: calls $7.50
*** FLOP *** [Ah 3h 9c]
Big Blind: checks 
Hero: bets $7.84
Big Blind: calls $7.84
*** TURN *** [Ah 3h 9c] [3s]
Big Blind: checks 
Hero: checks 
*** RIVER *** [Ah 3h 9c 3s] [8c]
Big Blind: bets $20.52
Hero: folds 
*** SHOW DOWN ***
Small Blind: shows [4h 6d] (a hand...)
Big Blind: shows [8d 9d] (a hand...)
Hero: shows [Jd 4d] (a hand...)
UTG: shows [7c Td] (a hand...)
UTG+1: shows [5d Th] (a hand...)
Uncalled bet ($20.52) returned to Big Blind
Big Blind collected $41.03 from pot
*** SUMMARY ***
Total pot $43.18 | Rake $2.15
Board [Ah 3h 9c 3s 8c]
Seat 1: UTG folded
Seat 2: UTG+1 folded
Seat 3: Hero folded
Seat 4: Small Blind folded
Seat 5: Big Blind collected ($41.03)



PokerStars Hand #3958468741:  Hold'em No Limit ($2.50/$5) - 2020/06/09 21:21:03 ET
Table 'Zone Poker ID 1612' 9-max Seat #2 is the button
Seat 1: Hero ($681.85 in chips) 
Seat 2: Dealer ($1151.51 in chips) 
Seat 3: Small Blind ($377.54 in chips) 
Seat 4: Big Blind ($495.00 in chips) 
Seat 5: UTG ($2639.89 in chips) 
Small Blind: posts small blind $2.50
Big Blind: posts big blind $5
*** HOLE CARDS ***
Dealt to Hero [Ah Kh]
UTG: folds 
Hero: raises $7.50 to $12.50
Dealer: calls $12.50
Small Blind: folds 
Big Blind: folds 
*** FLOP *** [Qd Kd Qh]
Hero: checks 
Dealer: bets $15.44
Hero: calls $15.44
*** TURN *** [Qd Kd Qh] [Ac]
Hero: checks 
Dealer: checks 
*** RIVER *** [Qd Kd Qh Ac] [Qs]
Hero: bets $20
Dealer: raises $75.29 to $95.29
Hero: calls $75.29
*** SHOW DOWN ***
Small Blind: shows [8c 6s] (a hand...)
Big Blind: shows [7h 8s] (a hand...)
Hero: shows [Ah Kh] (a hand...)
Dealer: shows [3s 3h] (a hand...)
UTG: shows [8h 2d] (a hand...)
Hero collected $250.96 from pot
*** SUMMARY ***
Total pot $253.96 | Rake $3.00
Board [Qd Kd Qh Ac Qs]
Seat 1: Hero showed [Ah Kh] and won ($250.96)
Seat 2: Dealer showed [3s 3h] and lost with...
Seat 3: Small Blind folded
Seat 4: Big Blind folded
Seat 5: UTG folded



PokerStars Hand #3958467674:  Hold'em No Limit ($2.50/$5) - 2020/06/09 21:19:04 ET
Table 'Zone Poker ID 1612' 9-max Seat #1 is the button
Seat 1: Dealer ($545.88 in chips) 
Seat 2: Hero ($534.32 in chips) 
Seat 3: Big Blind ($505.00 in chips) 
Seat 4: UTG ($649.49 in chips) 
Seat 5: UTG+1 ($663.60 in chips) 
Hero: posts small blind $2.50
Big Blind: posts big blind $5
*** HOLE CARDS ***
Dealt to Hero [Jd Qc]
UTG: folds 
UTG+1: folds 
Dealer: folds 
Hero: raises $10.00 to $15
Big Blind: calls $10
*** FLOP *** [Jh Ts 4h]
Hero: bets $8.55
Big Blind: calls $8.55
*** TURN *** [Jh Ts 4h] [4c]
Hero: checks 
Big Blind: bets $33.56
Hero: calls $33.56
*** RIVER *** [Jh Ts 4h 4c] [2s]
Hero: checks 
Big Blind: bets $78.42
Hero: calls $78.42
*** SHOW DOWN ***
Big Blind: shows [Jc 6c] (a hand...)
Hero: shows [Jd Qc] (a hand...)
Dealer: shows [Qd 2d] (a hand...)
UTG: shows [5d Js] (a hand...)
UTG+1: shows [5s Ad] (a hand...)
Hero collected $268.06 from pot
*** SUMMARY ***
Total pot $271.06 | Rake $3.00
Board [Jh Ts 4h 4c 2s]
Seat 1: Dealer folded
Seat 2: Hero showed [Jd Qc] and won ($268.06)
Seat 3: Big Blind showed [Jc 6c] and lost with...
Seat 4: UTG folded
Seat 5: UTG+1 folded



PokerStars Hand #3958464046:  Hold'em No Limit ($2.50/$5) - 2020/06/09 21:12:13 ET
Table 'Zone Poker ID 1612' 9-max Seat #4 is the button
Seat 1: Big Blind ($629.15 in chips) 
Seat 2: UTG ($539.41 in chips) 
Seat 3: Hero ($505.00 in chips) 
Seat 4: Dealer ($1026.71 in chips) 
Seat 5: Small Blind ($1648.78 in chips) 
Small Blind: posts small blind $2.50
Big Blind: posts big blind $5
*** HOLE CARDS ***
Dealt to Hero [Qh Jh]
UTG: folds 
Hero: raises $7.50 to $12.50
Dealer: folds 
Small Blind: raises $40.00 to $52.50
Big Blind: folds 
Hero: calls $40
*** FLOP *** [3c Kd Ad]
Small Blind: bets $35
Hero: calls $35
*** TURN *** [3c Kd Ad] [Js]
Small Blind: checks 
Hero: checks 
*** RIVER *** [3c Kd Ad Js] [7s]
Small Blind: bets $1561.28 and is all-in
Hero: folds 
*** SHOW DOWN ***
Small Blind: shows [7d 7c] (a hand...)
Big Blind: shows [3d Jc] (a hand...)
Hero: shows [Qh Jh] (a hand...)
Dealer: shows [9s Tc] (a hand...)
UTG: shows [Ks 4h] (a hand...)
Uncalled bet ($1561.28) returned to Small Blind
Small Blind collected $177 from pot
*** SUMMARY ***
Total pot $180.00 | Rake $3.00
Board [3c Kd Ad Js 7s]
Seat 1: Big Blind folded
Seat 2: UTG folded
Seat 3: Hero folded
Seat 4: Dealer folded
Seat 5: Small Blind collected ($177)



PokerStars Hand #3958376551:  Hold'em No Limit ($2.50/$5) - 2020/06/09 18:06:02 ET
Table 'Zone Poker ID 1612' 9-max Seat #1 is the button
Seat 1: Dealer ($546.33 in chips) 
Seat 2: Small Blind ($231.51 in chips) 
Seat 3: Big Blind ($741.20 in chips) 
Seat 4: UTG ($633.06 in chips) 
Seat 5: Hero ($1042.57 in chips) 
Seat 6: UTG+2 ($633.50 in chips) 
Small Blind: posts small blind $2.50
Big Blind: posts big blind $5
*** HOLE CARDS ***
Dealt to Hero [As 3s]
UTG: folds 
Hero: raises $7.50 to $12.50
UTG+2: folds 
Dealer: raises $22.50 to $35
Small Blind: folds 
Big Blind: folds 
Hero: calls $22.50
*** FLOP *** [Jd 7s 3c]
Hero: checks 
Dealer: bets $25
Hero: raises $57.82 to $82.82
Dealer: raises $92.82 to $175.64
Hero: calls $92.82
*** TURN *** [Jd 7s 3c] [7c]
Hero: checks 
Dealer: checks 
*** RIVER *** [Jd 7s 3c 7c] [5h]
Hero: checks 
Dealer: bets $335.69 and is all-in
Hero: calls $335.69
*** SHOW DOWN ***
Small Blind: shows [4d 7h] (a hand...)
Big Blind: shows [5c Qc] (a hand...)
Hero: shows [As 3s] (a hand...)
Dealer: shows [Qd Kd] (a hand...)
UTG+2: shows [Kc 8h] (a hand...)
UTG: shows [Th 2h] (a hand...)
Hero collected $1096.16 from pot
*** SUMMARY ***
Total pot $1100.16 | Rake $4.00
Board [Jd 7s 3c 7c 5h]
Seat 1: Dealer showed [Qd Kd] and lost with...
Seat 2: Small Blind folded
Seat 3: Big Blind folded
Seat 4: UTG folded
Seat 5: Hero showed [As 3s] and won ($1096.16)
Seat 6: UTG+2 folded



PokerStars Hand #3958368513:  Hold'em No Limit ($2.50/$5) - 2020/06/09 17:48:16 ET
Table 'Zone Poker ID 1612' 9-max Seat #2 is the button
Seat 1: UTG+2 ($953.06 in chips) 
Seat 2: Dealer ($382.00 in chips) 
Seat 3: Small Blind ($535.43 in chips) 
Seat 4: Big Blind ($643.04 in chips) 
Seat 5: UTG ($444.76 in chips) 
Seat 6: Hero ($602.10 in chips) 
Small Blind: posts small blind $2.50
Big Blind: posts big blind $5
*** HOLE CARDS ***
Dealt to Hero [As Qd]
UTG: folds 
Hero: raises $7.50 to $12.50
UTG+2: folds 
Dealer: folds 
Small Blind: folds 
Big Blind: calls $7.50
*** FLOP *** [Qs 5s 7d]
Big Blind: checks 
Hero: bets $8.07
Big Blind: raises $23.07 to $31.14
Hero: calls $23.07
*** TURN *** [Qs 5s 7d] [Jh]
Big Blind: bets $85.78
Hero: calls $85.78
*** RIVER *** [Qs 5s 7d Jh] [Ad]
Big Blind: bets $257.34
Hero: calls $257.34
*** SHOW DOWN ***
Small Blind: shows [Jd 4d] (a hand...)
Big Blind: shows [5c 5h] (a hand...)
Hero: shows [As Qd] (a hand...)
Dealer: shows [6d 7h] (a hand...)
UTG+2: shows [2s Kd] (a hand...)
UTG: shows [4c Tc] (a hand...)
Big Blind collected $772.02 from pot
*** SUMMARY ***
Total pot $776.02 | Rake $4.00
Board [Qs 5s 7d Jh Ad]
Seat 1: UTG+2 folded
Seat 2: Dealer folded
Seat 3: Small Blind folded
Seat 4: Big Blind showed [5c 5h] and won ($772.02)
Seat 5: UTG folded
Seat 6: Hero showed [As Qd] and lost with...



PokerStars Hand #3958367267:  Hold'em No Limit ($2.50/$5) - 2020/06/09 17:45:35 ET
Table 'Zone Poker ID 1612' 9-max Seat #5 is the button
Seat 1: Hero ($557.05 in chips) 
Seat 2: UTG ($587.13 in chips) 
Seat 3: UTG+1 ($566.21 in chips) 
Seat 4: UTG+2 ($463.25 in chips) 
Seat 5: Dealer ($503.50 in chips) 
Seat 6: Small Blind ($829.89 in chips) 
Small Blind: posts small blind $2.50
Hero: posts big blind $5
*** HOLE CARDS ***
Dealt to Hero [Qd Js]
UTG: folds 
UTG+1: folds 
UTG+2: folds 
Dealer: raises $7.50 to $12.50
Small Blind: folds 
Hero: calls $7.50
*** FLOP *** [3c Qc Ts]
Hero: checks 
Dealer: bets $8.07
Hero: calls $8.07
*** TURN *** [3c Qc Ts] [2c]
Hero: checks 
Dealer: checks 
*** RIVER *** [3c Qc Ts 2c] [9c]
Hero: checks 
Dealer: bets $31.10
Hero: calls $31.10
*** SHOW DOWN ***
Small Blind: shows [Th 3s] (a hand...)
Hero: shows [Qd Js] (a hand...)
Dealer: shows [8s Ah] (a hand...)
UTG+2: shows [9h Td] (a hand...)
UTG: shows [5s 3d] (a hand...)
UTG+1: shows [6d 8d] (a hand...)
Hero collected $101.84 from pot
*** SUMMARY ***
Total pot $105.84 | Rake $4.00
Board [3c Qc Ts 2c 9c]
Seat 1: Hero showed [Qd Js] and won ($101.84)
Seat 2: UTG folded
Seat 3: UTG+1 folded
Seat 4: UTG+2 folded
Seat 5: Dealer showed [8s Ah] and lost with...
Seat 6: Small Blind folded



PokerStars Hand #3958365993:  Hold'em No Limit ($2.50/$5) - 2020/06/09 17:42:48 ET
Table 'Zone Poker ID 1612' 9-max Seat #5 is the button
Seat 1: Hero ($928.86 in chips) 
Seat 2: UTG ($500.00 in chips) 
Seat 3: UTG+1 ($472.50 in chips) 
Seat 4: UTG+2 ($402.94 in chips) 
Seat 5: Dealer ($919.21 in chips) 
Seat 6: Small Blind ($525.35 in chips) 
Small Blind: posts small blind $2.50
Hero: posts big blind $5
*** HOLE CARDS ***
Dealt to Hero [Qs 8d]
UTG: folds 
UTG+1: folds 
UTG+2: folds 
Dealer: raises $6 to $11
Small Blind: folds 
Hero: calls $6
*** FLOP *** [Ad Kh 5c]
Hero: checks 
Dealer: bets $7.75
Hero: calls $7.75
*** TURN *** [Ad Kh 5c] [6h]
Hero: checks 
Dealer: checks 
*** RIVER *** [Ad Kh 5c 6h] [3s]
Hero: checks 
Dealer: bets $25.33
Hero: folds 
*** SHOW DOWN ***
Small Blind: shows [5d 6s] (a hand...)
Hero: shows [Qs 8d] (a hand...)
Dealer: shows [7d Td] (a hand...)
UTG+2: shows [2s 7s] (a hand...)
UTG: shows [9d Kc] (a hand...)
UTG+1: shows [Jh 4c] (a hand...)
Uncalled bet ($25.33) returned to Dealer
Dealer collected $38 from pot
*** SUMMARY ***
Total pot $40.00 | Rake $2.00
Board [Ad Kh 5c 6h 3s]
Seat 1: Hero folded
Seat 2: UTG folded
Seat 3: UTG+1 folded
Seat 4: UTG+2 folded
Seat 5: Dealer collected ($38)
Seat 6: Small Blind folded



PokerStars Hand #3958361757:  Hold'em No Limit ($2.50/$5) - 2020/06/09 17:33:13 ET
Table 'Zone Poker ID 1612' 9-max Seat #3 is the button
Seat 1: UTG+1 ($151.35 in chips) 
Seat 2: UTG+2 ($512.50 in chips) 
Seat 3: Hero ($479.62 in chips) 
Seat 4: Small Blind ($845.25 in chips) 
Seat 5: Big Blind ($537.50 in chips) 
Seat 6: UTG ($323.34 in chips) 
Small Blind: posts small blind $2.50
Big Blind: posts big blind $5
*** HOLE CARDS ***
Dealt to Hero [Ad 5h]
UTG: folds 
UTG+1: folds 
UTG+2: folds 
Hero: raises $7.50 to $12.50
Small Blind: folds 
Big Blind: calls $7.50
*** FLOP *** [4c 7c Ts]
Big Blind: checks 
Hero: checks 
*** TURN *** [4c 7c Ts] [2d]
Big Blind: checks 
Hero: checks 
*** RIVER *** [4c 7c Ts 2d] [Qd]
Big Blind: bets $19.60
Hero: folds 
*** SHOW DOWN ***
Small Blind: shows [As 9c] (a hand...)
Big Blind: shows [8s Tc] (a hand...)
Hero: shows [Ad 5h] (a hand...)
UTG+2: shows [7h 2s] (a hand...)
UTG: shows [9h 6s] (a hand...)
UTG+1: shows [Th 3s] (a hand...)
Uncalled bet ($19.60) returned to Big Blind
Big Blind collected $26.13 from pot
*** SUMMARY ***
Total pot $27.50 | Rake $1.37
Board [4c 7c Ts 2d Qd]
Seat 1: UTG+1 folded
Seat 2: UTG+2 folded
Seat 3: Hero folded
Seat 4: Small Blind folded
Seat 5: Big Blind collected ($26.13)
Seat 6: UTG folded



PokerStars Hand #3958360087:  Hold'em No Limit ($2.50/$5) - 2020/06/09 17:29:20 ET
Table 'Zone Poker ID 1612' 9-max Seat #5 is the button
Seat 1: Hero ($500.00 in chips) 
Seat 2: UTG ($542.50 in chips) 
Seat 3: UTG+1 ($580.70 in chips) 
Seat 4: UTG+2 ($497.27 in chips) 
Seat 5: Dealer ($485.00 in chips) 
Seat 6: Small Blind ($497.87 in chips) 
Small Blind: posts small blind $2.50
Hero: posts big blind $5
*** HOLE CARDS ***
Dealt to Hero [5s 3s]
UTG: folds 
UTG+1: folds 
UTG+2: folds 
Dealer: folds 
Small Blind: raises $10.00 to $15
Hero: calls $10
*** FLOP *** [Qh Js As]
Small Blind: checks 
Hero: checks 
*** TURN *** [Qh Js As] [5h]
Small Blind: checks 
Hero: checks 
*** RIVER *** [Qh Js As 5h] [Qc]
Small Blind: bets $21.38
Hero: calls $21.38
*** SHOW DOWN ***
Small Blind: shows [Kc Qd] (a hand...)
Hero: shows [5s 3s] (a hand...)
Dealer: shows [7s 5d] (a hand...)
UTG+2: shows [Ks 4c] (a hand...)
UTG: shows [7d Td] (a hand...)
UTG+1: shows [Jd 8d] (a hand...)
Small Blind collected $69.13 from pot
*** SUMMARY ***
Total pot $72.76 | Rake $3.63
Board [Qh Js As 5h Qc]
Seat 1: Hero showed [5s 3s] and lost with...
Seat 2: UTG folded
Seat 3: UTG+1 folded
Seat 4: UTG+2 folded
Seat 5: Dealer folded
Seat 6: Small Blind showed [Kc Qd] and won ($69.13)



PokerStars Hand #3958356808:  Hold'em No Limit ($2.50/$5) - 2020/06/09 17:21:47 ET
Table 'Zone Poker ID 1612' 9-max Seat #4 is the button
Seat 1: Hero ($500.00 in chips) 
Seat 2: UTG ($745.07 in chips) 
Seat 3: UTG+1 ($500.00 in chips) 
Seat 4: Dealer ($855.62 in chips) 
Seat 5: Small Blind ($530.99 in chips) 
Small Blind: posts small blind $2.50
Hero: posts big blind $5
*** HOLE CARDS ***
Dealt to Hero [Tc 9d]
UTG: raises $6 to $11
UTG+1: folds 
Dealer: folds 
Small Blind: calls $8.50
Hero: calls $6
*** FLOP *** [2d Qd 3s]
Small Blind: checks 
Hero: checks 
UTG: checks 
*** TURN *** [2d Qd 3s] [Th]
Small Blind: bets $5
Hero: calls $5
UTG: folds 
*** RIVER *** [2d Qd 3s Th] [2h]
Small Blind: bets $15
Hero: calls $15
*** SHOW DOWN ***
Small Blind: shows [Qh Td] (a hand...)
Hero: shows [Tc 9d] (a hand...)
Dealer: shows [9s 3h] (a hand...)
UTG: shows [7c 7s] (a hand...)
UTG+1: shows [6s 6c] (a hand...)
Small Blind collected $70 from pot
*** SUMMARY ***
Total pot $73.00 | Rake $3.00
Board [2d Qd 3s Th 2h]
Seat 1: Hero showed [Tc 9d] and lost with...
Seat 2: UTG folded
Seat 3: UTG+1 folded
Seat 4: Dealer folded
Seat 5: Small Blind showed [Qh Td] and won ($70)



PokerStars Hand #3958229540:  Hold'em No Limit ($2.50/$5) - 2020/06/09 10:43:51 ET
Table 'Zone Poker ID 1612' 9-max Seat #1 is the button
Seat 1: Hero ($511.00 in chips) 
Seat 2: Big Blind ($250.00 in chips) 
Hero: posts small blind $2.50
Big Blind: posts big blind $5
*** HOLE CARDS ***
Dealt to Hero [4c 4h]
Hero: raises $7.50 to $12.50
Big Blind: calls $7.50
*** FLOP *** [3h 9h Qh]
Big Blind: checks 
Hero: checks 
*** TURN *** [3h 9h Qh] [2c]
Big Blind: bets $12
Hero: calls $12
*** RIVER *** [3h 9h Qh 2c] [Ac]
Big Blind: bets $24
Hero: folds 
*** SHOW DOWN ***
Big Blind: shows [5s 4d] (a hand...)
Hero: shows [4c 4h] (a hand...)
Uncalled bet ($24.00) returned to Big Blind
Big Blind collected $48 from pot
*** SUMMARY ***
Total pot $49.00 | Rake $1.00
Board [3h 9h Qh 2c Ac]
Seat 1: Hero folded
Seat 2: Big Blind collected ($48)



PokerStars Hand #3958229223:  Hold'em No Limit ($2.50/$5) - 2020/06/09 10:42:25 ET
Table 'Zone Poker ID 1612' 9-max Seat #1 is the button
Seat 1: Hero ($695.73 in chips) 
Seat 2: Big Blind ($236.82 in chips) 
Hero: posts small blind $2.50
Big Blind: posts big blind $5
*** HOLE CARDS ***
Dealt to Hero [2d Qd]
Hero: raises $7.50 to $12.50
Big Blind: calls $7.50
*** FLOP *** [3d 4h 8h]
Big Blind: checks 
Hero: bets $7.20
Big Blind: calls $7.20
*** TURN *** [3d 4h 8h] [7c]
Big Blind: checks 
Hero: checks 
*** RIVER *** [3d 4h 8h 7c] [2h]
Big Blind: bets $24.20
Hero: folds 
*** SHOW DOWN ***
Big Blind: shows [9c Kd] (a hand...)
Hero: shows [2d Qd] (a hand...)
Uncalled bet ($24.20) returned to Big Blind
Big Blind collected $38.40 from pot
*** SUMMARY ***
Total pot $39.40 | Rake $1.00
Board [3d 4h 8h 7c 2h]
Seat 1: Hero folded
Seat 2: Big Blind collected ($38.40)



PokerStars Hand #3958229041:  Hold'em No Limit ($2.50/$5) - 2020/06/09 10:41:32 ET
Table 'Zone Poker ID 1612' 9-max Seat #2 is the button
Seat 1: Big Blind ($234.82 in chips) 
Seat 2: Hero ($502.50 in chips) 
Hero: posts small blind $2.50
Big Blind: posts big blind $5
*** HOLE CARDS ***
Dealt to Hero [Td As]
Hero: raises $7.50 to $12.50
Big Blind: calls $7.50
*** FLOP *** [4s 8d 4d]
Big Blind: bets $12
Hero: calls $12
*** TURN *** [4s 8d 4d] [3h]
Big Blind: bets $24
Hero: calls $24
*** RIVER *** [4s 8d 4d 3h] [3c]
Big Blind: bets $48
Hero: calls $48
*** SHOW DOWN ***
Big Blind: shows [7d Ad] (a hand...)
Hero: shows [Td As] (a hand...)
Big Blind collected $96 from pot
Hero collected $96 from pot
*** SUMMARY ***
Total pot $193.00 | Rake $1.00
Board [4s 8d 4d 3h 3c]
Seat 1: Big Blind showed [7d Ad] and won ($96)
Seat 2: Hero showed [Td As] and won ($96)



PokerStars Hand #3958227687:  Hold'em No Limit ($2.50/$5) - 2020/06/09 10:35:12 ET
Table 'Zone Poker ID 1612' 9-max Seat #1 is the button
Seat 1: Dealer ($698.86 in chips) 
Seat 2: Hero ($514.50 in chips) 
Dealer: posts small blind $2.50
Hero: posts big blind $5
*** HOLE CARDS ***
Dealt to Hero [9h Qc]
Dealer: raises $7.70 to $12.70
Hero: calls $7.70
*** FLOP *** [3c 3s Ac]
Hero: checks 
Dealer: bets $7.20
Hero: calls $7.20
*** TURN *** [3c 3s Ac] [2c]
Hero: checks 
Dealer: checks 
*** RIVER *** [3c 3s Ac 2c] [6d]
Hero: checks 
Dealer: bets $24.40
Hero: folds 
*** SHOW DOWN ***
Dealer: shows [9s 6s] (a hand...)
Hero: shows [9h Qc] (a hand...)
Uncalled bet ($24.40) returned to Dealer
Dealer collected $38.80 from pot
*** SUMMARY ***
Total pot $39.80 | Rake $1.00
Board [3c 3s Ac 2c 6d]
Seat 1: Dealer collected ($38.80)
Seat 2: Hero folded



PokerStars Hand #3958227529:  Hold'em No Limit ($2.50/$5) - 2020/06/09 10:34:30 ET
Table 'Zone Poker ID 1612' 9-max Seat #1 is the button
Seat 1: Hero ($563.00 in chips) 
Seat 2: Big Blind ($226.21 in chips) 
Hero: posts small blind $2.50
Big Blind: posts big blind $5
*** HOLE CARDS ***
Dealt to Hero [As 8c]
Hero: raises $7.50 to $12.50
Big Blind: calls $7.50
*** FLOP *** [4h 3s 7h]
Big Blind: checks 
Hero: checks 
*** TURN *** [4h 3s 7h] [Qc]
Big Blind: bets $12
Hero: calls $12
*** RIVER *** [4h 3s 7h Qc] [2d]
Big Blind: bets $24
Hero: calls $24
*** SHOW DOWN ***
Big Blind: shows [7s Ts] (a hand...)
Hero: shows [As 8c] (a hand...)
Big Blind collected $96 from pot
*** SUMMARY ***
Total pot $97.00 | Rake $1.00
Board [4h 3s 7h Qc 2d]
Seat 1: Hero showed [As 8c] and lost with...
Seat 2: Big Blind showed [7s Ts] and won ($96)



PokerStars Hand #3958224479:  Hold'em No Limit ($2.50/$5) - 2020/06/09 10:19:49 ET
Table 'Zone Poker ID 1612' 9-max Seat #1 is the button
Seat 1: Hero ($1605.51 in chips) 
Seat 2: Small Blind ($201.00 in chips) 
Seat 3: Big Blind ($554.99 in chips) 
Small Blind: posts small blind $2.50
Big Blind: posts big blind $5
*** HOLE CARDS ***
Dealt to Hero [8c 8d]
Hero: raises $7.50 to $12.50
Small Blind: folds 
Big Blind: calls $7.50
*** FLOP *** [6s Qc 3c]
Big Blind: checks 
Hero: bets $8.07
Big Blind: raises $21.14 to $29.21
Hero: calls $21.14
*** TURN *** [6s Qc 3c] [5h]
Big Blind: bets $50
Hero: calls $50
*** RIVER *** [6s Qc 3c 5h] [Td]
Big Blind: bets $117
Hero: folds 
*** SHOW DOWN ***
Small Blind: shows [4d Kh] (a hand...)
Big Blind: shows [8h 7c] (a hand...)
Hero: shows [8c 8d] (a hand...)
Uncalled bet ($117.00) returned to Big Blind
Big Blind collected $183.92 from pot
*** SUMMARY ***
Total pot $185.92 | Rake $2.00
Board [6s Qc 3c 5h Td]
Seat 1: Hero folded
Seat 2: Small Blind folded
Seat 3: Big Blind collected ($183.92)



PokerStars Hand #3958222918:  Hold'em No Limit ($2.50/$5) - 2020/06/09 10:12:03 ET
Table 'Zone Poker ID 1612' 9-max Seat #2 is the button
Seat 1: Big Blind ($627.21 in chips) 
Seat 2: Dealer ($579.42 in chips) 
Seat 3: Hero ($1094.46 in chips) 
Hero: posts small blind $2.50
Big Blind: posts big blind $5
*** HOLE CARDS ***
Dealt to Hero [Ah 9s]
Dealer: folds 
Hero: raises $10.00 to $15
Big Blind: calls $10
*** FLOP *** [9d 8s Jd]
Hero: checks 
Big Blind: checks 
*** TURN *** [9d 8s Jd] [5s]
Hero: bets $20
Big Blind: calls $20
*** RIVER *** [9d 8s Jd 5s] [Jh]
Hero: bets $51
Big Blind: raises $90 to $141
Hero: calls $90
*** SHOW DOWN ***
Dealer: shows [7d 5c] (a hand...)
Big Blind: shows [Ks Qd] (a hand...)
Hero: shows [Ah 9s] (a hand...)
Hero collected $350 from pot
*** SUMMARY ***
Total pot $352.00 | Rake $2.00
Board [9d 8s Jd 5s Jh]
Seat 1: Big Blind showed [Ks Qd] and lost with...
Seat 2: Dealer folded
Seat 3: Hero showed [Ah 9s] and won ($350)



PokerStars Hand #3958222706:  Hold'em No Limit ($2.50/$5) - 2020/06/09 10:11:00 ET
Table 'Zone Poker ID 1612' 9-max Seat #1 is the button
Seat 1: Dealer ($500.00 in chips) 
Seat 2: Small Blind ($596.92 in chips) 
Seat 3: Hero ($1055.47 in chips) 
Small Blind: posts small blind $2.50
Hero: posts big blind $5
*** HOLE CARDS ***
Dealt to Hero [8d 7c]
Dealer: raises $6 to $11
Small Blind: folds 
Hero: calls $6
*** FLOP *** [Qh 9h 8h]
Hero: checks 
Dealer: bets $7.68
Hero: calls $7.68
*** TURN *** [Qh 9h 8h] [Kd]
Hero: checks 
Dealer: checks 
*** RIVER *** [Qh 9h 8h Kd] [6s]
Hero: checks 
Dealer: bets $18.94
Hero: calls $18.94
*** SHOW DOWN ***
Small Blind: shows [2h 6c] (a hand...)
Dealer: shows [Td Qs] (a hand...)
Hero: shows [8d 7c] (a hand...)
Dealer collected $75.74 from pot
*** SUMMARY ***
Total pot $77.74 | Rake $2.00
Board [Qh 9h 8h Kd 6s]
Seat 1: Dealer showed [Td Qs] and won ($75.74)
Seat 2: Small Blind folded
Seat 3: Hero showed [8d 7c] and lost with...



PokerStars Hand #3958220355:  Hold'em No Limit ($2.50/$5) - 2020/06/09 09:58:03 ET
Table 'Zone Poker ID 1612' 9-max Seat #3 is the button
Seat 1: Hero ($1000.64 in chips) 
Seat 2: Big Blind ($493.91 in chips) 
Seat 3: Dealer ($463.66 in chips) 
Hero: posts small blind $2.50
Big Blind: posts big blind $5
*** HOLE CARDS ***
Dealt to Hero [Qd Qs]
Dealer: raises $10 to $15
Hero: raises $45.00 to $60
Big Blind: folds 
Dealer: calls $45
*** FLOP *** [7d Ad Kh]
Hero: bets $36.90
Dealer: calls $36.90
*** TURN *** [7d Ad Kh] [Kd]
Hero: checks 
Dealer: bets $98.40
Hero: calls $98.40
*** RIVER *** [7d Ad Kh Kd] [4s]
Hero: checks 
Dealer: bets $268.36 and is all-in
Hero: folds 
*** SHOW DOWN ***
Dealer: shows [5d 5h] (a hand...)
Big Blind: shows [2d Ks] (a hand...)
Hero: shows [Qd Qs] (a hand...)
Uncalled bet ($268.36) returned to Dealer
Dealer collected $393.60 from pot
*** SUMMARY ***
Total pot $395.60 | Rake $2.00
Board [7d Ad Kh Kd 4s]
Seat 1: Hero folded
Seat 2: Big Blind folded
Seat 3: Dealer collected ($393.60)



PokerStars Hand #3957998859:  Hold'em No Limit ($2.50/$5) - 2020/06/08 21:58:37 ET
Table 'Zone Poker ID 1612' 9-max Seat #4 is the button
Seat 1: Hero ($949.27 in chips) 
Seat 2: Big Blind ($205.00 in chips) 
Seat 3: UTG ($500.00 in chips) 
Seat 4: Dealer ($656.58 in chips) 
Hero: posts small blind $2.50
Big Blind: posts big blind $5
*** HOLE CARDS ***
Dealt to Hero [Jc Jd]
UTG: folds 
Dealer: raises $7.50 to $12.50
Hero: raises $42.50 to $55
Big Blind: folds 
Dealer: calls $42.50
*** FLOP *** [4h 5c 6h]
Hero: bets $72.52
Dealer: calls $72.52
*** TURN *** [4h 5c 6h] [8h]
Hero: checks 
Dealer: checks 
*** RIVER *** [4h 5c 6h 8h] [Js]
Hero: bets $83.11
Dealer: raises $445.95 to $529.06 and is all-in
Hero: folds 
*** SHOW DOWN ***
UTG: shows [4c 8s] (a hand...)
Dealer: shows [Qh Kh] (a hand...)
Big Blind: shows [Tc 7s] (a hand...)
Hero: shows [Jc Jd] (a hand...)
Uncalled bet ($445.95) returned to Dealer
Dealer collected $423.26 from pot
*** SUMMARY ***
Total pot $426.26 | Rake $3.00
Board [4h 5c 6h 8h Js]
Seat 1: Hero folded
Seat 2: Big Blind folded
Seat 3: UTG folded
Seat 4: Dealer collected ($423.26)



PokerStars Hand #3957997805:  Hold'em No Limit ($2.50/$5) - 2020/06/08 21:56:47 ET
Table 'Zone Poker ID 1612' 9-max Seat #1 is the button
Seat 1: Dealer ($807.47 in chips) 
Seat 2: Small Blind ($229.72 in chips) 
Seat 3: Hero ($1807.86 in chips) 
Seat 4: UTG ($280.02 in chips) 
Small Blind: posts small blind $2.50
Hero: posts big blind $5
*** HOLE CARDS ***
Dealt to Hero [8c Ks]
UTG: folds 
Dealer: folds 
Small Blind: calls $2.50
Hero: checks 
*** FLOP *** [Jh 8h 7s]
Small Blind: bets $5
Hero: calls $5
*** TURN *** [Jh 8h 7s] [2d]
Small Blind: bets $10
Hero: calls $10
*** RIVER *** [Jh 8h 7s 2d] [2c]
Small Blind: bets $15
Hero: calls $15
*** SHOW DOWN ***
Small Blind: shows [As 8d] (a hand...)
UTG: shows [9h Kd] (a hand...)
Dealer: shows [6s 7c] (a hand...)
Hero: shows [8c Ks] (a hand...)
Small Blind collected $67 from pot
*** SUMMARY ***
Total pot $70.00 | Rake $3.00
Board [Jh 8h 7s 2d 2c]
Seat 1: Dealer folded
Seat 2: Small Blind showed [As 8d] and won ($67)
Seat 3: Hero showed [8c Ks] and lost with...
Seat 4: UTG folded



PokerStars Hand #3957993131:  Hold'em No Limit ($2.50/$5) - 2020/06/08 21:48:22 ET
Table 'Zone Poker ID 1612' 9-max Seat #2 is the button
Seat 1: Hero ($538.75 in chips) 
Seat 2: Dealer ($169.12 in chips) 
Seat 3: Small Blind ($639.24 in chips) 
Small Blind: posts small blind $2.50
Hero: posts big blind $5
*** HOLE CARDS ***
Dealt to Hero [Kh 3h]
Dealer: raises $7.50 to $12.50
Small Blind: folds 
Hero: calls $7.50
*** FLOP *** [8d 4c 7c]
Hero: checks 
Dealer: checks 
*** TURN *** [8d 4c 7c] [2c]
Hero: checks 
Dealer: checks 
*** RIVER *** [8d 4c 7c 2c] [Kc]
Hero: checks 
Dealer: bets $20
Hero: calls $20
*** SHOW DOWN ***
Small Blind: shows [3c Tc] (a hand...)
Dealer: shows [5h Ac] (a hand...)
Hero: shows [Kh 3h] (a hand...)
Dealer collected $65.50 from pot
*** SUMMARY ***
Total pot $67.50 | Rake $2.00
Board [8d 4c 7c 2c Kc]
Seat 1: Hero showed [Kh 3h] and lost with...
Seat 2: Dealer showed [5h Ac] and won ($65.50)
Seat 3: Small Blind folded



PokerStars Hand #3957985006:  Hold'em No Limit ($2.50/$5) - 2020/06/08 21:33:34 ET
Table 'Zone Poker ID 1612' 9-max Seat #5 is the button
Seat 1: Small Blind ($112.77 in chips) 
Seat 2: Hero ($1408.38 in chips) 
Seat 3: UTG ($261.33 in chips) 
Seat 4: UTG+1 ($500.00 in chips) 
Seat 5: Dealer ($947.48 in chips) 
Small Blind: posts small blind $2.50
Hero: posts big blind $5
*** HOLE CARDS ***
Dealt to Hero [Ts As]
UTG: raises $5 to $10
UTG+1: folds 
Dealer: folds 
Small Blind: folds 
Hero: calls $5
*** FLOP *** [6s 7c 8c]
Hero: checks 
UTG: checks 
*** TURN *** [6s 7c 8c] [2d]
Hero: checks 
UTG: checks 
*** RIVER *** [6s 7c 8c 2d] [Ks]
Hero: checks 
UTG: bets $10.69
Hero: folds 
*** SHOW DOWN ***
Small Blind: shows [7d Kc] (a hand...)
Hero: shows [Ts As] (a hand...)
Dealer: shows [2c Qh] (a hand...)
UTG: shows [Kh Qd] (a hand...)
UTG+1: shows [4h 9h] (a hand...)
Uncalled bet ($10.69) returned to UTG
UTG collected $21.38 from pot
*** SUMMARY ***
Total pot $22.50 | Rake $1.12
Board [6s 7c 8c 2d Ks]
Seat 1: Small Blind folded
Seat 2: Hero folded
Seat 3: UTG collected ($21.38)
Seat 4: UTG+1 folded
Seat 5: Dealer folded



PokerStars Hand #3957983776:  Hold'em No Limit ($2.50/$5) - 2020/06/08 21:31:16 ET
Table 'Zone Poker ID 1612' 9-max Seat #1 is the button
Seat 1: Dealer ($530.57 in chips) 
Seat 2: Small Blind ($568.42 in chips) 
Seat 3: Hero ($462.63 in chips) 
Seat 4: UTG ($206.53 in chips) 
Seat 5: UTG+1 ($1042.70 in chips) 
Small Blind: posts small blind $2.50
Hero: posts big blind $5
*** HOLE CARDS ***
Dealt to Hero [Qd 9s]
UTG: folds 
UTG+1: folds 
Dealer: raises $5 to $10
Small Blind: folds 
Hero: calls $5
*** FLOP *** [Kc Jc 6h]
Hero: checks 
Dealer: bets $6
Hero: calls $6
*** TURN *** [Kc Jc 6h] [Ac]
Hero: checks 
Dealer: checks 
*** RIVER *** [Kc Jc 6h Ac] [Qh]
Hero: checks 
Dealer: bets $24.59
Hero: folds 
*** SHOW DOWN ***
Small Blind: shows [6s 3s] (a hand...)
Hero: shows [Qd 9s] (a hand...)
Dealer: shows [Kd Td] (a hand...)
UTG: shows [5d Jh] (a hand...)
UTG+1: shows [9c 3c] (a hand...)
Uncalled bet ($24.59) returned to Dealer
Dealer collected $32.78 from pot
*** SUMMARY ***
Total pot $34.50 | Rake $1.72
Board [Kc Jc 6h Ac Qh]
Seat 1: Dealer collected ($32.78)
Seat 2: Small Blind folded
Seat 3: Hero folded
Seat 4: UTG folded
Seat 5: UTG+1 folded



PokerStars Hand #3957981783:  Hold'em No Limit ($2.50/$5) - 2020/06/08 21:27:29 ET
Table 'Zone Poker ID 1612' 9-max Seat #5 is the button
Seat 1: Small Blind ($1028.90 in chips) 
Seat 2: Big Blind ($109.14 in chips) 
Seat 3: UTG ($674.34 in chips) 
Seat 4: UTG+1 ($164.88 in chips) 
Seat 5: Hero ($637.00 in chips) 
Small Blind: posts small blind $2.50
Big Blind: posts big blind $5
*** HOLE CARDS ***
Dealt to Hero [Kc Kd]
UTG: raises $7.50 to $12.50
UTG+1: folds 
Hero: raises $30.00 to $42.50
Small Blind: folds 
Big Blind: folds 
UTG: raises $77.50 to $120
Hero: calls $77.50
*** FLOP *** [Ac Qs 6d]
UTG: bets $50
Hero: calls $50
*** TURN *** [Ac Qs 6d] [8s]
UTG: bets $100
Hero: calls $100
*** RIVER *** [Ac Qs 6d 8s] [Ks]
UTG: bets $404.34 and is all-in
Hero: calls $367 and is all-in
*** SHOW DOWN ***
Small Blind: shows [Jh 9c] (a hand...)
Big Blind: shows [4d 7d] (a hand...)
Hero: shows [Kc Kd] (a hand...)
UTG: shows [Kh Th] (a hand...)
UTG+1: shows [3c 5s] (a hand...)
Uncalled bet ($37.34) returned to UTG
Hero collected $1278.50 from pot
*** SUMMARY ***
Total pot $1281.50 | Rake $3.00
Board [Ac Qs 6d 8s Ks]
Seat 1: Small Blind folded
Seat 2: Big Blind folded
Seat 3: UTG showed [Kh Th] and lost with...
Seat 4: UTG+1 folded
Seat 5: Hero showed [Kc Kd] and won ($1278.50)



PokerStars Hand #3957860951:  Hold'em No Limit ($2.50/$5) - 2020/06/08 16:47:51 ET
Table 'Zone Poker ID 1612' 9-max Seat #5 is the button
Seat 1: Small Blind ($495.00 in chips) 
Seat 2: Hero ($891.20 in chips) 
Seat 3: UTG ($495.00 in chips) 
Seat 4: UTG+1 ($542.07 in chips) 
Seat 5: Dealer ($822.92 in chips) 
Small Blind: posts small blind $2.50
Hero: posts big blind $5
*** HOLE CARDS ***
Dealt to Hero [Th As]
UTG: folds 
UTG+1: folds 
Dealer: folds 
Small Blind: raises $10.00 to $15
Hero: calls $10
*** FLOP *** [Qc 8c Ks]
Small Blind: bets $21.38
Hero: calls $21.38
*** TURN *** [Qc 8c Ks] [6d]
Small Blind: bets $52.32
Hero: calls $52.32
*** RIVER *** [Qc 8c Ks 6d] [4c]
Small Blind: bets $130.80
Hero: folds 
*** SHOW DOWN ***
Small Blind: shows [Qd Kc] (a hand...)
Hero: shows [Th As] (a hand...)
Dealer: shows [9h 5s] (a hand...)
UTG: shows [Ts 8s] (a hand...)
UTG+1: shows [5h 3d] (a hand...)
Uncalled bet ($130.80) returned to Small Blind
Small Blind collected $174.40 from pot
*** SUMMARY ***
Total pot $177.40 | Rake $3.00
Board [Qc 8c Ks 6d 4c]
Seat 1: Small Blind collected ($174.40)
Seat 2: Hero folded
Seat 3: UTG folded
Seat 4: UTG+1 folded
Seat 5: Dealer folded



PokerStars Hand #3957855937:  Hold'em No Limit ($2.50/$5) - 2020/06/08 16:33:50 ET
Table 'Zone Poker ID 1612' 9-max Seat #6 is the button
Seat 1: Hero ($606.12 in chips) 
Seat 2: Big Blind ($696.93 in chips) 
Seat 3: UTG ($531.27 in chips) 
Seat 4: UTG+1 ($780.84 in chips) 
Seat 5: UTG+2 ($538.40 in chips) 
Seat 6: Dealer ($468.68 in chips) 
Hero: posts small blind $2.50
Big Blind: posts big blind $5
*** HOLE CARDS ***
Dealt to Hero [Tc Kc]
UTG: folds 
UTG+1: folds 
UTG+2: folds 
Dealer: folds 
Hero: raises $10.00 to $15
Big Blind: calls $10
*** FLOP *** [5d 7c Ah]
Hero: checks 
Big Blind: bets $16.56
Hero: calls $16.56
*** TURN *** [5d 7c Ah] [4c]
Hero: checks 
Big Blind: bets $40.49
Hero: calls $40.49
*** RIVER *** [5d 7c Ah 4c] [2s]
Hero: checks 
Big Blind: bets $105.83
Hero: folds 
*** SHOW DOWN ***
Big Blind: shows [Ad 9s] (a hand...)
Hero: shows [Tc Kc] (a hand...)
UTG+2: shows [2d 5c] (a hand...)
Dealer: shows [8h 3d] (a hand...)
UTG: shows [Qs 5s] (a hand...)
UTG+1: shows [5h 3c] (a hand...)
Uncalled bet ($105.83) returned to Big Blind
Big Blind collected $140.10 from pot
*** SUMMARY ***
Total pot $144.10 | Rake $4.00
Board [5d 7c Ah 4c 2s]
Seat 1: Hero folded
Seat 2: Big Blind collected ($140.10)
Seat 3: UTG folded
Seat 4: UTG+1 folded
Seat 5: UTG+2 folded
Seat 6: Dealer folded



PokerStars Hand #3957852183:  Hold'em No Limit ($2.50/$5) - 2020/06/08 16:22:44 ET
Table 'Zone Poker ID 1612' 9-max Seat #1 is the button
Seat 1: Dealer ($547.87 in chips) 
Seat 2: Small Blind ($771.62 in chips) 
Seat 3: Big Blind ($720.02 in chips) 
Seat 4: Hero ($638.08 in chips) 
Seat 5: UTG+1 ($642.15 in chips) 
Small Blind: posts small blind $2.50
Big Blind: posts big blind $5
*** HOLE CARDS ***
Dealt to Hero [Js Qc]
Hero: raises $7.50 to $12.50
UTG+1: folds 
Dealer: folds 
Small Blind: folds 
Big Blind: calls $7.50
*** FLOP *** [8h 6s Kc]
Big Blind: checks 
Hero: bets $7.84
Big Blind: calls $7.84
*** TURN *** [8h 6s Kc] [5h]
Big Blind: checks 
Hero: checks 
*** RIVER *** [8h 6s Kc 5h] [Qh]
Big Blind: bets $14
Hero: calls $14
*** SHOW DOWN ***
Small Blind: shows [4c 8c] (a hand...)
Big Blind: shows [9h Kh] (a hand...)
Hero: shows [Js Qc] (a hand...)
Dealer: shows [9s Tc] (a hand...)
UTG+1: shows [Jh 3c] (a hand...)
Big Blind collected $68.18 from pot
*** SUMMARY ***
Total pot $71.18 | Rake $3.00
Board [8h 6s Kc 5h Qh]
Seat 1: Dealer folded
Seat 2: Small Blind folded
Seat 3: Big Blind showed [9h Kh] and won ($68.18)
Seat 4: Hero showed [Js Qc] and lost with...
Seat 5: UTG+1 folded



PokerStars Hand #3957852130:  Hold'em No Limit ($2.50/$5) - 2020/06/08 16:22:34 ET
Table 'Zone Poker ID 1612' 9-max Seat #5 is the button
Seat 1: Small Blind ($516.79 in chips) 
Seat 2: Big Blind ($795.87 in chips) 
Seat 3: UTG ($1455.49 in chips) 
Seat 4: UTG+1 ($720.02 in chips) 
Seat 5: Hero ($590.35 in chips) 
Small Blind: posts small blind $2.50
Big Blind: posts big blind $5
*** HOLE CARDS ***
Dealt to Hero [Qd Qs]
UTG: folds 
UTG+1: folds 
Hero: raises $7.50 to $12.50
Small Blind: calls $10
Big Blind: folds 
*** FLOP *** [Td 5c 4c]
Small Blind: checks 
Hero: bets $20
Small Blind: calls $20
*** TURN *** [Td 5c 4c] [Ac]
Small Blind: checks 
Hero: checks 
*** RIVER *** [Td 5c 4c Ac] [2d]
Small Blind: bets $53.57
Hero: calls $53.57
*** SHOW DOWN ***
Small Blind: shows [9c 8c] (a hand...)
Big Blind: shows [5h Jd] (a hand...)
Hero: shows [Qd Qs] (a hand...)
UTG: shows [Jc 9s] (a hand...)
UTG+1: shows [3h Js] (a hand...)
Small Blind collected $174.14 from pot
*** SUMMARY ***
Total pot $177.14 | Rake $3.00
Board [Td 5c 4c Ac 2d]
Seat 1: Small Blind showed [9c 8c] and won ($174.14)
Seat 2: Big Blind folded
Seat 3: UTG folded
Seat 4: UTG+1 folded
Seat 5: Hero showed [Qd Qs] and lost with...



PokerStars Hand #3957848216:  Hold'em No Limit ($2.50/$5) - 2020/06/08 16:10:53 ET
Table 'Zone Poker ID 1612' 9-max Seat #4 is the button
Seat 1: Big Blind ($277.53 in chips) 
Seat 2: Hero ($627.57 in chips) 
Seat 3: UTG+1 ($466.00 in chips) 
Seat 4: Dealer ($917.08 in chips) 
Seat 5: Small Blind ($423.13 in chips) 
Small Blind: posts small blind $2.50
Big Blind: posts big blind $5
*** HOLE CARDS ***
Dealt to Hero [Qd Td]
Hero: raises $7.50 to $12.50
UTG+1: folds 
Dealer: folds 
Small Blind: calls $10
Big Blind: folds 
*** FLOP *** [4s 8c Ks]
Small Blind: checks 
Hero: bets $14.25
Small Blind: calls $14.25
*** TURN *** [4s 8c Ks] [6c]
Small Blind: checks 
Hero: checks 
*** RIVER *** [4s 8c Ks 6c] [Js]
Small Blind: bets $27.79
Hero: folds 
*** SHOW DOWN ***
Small Blind: shows [Th As] (a hand...)
Big Blind: shows [3s 9h] (a hand...)
Hero: shows [Qd Td] (a hand...)
Dealer: shows [7c Qc] (a hand...)
UTG+1: shows [3h 4d] (a hand...)
Uncalled bet ($27.79) returned to Small Blind
Small Blind collected $55.58 from pot
*** SUMMARY ***
Total pot $58.50 | Rake $2.92
Board [4s 8c Ks 6c Js]
Seat 1: Big Blind folded
Seat 2: Hero folded
Seat 3: UTG+1 folded
Seat 4: Dealer folded
Seat 5: Small Blind collected ($55.58)



PokerStars Hand #3957845299:  Hold'em No Limit ($2.50/$5) - 2020/06/08 16:02:17 ET
Table 'Zone Poker ID 1612' 9-max Seat #1 is the button
Seat 1: Dealer ($984.11 in chips) 
Seat 2: Small Blind ($623.84 in chips) 
Seat 3: Hero ($664.17 in chips) 
Seat 4: UTG ($500.00 in chips) 
Seat 5: UTG+1 ($500.00 in chips) 
Small Blind: posts small blind $2.50
Hero: posts big blind $5
*** HOLE CARDS ***
Dealt to Hero [5s Jc]
UTG: folds 
UTG+1: folds 
Dealer: folds 
Small Blind: calls $2.50
Hero: checks 
*** FLOP *** [6c 9c 5c]
Small Blind: bets $9.50
Hero: calls $9.50
*** TURN *** [6c 9c 5c] [6d]
Small Blind: bets $13.78
Hero: calls $13.78
*** RIVER *** [6c 9c 5c 6d] [3s]
Small Blind: bets $21.87
Hero: calls $21.87
*** SHOW DOWN ***
Small Blind: shows [2d Ac] (a hand...)
Hero: shows [5s Jc] (a hand...)
Dealer: shows [3d 2s] (a hand...)
UTG: shows [Qc 6s] (a hand...)
UTG+1: shows [6h 5d] (a hand...)
Hero collected $97.30 from pot
*** SUMMARY ***
Total pot $100.30 | Rake $3.00
Board [6c 9c 5c 6d 3s]
Seat 1: Dealer folded
Seat 2: Small Blind showed [2d Ac] and lost with...
Seat 3: Hero showed [5s Jc] and won ($97.30)
Seat 4: UTG folded
Seat 5: UTG+1 folded



PokerStars Hand #3957844580:  Hold'em No Limit ($2.50/$5) - 2020/06/08 16:00:10 ET
Table 'Zone Poker ID 1612' 9-max Seat #3 is the button
Seat 1: Big Blind ($691.68 in chips) 
Seat 2: Hero ($524.45 in chips) 
Seat 3: Dealer ($701.28 in chips) 
Seat 4: Small Blind ($499.43 in chips) 
Small Blind: posts small blind $2.50
Big Blind: posts big blind $5
*** HOLE CARDS ***
Dealt to Hero [8c 5c]
Hero: raises $7.50 to $12.50
Dealer: folds 
Small Blind: folds 
Big Blind: calls $7.50
*** FLOP *** [8d 7d Th]
Big Blind: checks 
Hero: checks 
*** TURN *** [8d 7d Th] [As]
Big Blind: checks 
Hero: checks 
*** RIVER *** [8d 7d Th As] [Ac]
Big Blind: bets $9
Hero: calls $9
*** SHOW DOWN ***
Small Blind: shows [5h Jc] (a hand...)
Dealer: shows [Qd Ts] (a hand...)
Big Blind: shows [8s 8h] (a hand...)
Hero: shows [8c 5c] (a hand...)
Big Blind collected $43.23 from pot
*** SUMMARY ***
Total pot $45.50 | Rake $2.27
Board [8d 7d Th As Ac]
Seat 1: Big Blind showed [8s 8h] and won ($43.23)
Seat 2: Hero showed [8c 5c] and lost with...
Seat 3: Dealer folded
Seat 4: Small Blind folded



PokerStars Hand #3957843174:  Hold'em No Limit ($2.50/$5) - 2020/06/08 15:56:17 ET
Table 'Zone Poker ID 1612' 9-max Seat #1 is the button
Seat 1: Hero ($485.00 in chips) 
Seat 2: Small Blind ($1371.85 in chips) 
Seat 3: Big Blind ($505.00 in chips) 
Small Blind: posts small blind $2.50
Big Blind: posts big blind $5
*** HOLE CARDS ***
Dealt to Hero [8s Qs]
Hero: raises $7.50 to $12.50
Small Blind: folds 
Big Blind: calls $7.50
*** FLOP *** [Td 4d Ks]
Big Blind: checks 
Hero: bets $20
Big Blind: calls $20
*** TURN *** [Td 4d Ks] [3h]
Big Blind: checks 
Hero: checks 
*** RIVER *** [Td 4d Ks 3h] [Ac]
Big Blind: bets $65.50
Hero: folds 
*** SHOW DOWN ***
Small Blind: shows [7h 8d] (a hand...)
Big Blind: shows [Qh Jc] (a hand...)
Hero: shows [8s Qs] (a hand...)
Uncalled bet ($65.50) returned to Big Blind
Big Blind collected $65.50 from pot
*** SUMMARY ***
Total pot $67.50 | Rake $2.00
Board [Td 4d Ks 3h Ac]
Seat 1: Hero folded
Seat 2: Small Blind folded
Seat 3: Big Blind collected ($65.50)



PokerStars Hand #3957821405:  Hold'em No Limit ($2.50/$5) - 2020/06/08 14:52:58 ET
Table 'Zone Poker ID 1612' 9-max Seat #1 is the button
Seat 1: Dealer ($1353.03 in chips) 
Seat 2: Hero ($983.14 in chips) 
Seat 3: Big Blind ($376.45 in chips) 
Hero: posts small blind $2.50
Big Blind: posts big blind $5
*** HOLE CARDS ***
Dealt to Hero [Ac Js]
Dealer: folds 
Hero: raises $10.00 to $15
Big Blind: calls $10
*** FLOP *** [Ad 7c 4h]
Hero: bets $8.55
Big Blind: calls $8.55
*** TURN *** [Ad 7c 4h] [7s]
Hero: checks 
Big Blind: bets $10
Hero: calls $10
*** RIVER *** [Ad 7c 4h 7s] [8s]
Hero: checks 
Big Blind: bets $65.10
Hero: folds 
*** SHOW DOWN ***
Dealer: shows [8h Kc] (a hand...)
Big Blind: shows [6d 5d] (a hand...)
Hero: shows [Ac Js] (a hand...)
Uncalled bet ($65.10) returned to Big Blind
Big Blind collected $65.10 from pot
*** SUMMARY ***
Total pot $67.10 | Rake $2.00
Board [Ad 7c 4h 7s 8s]
Seat 1: Dealer folded
Seat 2: Hero folded
Seat 3: Big Blind collected ($65.10)



PokerStars Hand #3957820821:  Hold'em No Limit ($2.50/$5) - 2020/06/08 14:51:11 ET
Table 'Zone Poker ID 1612' 9-max Seat #1 is the button
Seat 1: Hero ($483.82 in chips) 
Seat 2: Small Blind ($515.75 in chips) 
Seat 3: Big Blind ($1129.66 in chips) 
Small Blind: posts small blind $2.50
Big Blind: posts big blind $5
*** HOLE CARDS ***
Dealt to Hero [Ts 8s]
Hero: raises $7.50 to $12.50
Small Blind: raises $42.50 to $55
Big Blind: folds 
Hero: calls $42.50
*** FLOP *** [6d 4d Th]
Small Blind: bets $56.50
Hero: calls $56.50
*** TURN *** [6d 4d Th] [6s]
Small Blind: bets $123
Hero: calls $123
*** RIVER *** [6d 4d Th 6s] [6h]
Small Blind: bets $281.25 and is all-in
Hero: calls $249.32 and is all-in
*** SHOW DOWN ***
Small Blind: shows [4c 4h] (a hand...)
Big Blind: shows [8c Ad] (a hand...)
Hero: shows [Ts 8s] (a hand...)
Uncalled bet ($31.93) returned to Small Blind
Hero collected $970.64 from pot
*** SUMMARY ***
Total pot $972.64 | Rake $2.00
Board [6d 4d Th 6s 6h]
Seat 1: Hero showed [Ts 8s] and won ($970.64)
Seat 2: Small Blind showed [4c 4h] and lost with...
Seat 3: Big Blind folded



PokerStars Hand #3956357882:  Hold'em No Limit ($2.50/$5) - 2020/06/05 17:25:19 ET
Table 'Zone Poker ID 1612' 9-max Seat #5 is the button
Seat 1: Small Blind ($828.92 in chips) 
Seat 2: Hero ($496.30 in chips) 
Seat 3: UTG ($527.88 in chips) 
Seat 4: UTG+1 ($613.67 in chips) 
Seat 5: Dealer ($605.02 in chips) 
Small Blind: posts small blind $2.50
Hero: posts big blind $5
*** HOLE CARDS ***
Dealt to Hero [Th Ah]
UTG: raises $7 to $12
UTG+1: folds 
Dealer: folds 
Small Blind: folds 
Hero: raises $45.50 to $57.50
UTG: calls $45.50
*** FLOP *** [Qh 2d 5c]
Hero: bets $57.25
UTG: calls $57.25
*** TURN *** [Qh 2d 5c] [Ad]
Hero: checks 
UTG: checks 
*** RIVER *** [Qh 2d 5c Ad] [5s]
Hero: bets $114.50
UTG: raises $298.63 to $413.13 and is all-in
Hero: calls $267.05 and is all-in
*** SHOW DOWN ***
Small Blind: shows [Jh 4s] (a hand...)
Hero: shows [Th Ah] (a hand...)
Dealer: shows [Tc 5d] (a hand...)
UTG: shows [Qc Qs] (a hand...)
UTG+1: shows [Ks 5h] (a hand...)
Uncalled bet ($31.58) returned to UTG
UTG collected $992.10 from pot
*** SUMMARY ***
Total pot $995.10 | Rake $3.00
Board [Qh 2d 5c Ad 5s]
Seat 1: Small Blind folded
Seat 2: Hero showed [Th Ah] and lost with...
Seat 3: UTG showed [Qc Qs] and won ($992.10)
Seat 4: UTG+1 folded
Seat 5: Dealer folded



PokerStars Hand #3956356956:  Hold'em No Limit ($2.50/$5) - 2020/06/05 17:23:00 ET
Table 'Zone Poker ID 1612' 9-max Seat #1 is the button
Seat 1: Dealer ($856.42 in chips) 
Seat 2: Small Blind ($537.14 in chips) 
Seat 3: Big Blind ($232.50 in chips) 
Seat 4: UTG ($312.19 in chips) 
Seat 5: Hero ($561.39 in chips) 
Small Blind: posts small blind $2.50
Big Blind: posts big blind $5
*** HOLE CARDS ***
Dealt to Hero [5c 5h]
UTG: folds 
Hero: raises $7.50 to $12.50
Dealer: folds 
Small Blind: folds 
Big Blind: calls $7.50
*** FLOP *** [3d 9d 8s]
Big Blind: checks 
Hero: bets $7.84
Big Blind: calls $7.84
*** TURN *** [3d 9d 8s] [6s]
Big Blind: checks 
Hero: checks 
*** RIVER *** [3d 9d 8s 6s] [5s]
Big Blind: bets $15
Hero: calls $15
*** SHOW DOWN ***
Small Blind: shows [8d 3c] (a hand...)
Big Blind: shows [Jd Ks] (a hand...)
Hero: shows [5c 5h] (a hand...)
Dealer: shows [Kh 4c] (a hand...)
UTG: shows [Qd 8c] (a hand...)
Hero collected $70.18 from pot
*** SUMMARY ***
Total pot $73.18 | Rake $3.00
Board [3d 9d 8s 6s 5s]
Seat 1: Dealer folded
Seat 2: Small Blind folded
Seat 3: Big Blind showed [Jd Ks] and lost with...
Seat 4: UTG folded
Seat 5: Hero showed [5c 5h] and won ($70.18)



PokerStars Hand #3956354594:  Hold'em No Limit ($2.50/$5) - 2020/06/05 17:17:23 ET
Table 'Zone Poker ID 1612' 9-max Seat #1 is the button
Seat 1: Hero ($668.44 in chips) 
Seat 2: Small Blind ($1985.03 in chips) 
Seat 3: Big Blind ($809.20 in chips) 
Seat 4: UTG ($567.23 in chips) 
Seat 5: UTG+1 ($603.90 in chips) 
Small Blind: posts small blind $2.50
Big Blind: posts big blind $5
*** HOLE CARDS ***
Dealt to Hero [Ac 4s]
UTG: folds 
UTG+1: folds 
Hero: raises $7.50 to $12.50
Small Blind: folds 
Big Blind: calls $7.50
*** FLOP *** [3c 7h 7s]
Big Blind: checks 
Hero: checks 
*** TURN *** [3c 7h 7s] [4c]
Big Blind: checks 
Hero: bets $8.25
Big Blind: raises $31.97 to $40.22
Hero: calls $31.97
*** RIVER *** [3c 7h 7s 4c] [Jd]
Big Blind: bets $164.94
Hero: folds 
*** SHOW DOWN ***
Small Blind: shows [Ts 8d] (a hand...)
Big Blind: shows [8c 7d] (a hand...)
Hero: shows [Ac 4s] (a hand...)
UTG: shows [Ks 4d] (a hand...)
UTG+1: shows [9d 6h] (a hand...)
Uncalled bet ($164.94) returned to Big Blind
Big Blind collected $104.94 from pot
*** SUMMARY ***
Total pot $107.94 | Rake $3.00
Board [3c 7h 7s 4c Jd]
Seat 1: Hero folded
Seat 2: Small Blind folded
Seat 3: Big Blind collected ($104.94)
Seat 4: UTG folded
Seat 5: UTG+1 folded



PokerStars Hand #3956349138:  Hold'em No Limit ($2.50/$5) - 2020/06/05 17:04:17 ET
Table 'Zone Poker ID 1612' 9-max Seat #2 is the button
Seat 1: Hero ($500.00 in chips) 
Seat 2: Dealer ($1350.30 in chips) 
Seat 3: Small Blind ($1082.50 in chips) 
Small Blind: posts small blind $2.50
Hero: posts big blind $5
*** HOLE CARDS ***
Dealt to Hero [Qd Ts]
Dealer: raises $7 to $12
Small Blind: folds 
Hero: calls $7
*** FLOP *** [Tc Th 4d]
Hero: checks 
Dealer: bets $5
Hero: raises $17.59 to $22.59
Dealer: calls $17.59
*** TURN *** [Tc Th 4d] [5h]
Hero: bets $45.26
Dealer: calls $45.26
*** RIVER *** [Tc Th 4d 5h] [5d]
Hero: bets $80.10
Dealer: raises $119.90 to $200
Hero: calls $119.90
*** SHOW DOWN ***
Small Blind: shows [6s Js] (a hand...)
Dealer: shows [Td Kh] (a hand...)
Hero: shows [Qd Ts] (a hand...)
Hero collected $280.10 from pot
Dealer collected $280.10 from pot
*** SUMMARY ***
Total pot $562.20 | Rake $2.00
Board [Tc Th 4d 5h 5d]
Seat 1: Hero showed [Qd Ts] and won ($280.10)
Seat 2: Dealer showed [Td Kh] and won ($280.10)
Seat 3: Small Blind folded



PokerStars Hand #3956347232:  Hold'em No Limit ($2.50/$5) - 2020/06/05 16:59:52 ET
Table 'Zone Poker ID 1612' 9-max Seat #3 is the button
Seat 1: Small Blind ($464.56 in chips) 
Seat 2: Hero ($474.53 in chips) 
Seat 3: Dealer ($265.50 in chips) 
Small Blind: posts small blind $2.50
Hero: posts big blind $5
*** HOLE CARDS ***
Dealt to Hero [9h Ac]
Dealer: folds 
Small Blind: raises $5.00 to $10
Hero: calls $5
*** FLOP *** [4h Qc 3d]
Small Blind: checks 
Hero: checks 
*** TURN *** [4h Qc 3d] [3h]
Small Blind: checks 
Hero: checks 
*** RIVER *** [4h Qc 3d 3h] [Ks]
Small Blind: bets $9.50
Hero: calls $9.50
*** SHOW DOWN ***
Small Blind: shows [Qd Kc] (a hand...)
Dealer: shows [6h 2d] (a hand...)
Hero: shows [9h Ac] (a hand...)
Small Blind collected $37.05 from pot
*** SUMMARY ***
Total pot $39.00 | Rake $1.95
Board [4h Qc 3d 3h Ks]
Seat 1: Small Blind showed [Qd Kc] and won ($37.05)
Seat 2: Hero showed [9h Ac] and lost with...
Seat 3: Dealer folded



PokerStars Hand #3956346999:  Hold'em No Limit ($2.50/$5) - 2020/06/05 16:59:18 ET
Table 'Zone Poker ID 1612' 9-max Seat #2 is the button
Seat 1: Big Blind ($589.64 in chips) 
Seat 2: Hero ($497.03 in chips) 
Seat 3: Small Blind ($240.00 in chips) 
Small Blind: posts small blind $2.50
Big Blind: posts big blind $5
*** HOLE CARDS ***
Dealt to Hero [6c Ah]
Hero: raises $7.50 to $12.50
Small Blind: calls $10
Big Blind: folds 
*** FLOP *** [8d 7d 6h]
Small Blind: checks 
Hero: checks 
*** TURN *** [8d 7d 6h] [5c]
Small Blind: bets $5
Hero: calls $5
*** RIVER *** [8d 7d 6h 5c] [Td]
Small Blind: bets $5
Hero: calls $5
*** SHOW DOWN ***
Small Blind: shows [7h 4h] (a hand...)
Big Blind: shows [6s Jc] (a hand...)
Hero: shows [6c Ah] (a hand...)
Small Blind collected $48 from pot
*** SUMMARY ***
Total pot $50.00 | Rake $2.00
Board [8d 7d 6h 5c Td]
Seat 1: Big Blind folded
Seat 2: Hero showed [6c Ah] and lost with...
Seat 3: Small Blind showed [7h 4h] and won ($48)



PokerStars Hand #3956345935:  Hold'em No Limit ($2.50/$5) - 2020/06/05 16:56:44 ET
Table 'Zone Poker ID 1612' 9-max Seat #3 is the button
Seat 1: Small Blind ($1865.91 in chips) 
Seat 2: Big Blind ($651.15 in chips) 
Seat 3: Hero ($637.57 in chips) 
Small Blind: posts small blind $2.50
Big Blind: posts big blind $5
*** HOLE CARDS ***
Dealt to Hero [Ad 6c]
Hero: raises $7.50 to $12.50
Small Blind: calls $10
Big Blind: folds 
*** FLOP *** [6s Kh As]
Small Blind: checks 
Hero: bets $10
Small Blind: calls $10
*** TURN *** [6s Kh As] [4s]
Small Blind: bets $5
Hero: raises $29 to $34
Small Blind: raises $29 to $63
Hero: calls $29
*** RIVER *** [6s Kh As 4s] [Jc]
Small Blind: bets $174
Hero: folds 
*** SHOW DOWN ***
Small Blind: shows [Th Qh] (a hand...)
Big Blind: shows [7c 9s] (a hand...)
Hero: shows [Ad 6c] (a hand...)
Uncalled bet ($174.00) returned to Small Blind
Small Blind collected $174 from pot
*** SUMMARY ***
Total pot $176.00 | Rake $2.00
Board [6s Kh As 4s Jc]
Seat 1: Small Blind collected ($174)
Seat 2: Big Blind folded
Seat 3: Hero folded



PokerStars Hand #3956343862:  Hold'em No Limit ($2.50/$5) - 2020/06/05 16:51:50 ET
Table 'Zone Poker ID 1612' 9-max Seat #3 is the button
Seat 1: Small Blind ($1125.46 in chips) 
Seat 2: Big Blind ($652.15 in chips) 
Seat 3: Hero ($565.50 in chips) 
Small Blind: posts small blind $2.50
Big Blind: posts big blind $5
*** HOLE CARDS ***
Dealt to Hero [Th Kd]
Hero: raises $7.50 to $12.50
Small Blind: calls $10
Big Blind: folds 
*** FLOP *** [Ah Qc 5d]
Small Blind: checks 
Hero: bets $8.55
Small Blind: calls $8.55
*** TURN *** [Ah Qc 5d] [2c]
Small Blind: checks 
Hero: checks 
*** RIVER *** [Ah Qc 5d 2c] [2h]
Small Blind: bets $60
Hero: folds 
*** SHOW DOWN ***
Small Blind: shows [Tc Ac] (a hand...)
Big Blind: shows [4d 3h] (a hand...)
Hero: shows [Th Kd] (a hand...)
Uncalled bet ($60.00) returned to Small Blind
Small Blind collected $45.10 from pot
*** SUMMARY ***
Total pot $47.10 | Rake $2.00
Board [Ah Qc 5d 2c 2h]
Seat 1: Small Blind collected ($45.10)
Seat 2: Big Blind folded
Seat 3: Hero folded



PokerStars Hand #3956342502:  Hold'em No Limit ($2.50/$5) - 2020/06/05 16:48:31 ET
Table 'Zone Poker ID 1612' 9-max Seat #2 is the button
Seat 1: UTG ($580.46 in chips) 
Seat 2: Hero ($490.00 in chips) 
Seat 3: Small Blind ($222.50 in chips) 
Seat 4: Big Blind ($501.32 in chips) 
Small Blind: posts small blind $2.50
Big Blind: posts big blind $5
*** HOLE CARDS ***
Dealt to Hero [Ah Js]
UTG: folds 
Hero: raises $7.50 to $12.50
Small Blind: folds 
Big Blind: calls $7.50
*** FLOP *** [3h Qc Ac]
Big Blind: checks 
Hero: bets $7.84
Big Blind: calls $7.84
*** TURN *** [3h Qc Ac] [Kc]
Big Blind: checks 
Hero: checks 
*** RIVER *** [3h Qc Ac Kc] [Jd]
Big Blind: bets $20.52
Hero: calls $20.52
*** SHOW DOWN ***
Small Blind: shows [5d Qs] (a hand...)
UTG: shows [8s 5s] (a hand...)
Big Blind: shows [Ad Th] (a hand...)
Hero: shows [Ah Js] (a hand...)
Big Blind collected $81.22 from pot
*** SUMMARY ***
Total pot $84.22 | Rake $3.00
Board [3h Qc Ac Kc Jd]
Seat 1: UTG folded
Seat 2: Hero showed [Ah Js] and lost with...
Seat 3: Small Blind folded
Seat 4: Big Blind showed [Ad Th] and won ($81.22)



PokerStars Hand #3956342376:  Hold'em No Limit ($2.50/$5) - 2020/06/05 16:48:16 ET
Table 'Zone Poker ID 1612' 9-max Seat #2 is the button
Seat 1: UTG ($495.00 in chips) 
Seat 2: Hero ($570.00 in chips) 
Seat 3: Small Blind ($883.54 in chips) 
Seat 4: Big Blind ($227.50 in chips) 
Small Blind: posts small blind $2.50
Big Blind: posts big blind $5
*** HOLE CARDS ***
Dealt to Hero [8s 8c]
UTG: raises $5 to $10
Hero: raises $30 to $40
Small Blind: folds 
Big Blind: folds 
UTG: calls $30
*** FLOP *** [2h 6h 2d]
UTG: checks 
Hero: bets $42.25
UTG: calls $42.25
*** TURN *** [2h 6h 2d] [Td]
UTG: checks 
Hero: checks 
*** RIVER *** [2h 6h 2d Td] [3s]
UTG: bets $412.75 and is all-in
Hero: folds 
*** SHOW DOWN ***
Small Blind: shows [7h 9c] (a hand...)
UTG: shows [Th Jh] (a hand...)
Big Blind: shows [6d 7c] (a hand...)
Hero: shows [8s 8c] (a hand...)
Uncalled bet ($412.75) returned to UTG
UTG collected $169 from pot
*** SUMMARY ***
Total pot $172.00 | Rake $3.00
Board [2h 6h 2d Td 3s]
Seat 1: UTG collected ($169)
Seat 2: Hero folded
Seat 3: Small Blind folded
Seat 4: Big Blind folded



PokerStars Hand #3956247530:  Hold'em No Limit ($2.50/$5) - 2020/06/05 12:09:09 ET
Table 'Zone Poker ID 1612' 9-max Seat #3 is the button
Seat 1: Small Blind ($1084.50 in chips) 
Seat 2: Big Blind ($1237.62 in chips) 
Seat 3: Hero ($993.00 in chips) 
Small Blind: posts small blind $2.50
Big Blind: posts big blind $5
*** HOLE CARDS ***
Dealt to Hero [5h 8h]
Hero: raises $7.50 to $12.50
Small Blind: folds 
Big Blind: calls $7.50
*** FLOP *** [3h 5s 3s]
Big Blind: checks 
Hero: bets $7.84
Big Blind: raises $19.16 to $27
Hero: calls $19.16
*** TURN *** [3h 5s 3s] [2d]
Big Blind: bets $120
Hero: calls $120
*** RIVER *** [3h 5s 3s 2d] [6d]
Big Blind: bets $319.50
Hero: folds 
*** SHOW DOWN ***
Small Blind: shows [Qd 8d] (a hand...)
Big Blind: shows [2h 2s] (a hand...)
Hero: shows [5h 8h] (a hand...)
Uncalled bet ($319.50) returned to Big Blind
Big Blind collected $319.50 from pot
*** SUMMARY ***
Total pot $321.50 | Rake $2.00
Board [3h 5s 3s 2d 6d]
Seat 1: Small Blind folded
Seat 2: Big Blind collected ($319.50)
Seat 3: Hero folded



PokerStars Hand #3956247210:  Hold'em No Limit ($2.50/$5) - 2020/06/05 12:07:53 ET
Table 'Zone Poker ID 1612' 9-max Seat #3 is the button
Seat 1: Small Blind ($1232.62 in chips) 
Seat 2: Hero ($756.92 in chips) 
Seat 3: Dealer ($1190.45 in chips) 
Small Blind: posts small blind $2.50
Hero: posts big blind $5
*** HOLE CARDS ***
Dealt to Hero [Ah Js]
Dealer: raises $7.50 to $12.50
Small Blind: folds 
Hero: calls $7.50
*** FLOP *** [8s 7c 6d]
Hero: checks 
Dealer: bets $8.07
Hero: calls $8.07
*** TURN *** [8s 7c 6d] [Td]
Hero: checks 
Dealer: bets $15.82
Hero: raises $36.64 to $52.46
Dealer: calls $36.64
*** RIVER *** [8s 7c 6d Td] [2c]
Hero: bets $109.92
Dealer: raises $1007.50 to $1117.42 and is all-in
Hero: folds 
*** SHOW DOWN ***
Small Blind: shows [7h 3c] (a hand...)
Dealer: shows [9h Jc] (a hand...)
Hero: shows [Ah Js] (a hand...)
Uncalled bet ($1007.50) returned to Dealer
Dealer collected $366.40 from pot
*** SUMMARY ***
Total pot $368.40 | Rake $2.00
Board [8s 7c 6d Td 2c]
Seat 1: Small Blind folded
Seat 2: Hero folded
Seat 3: Dealer collected ($366.40)



PokerStars Hand #3956246860:  Hold'em No Limit ($2.50/$5) - 2020/06/05 12:06:35 ET
Table 'Zone Poker ID 1612' 9-max Seat #2 is the button
Seat 1: Big Blind ($529.50 in chips) 
Seat 2: Dealer ($1264.14 in chips) 
Seat 3: Hero ($500.00 in chips) 
Hero: posts small blind $2.50
Big Blind: posts big blind $5
*** HOLE CARDS ***
Dealt to Hero [Qd Qs]
Dealer: folds 
Hero: raises $10.00 to $15
Big Blind: raises $30 to $45
Hero: raises $75.00 to $120
Big Blind: calls $75
*** FLOP *** [4s 4h Ad]
Hero: checks 
Big Blind: checks 
*** TURN *** [4s 4h Ad] [5d]
Hero: checks 
Big Blind: bets $100
Hero: calls $100
*** RIVER *** [4s 4h Ad 5d] [Qh]
Hero: checks 
Big Blind: bets $309.50 and is all-in
Hero: calls $280 and is all-in
*** SHOW DOWN ***
Dealer: shows [8d 2d] (a hand...)
Big Blind: shows [As 5s] (a hand...)
Hero: shows [Qd Qs] (a hand...)
Uncalled bet ($29.50) returned to Big Blind
Hero collected $998 from pot
*** SUMMARY ***
Total pot $1000.00 | Rake $2.00
Board [4s 4h Ad 5d Qh]
Seat 1: Big Blind showed [As 5s] and lost with...
Seat 2: Dealer folded
Seat 3: Hero showed [Qd Qs] and won ($998)



PokerStars Hand #3956246482:  Hold'em No Limit ($2.50/$5) - 2020/06/05 12:05:12 ET
Table 'Zone Poker ID 1612' 9-max Seat #2 is the button
Seat 1: Big Blind ($482.75 in chips) 
Seat 2: Dealer ($930.72 in chips) 
Seat 3: Hero ($519.60 in chips) 
Hero: posts small blind $2.50
Big Blind: posts big blind $5
*** HOLE CARDS ***
Dealt to Hero [Qd Kd]
Dealer: folds 
Hero: raises $10.00 to $15
Big Blind: calls $10
*** FLOP *** [Ac 8c 5d]
Hero: checks 
Big Blind: checks 
*** TURN *** [Ac 8c 5d] [Ts]
Hero: checks 
Big Blind: bets $20
Hero: calls $20
*** RIVER *** [Ac 8c 5d Ts] [5s]
Hero: checks 
Big Blind: bets $40
Hero: calls $40
*** SHOW DOWN ***
Dealer: shows [Kc 6d] (a hand...)
Big Blind: shows [2d Ah] (a hand...)
Hero: shows [Qd Kd] (a hand...)
Big Blind collected $148 from pot
*** SUMMARY ***
Total pot $150.00 | Rake $2.00
Board [Ac 8c 5d Ts 5s]
Seat 1: Big Blind showed [2d Ah] and won ($148)
Seat 2: Dealer folded
Seat 3: Hero showed [Qd Kd] and lost with...



PokerStars Hand #3956244656:  Hold'em No Limit ($2.50/$5) - 2020/06/05 11:58:21 ET
Table 'Zone Poker ID 1612' 9-max Seat #1 is the button
Seat 1: Dealer ($1034.09 in chips) 
Seat 2: Small Blind ($495.00 in chips) 
Seat 3: Hero ($513.83 in chips) 
Seat 4: UTG ($581.16 in chips) 
Small Blind: posts small blind $2.50
Hero: posts big blind $5
*** HOLE CARDS ***
Dealt to Hero [Td Ks]
UTG: raises $7.50 to $12.50
Dealer: calls $12.50
Small Blind: folds 
Hero: calls $7.50
*** FLOP *** [4h 8c 2s]
Hero: checks 
UTG: checks 
Dealer: checks 
*** TURN *** [4h 8c 2s] [Kc]
Hero: checks 
UTG: bets $19
Dealer: calls $19
Hero: calls $19
*** RIVER *** [4h 8c 2s Kc] [7c]
Hero: checks 
UTG: bets $70.50
Dealer: calls $70.50
Hero: folds 
*** SHOW DOWN ***
Small Blind: shows [8s 3d] (a hand...)
UTG: shows [Qc 9c] (a hand...)
Dealer: shows [As Ac] (a hand...)
Hero: shows [Td Ks] (a hand...)
UTG collected $235 from pot
*** SUMMARY ***
Total pot $238.00 | Rake $3.00
Board [4h 8c 2s Kc 7c]
Seat 1: Dealer showed [As Ac] and lost with...
Seat 2: Small Blind folded
Seat 3: Hero folded
Seat 4: UTG showed [Qc 9c] and won ($235)



PokerStars Hand #3956242557:  Hold'em No Limit ($2.50/$5) - 2020/06/05 11:50:31 ET
Table 'Zone Poker ID 1612' 9-max Seat #1 is the button
Seat 1: Dealer ($363.25 in chips) 
Seat 2: Small Blind ($586.47 in chips) 
Seat 3: Big Blind ($607.00 in chips) 
Seat 4: Hero ($475.00 in chips) 
Small Blind: posts small blind $2.50
Big Blind: posts big blind $5
*** HOLE CARDS ***
Dealt to Hero [Td Jc]
Hero: raises $7.50 to $12.50
Dealer: calls $12.50
Small Blind: folds 
Big Blind: calls $7.50
*** FLOP *** [5c Ts 8d]
Big Blind: checks 
Hero: checks 
Dealer: checks 
*** TURN *** [5c Ts 8d] [9c]
Big Blind: checks 
Hero: bets $28.50
Dealer: calls $28.50
Big Blind: folds 
*** RIVER *** [5c Ts 8d 9c] [9s]
Hero: checks 
Dealer: bets $161.86
Hero: folds 
*** SHOW DOWN ***
Small Blind: shows [2d 8c] (a hand...)
Dealer: shows [Ad 9h] (a hand...)
Big Blind: shows [Js Tc] (a hand...)
Hero: shows [Td Jc] (a hand...)
Uncalled bet ($161.86) returned to Dealer
Dealer collected $94 from pot
*** SUMMARY ***
Total pot $97.00 | Rake $3.00
Board [5c Ts 8d 9c 9s]
Seat 1: Dealer collected ($94)
Seat 2: Small Blind folded
Seat 3: Big Blind folded
Seat 4: Hero folded



PokerStars Hand #3956238165:  Hold'em No Limit ($2.50/$5) - 2020/06/05 11:33:18 ET
Table 'Zone Poker ID 1612' 9-max Seat #1 is the button
Seat 1: Dealer ($527.00 in chips) 
Seat 2: Small Blind ($518.00 in chips) 
Seat 3: Hero ($1184.77 in chips) 
Small Blind: posts small blind $2.50
Hero: posts big blind $5
*** HOLE CARDS ***
Dealt to Hero [9c 6c]
Dealer: raises $10 to $15
Small Blind: folds 
Hero: calls $10
*** FLOP *** [3h Jc Kc]
Hero: checks 
Dealer: checks 
*** TURN *** [3h Jc Kc] [Ts]
Hero: bets $20
Dealer: calls $20
*** RIVER *** [3h Jc Kc Ts] [Ah]
Hero: checks 
Dealer: bets $55
Hero: folds 
*** SHOW DOWN ***
Small Blind: shows [4s 7d] (a hand...)
Dealer: shows [Qs Js] (a hand...)
Hero: shows [9c 6c] (a hand...)
Uncalled bet ($55) returned to Dealer
Dealer collected $70.50 from pot
*** SUMMARY ***
Total pot $72.50 | Rake $2.00
Board [3h Jc Kc Ts Ah]
Seat 1: Dealer collected ($70.50)
Seat 2: Small Blind folded
Seat 3: Hero folded



PokerStars Hand #3956237392:  Hold'em No Limit ($2.50/$5) - 2020/06/05 11:30:20 ET
Table 'Zone Poker ID 1612' 9-max Seat #2 is the button
Seat 1: Hero ($554.23 in chips) 
Seat 2: Dealer ($613.15 in chips) 
Seat 3: Small Blind ($478.00 in chips) 
Small Blind: posts small blind $2.50
Hero: posts big blind $5
*** HOLE CARDS ***
Dealt to Hero [7d Kd]
Dealer: raises $7.50 to $12.50
Small Blind: folds 
Hero: calls $7.50
*** FLOP *** [Tc 7s 3d]
Hero: checks 
Dealer: bets $8.07
Hero: calls $8.07
*** TURN *** [Tc 7s 3d] [6s]
Hero: checks 
Dealer: checks 
*** RIVER *** [Tc 7s 3d 6s] [Ac]
Hero: checks 
Dealer: bets $20.82
Hero: calls $20.82
*** SHOW DOWN ***
Small Blind: shows [8d 4c] (a hand...)
Dealer: shows [9c Ah] (a hand...)
Hero: shows [7d Kd] (a hand...)
Dealer collected $83.28 from pot
*** SUMMARY ***
Total pot $85.28 | Rake $2.00
Board [Tc 7s 3d 6s Ac]
Seat 1: Hero showed [7d Kd] and lost with...
Seat 2: Dealer showed [9c Ah] and won ($83.28)
Seat 3: Small Blind folded



PokerStars Hand #3956234011:  Hold'em No Limit ($2.50/$5) - 2020/06/05 11:17:17 ET
Table 'Zone Poker ID 1612' 9-max Seat #1 is the button
Seat 1: Dealer ($565.13 in chips) 
Seat 2: Hero ($555.98 in chips) 
Seat 3: Big Blind ($278.80 in chips) 
Hero: posts small blind $2.50
Big Blind: posts big blind $5
*** HOLE CARDS ***
Dealt to Hero [Qs 9s]
Dealer: raises $7.50 to $12.50
Hero: raises $42.50 to $55
Big Blind: calls $50
Dealer: folds 
*** FLOP *** [7c 6h 3c]
Hero: checks 
Big Blind: bets $5
Hero: calls $5
*** TURN *** [7c 6h 3c] [9c]
Hero: checks 
Big Blind: bets $10.62
Hero: calls $10.62
*** RIVER *** [7c 6h 3c 9c] [As]
Hero: checks 
Big Blind: bets $15
Hero: calls $15
*** SHOW DOWN ***
Dealer: shows [2h Ad] (a hand...)
Big Blind: shows [9d 5h] (a hand...)
Hero: shows [Qs 9s] (a hand...)
Hero collected $181.74 from pot
*** SUMMARY ***
Total pot $183.74 | Rake $2.00
Board [7c 6h 3c 9c As]
Seat 1: Dealer folded
Seat 2: Hero showed [Qs 9s] and won ($181.74)
Seat 3: Big Blind showed [9d 5h] and lost with...



PokerStars Hand #3956233715:  Hold'em No Limit ($2.50/$5) - 2020/06/05 11:16:08 ET
Table 'Zone Poker ID 1612' 9-max Seat #2 is the button
Seat 1: Hero ($485.00 in chips) 
Seat 2: Dealer ($393.80 in chips) 
Seat 3: Small Blind ($500.00 in chips) 
Small Blind: posts small blind $2.50
Hero: posts big blind $5
*** HOLE CARDS ***
Dealt to Hero [Ac Jc]
Dealer: calls $5
Small Blind: folds 
Hero: raises $20 to $25
Dealer: calls $20
*** FLOP *** [Ks Ad 5c]
Hero: bets $15
Dealer: raises $20 to $35
Hero: calls $20
*** TURN *** [Ks Ad 5c] [7d]
Hero: checks 
Dealer: bets $30
Hero: calls $30
*** RIVER *** [Ks Ad 5c 7d] [2h]
Hero: checks 
Dealer: bets $25
Hero: calls $25
*** SHOW DOWN ***
Small Blind: shows [Kh 2c] (a hand...)
Dealer: shows [4h Qd] (a hand...)
Hero: shows [Ac Jc] (a hand...)
Hero collected $230.50 from pot
*** SUMMARY ***
Total pot $232.50 | Rake $2.00
Board [Ks Ad 5c 7d 2h]
Seat 1: Hero showed [Ac Jc] and won ($230.50)
Seat 2: Dealer showed [4h Qd] and lost with...
Seat 3: Small Blind folded



PokerStars Hand #3956233157:  Hold'em No Limit ($2.50/$5) - 2020/06/05 11:14:03 ET
Table 'Zone Poker ID 1612' 9-max Seat #3 is the button
Seat 1: Hero ($794.20 in chips) 
Seat 2: Big Blind ($822.19 in chips) 
Seat 3: Dealer ($536.06 in chips) 
Hero: posts small blind $2.50
Big Blind: posts big blind $5
*** HOLE CARDS ***
Dealt to Hero [Ac Jc]
Dealer: raises $5 to $10
Hero: raises $35.00 to $45
Big Blind: folds 
Dealer: calls $35
*** FLOP *** [Js Tc Jd]
Hero: bets $27.90
Dealer: calls $27.90
*** TURN *** [Js Tc Jd] [7h]
Hero: checks 
Dealer: checks 
*** RIVER *** [Js Tc Jd 7h] [Qh]
Hero: bets $111.60
Dealer: raises $111.60 to $223.20
Hero: calls $111.60
*** SHOW DOWN ***
Dealer: shows [Td Jh] (a hand...)
Big Blind: shows [3h 6s] (a hand...)
Hero: shows [Ac Jc] (a hand...)
Dealer collected $595.20 from pot
*** SUMMARY ***
Total pot $597.20 | Rake $2.00
Board [Js Tc Jd 7h Qh]
Seat 1: Hero showed [Ac Jc] and lost with...
Seat 2: Big Blind folded
Seat 3: Dealer showed [Td Jh] and won ($595.20)



PokerStars Hand #3956231609:  Hold'em No Limit ($2.50/$5) - 2020/06/05 11:07:42 ET
Table 'Zone Poker ID 1612' 9-max Seat #2 is the button
Seat 1: Big Blind ($561.50 in chips) 
Seat 2: Dealer ($224.32 in chips) 
Seat 3: Hero ($543.05 in chips) 
Hero: posts small blind $2.50
Big Blind: posts big blind $5
*** HOLE CARDS ***
Dealt to Hero [Ah Ts]
Dealer: folds 
Hero: raises $10.00 to $15
Big Blind: raises $25 to $40
Hero: calls $25
*** FLOP *** [Td 4c 5s]
Hero: checks 
Big Blind: bets $44
Hero: calls $44
*** TURN *** [Td 4c 5s] [Ks]
Hero: checks 
Big Blind: bets $109
Hero: calls $109
*** RIVER *** [Td 4c 5s Ks] [9c]
Hero: checks 
Big Blind: bets $177
Hero: folds 
*** SHOW DOWN ***
Dealer: shows [2d 3c] (a hand...)
Big Blind: shows [7d Ad] (a hand...)
Hero: shows [Ah Ts] (a hand...)
Uncalled bet ($177.00) returned to Big Blind
Big Blind collected $384 from pot
*** SUMMARY ***
Total pot $386.00 | Rake $2.00
Board [Td 4c 5s Ks 9c]
Seat 1: Big Blind collected ($384)
Seat 2: Dealer folded
Seat 3: Hero folded



PokerStars Hand #3955906271:  Hold'em No Limit ($2.50/$5) - 2020/06/04 19:30:31 ET
Table 'Zone Poker ID 1612' 9-max Seat #1 is the button
Seat 1: Dealer ($481.50 in chips) 
Seat 2: Small Blind ($1582.01 in chips) 
Seat 3: Hero ($510.50 in chips) 
Small Blind: posts small blind $2.50
Hero: posts big blind $5
*** HOLE CARDS ***
Dealt to Hero [9c Qh]
Dealer: folds 
Small Blind: raises $7.50 to $12.50
Hero: calls $7.50
*** FLOP *** [5h Tc 3d]
Small Blind: checks 
Hero: checks 
*** TURN *** [5h Tc 3d] [Ks]
Small Blind: bets $11.88
Hero: calls $11.88
*** RIVER *** [5h Tc 3d Ks] [Td]
Small Blind: bets $23.38
Hero: calls $23.38
*** SHOW DOWN ***
Small Blind: shows [Kh 7h] (a hand...)
Dealer: shows [Qs 3h] (a hand...)
Hero: shows [9c Qh] (a hand...)
Small Blind collected $93.52 from pot
*** SUMMARY ***
Total pot $95.52 | Rake $2.00
Board [5h Tc 3d Ks Td]
Seat 1: Dealer folded
Seat 2: Small Blind showed [Kh 7h] and won ($93.52)
Seat 3: Hero showed [9c Qh] and lost with...



PokerStars Hand #3955905673:  Hold'em No Limit ($2.50/$5) - 2020/06/04 19:29:10 ET
Table 'Zone Poker ID 1612' 9-max Seat #1 is the button
Seat 1: Dealer ($543.00 in chips) 
Seat 2: Hero ($475.62 in chips) 
Seat 3: Big Blind ($1966.55 in chips) 
Hero: posts small blind $2.50
Big Blind: posts big blind $5
*** HOLE CARDS ***
Dealt to Hero [Jd As]
Dealer: folds 
Hero: raises $10.00 to $15
Big Blind: raises $30 to $45
Hero: calls $30
*** FLOP *** [2s Qc Ah]
Hero: checks 
Big Blind: bets $29.04
Hero: calls $29.04
*** TURN *** [2s Qc Ah] [Td]
Hero: checks 
Big Blind: bets $75.54
Hero: calls $75.54
*** RIVER *** [2s Qc Ah Td] [8d]
Hero: checks 
Big Blind: bets $1816.97 and is all-in
Hero: folds 
*** SHOW DOWN ***
Dealer: shows [2d 5s] (a hand...)
Big Blind: shows [Kd 6h] (a hand...)
Hero: shows [Jd As] (a hand...)
Uncalled bet ($1816.97) returned to Big Blind
Big Blind collected $297.16 from pot
*** SUMMARY ***
Total pot $299.16 | Rake $2.00
Board [2s Qc Ah Td 8d]
Seat 1: Dealer folded
Seat 2: Hero folded
Seat 3: Big Blind collected ($297.16)



PokerStars Hand #3955903439:  Hold'em No Limit ($2.50/$5) - 2020/06/04 19:24:10 ET
Table 'Zone Poker ID 1612' 9-max Seat #2 is the button
Seat 1: Hero ($477.00 in chips) 
Seat 2: Dealer ($492.50 in chips) 
Seat 3: Small Blind ($466.00 in chips) 
Small Blind: posts small blind $2.50
Hero: posts big blind $5
*** HOLE CARDS ***
Dealt to Hero [5c 7h]
Dealer: raises $5 to $10
Small Blind: folds 
Hero: calls $5
*** FLOP *** [Th Ah 5h]
Hero: checks 
Dealer: checks 
*** TURN *** [Th Ah 5h] [Qh]
Hero: checks 
Dealer: bets $7.50
Hero: calls $7.50
*** RIVER *** [Th Ah 5h Qh] [8c]
Hero: checks 
Dealer: bets $56
Hero: folds 
*** SHOW DOWN ***
Small Blind: shows [Qs Tc] (a hand...)
Dealer: shows [2s Js] (a hand...)
Hero: shows [5c 7h] (a hand...)
Uncalled bet ($56.00) returned to Dealer
Dealer collected $35.63 from pot
*** SUMMARY ***
Total pot $37.50 | Rake $1.87
Board [Th Ah 5h Qh 8c]
Seat 1: Hero folded
Seat 2: Dealer collected ($35.63)
Seat 3: Small Blind folded



PokerStars Hand #3955902713:  Hold'em No Limit ($2.50/$5) - 2020/06/04 19:22:35 ET
Table 'Zone Poker ID 1612' 9-max Seat #1 is the button
Seat 1: Hero ($493.50 in chips) 
Seat 2: Small Blind ($493.50 in chips) 
Seat 3: Big Blind ($1390.16 in chips) 
Small Blind: posts small blind $2.50
Big Blind: posts big blind $5
*** HOLE CARDS ***
Dealt to Hero [Ks Ah]
Hero: raises $7.50 to $12.50
Small Blind: folds 
Big Blind: calls $7.50
*** FLOP *** [9c 7h 8h]
Big Blind: checks 
Hero: checks 
*** TURN *** [9c 7h 8h] [5s]
Big Blind: bets $9
Hero: calls $9
*** RIVER *** [9c 7h 8h 5s] [3d]
Big Blind: bets $43.50
Hero: folds 
*** SHOW DOWN ***
Small Blind: shows [6h Ad] (a hand...)
Big Blind: shows [As 6c] (a hand...)
Hero: shows [Ks Ah] (a hand...)
Uncalled bet ($43.50) returned to Big Blind
Big Blind collected $43.50 from pot
*** SUMMARY ***
Total pot $45.50 | Rake $2.00
Board [9c 7h 8h 5s 3d]
Seat 1: Hero folded
Seat 2: Small Blind folded
Seat 3: Big Blind collected ($43.50)



PokerStars Hand #3955901374:  Hold'em No Limit ($2.50/$5) - 2020/06/04 19:19:35 ET
Table 'Zone Poker ID 1612' 9-max Seat #1 is the button
Seat 1: Dealer ($1413.02 in chips) 
Seat 2: Small Blind ($500.00 in chips) 
Seat 3: Hero ($557.63 in chips) 
Small Blind: posts small blind $2.50
Hero: posts big blind $5
*** HOLE CARDS ***
Dealt to Hero [7h 5s]
Dealer: raises $6 to $11
Small Blind: folds 
Hero: calls $6
*** FLOP *** [7s 3c Jc]
Hero: checks 
Dealer: bets $7.68
Hero: calls $7.68
*** TURN *** [7s 3c Jc] [Qd]
Hero: checks 
Dealer: checks 
*** RIVER *** [7s 3c Jc Qd] [2d]
Hero: checks 
Dealer: bets $18.94
Hero: folds 
*** SHOW DOWN ***
Small Blind: shows [3d Ks] (a hand...)
Dealer: shows [Js 6s] (a hand...)
Hero: shows [7h 5s] (a hand...)
Uncalled bet ($18.94) returned to Dealer
Dealer collected $37.87 from pot
*** SUMMARY ***
Total pot $39.86 | Rake $1.99
Board [7s 3c Jc Qd 2d]
Seat 1: Dealer collected ($37.87)
Seat 2: Small Blind folded
Seat 3: Hero folded



PokerStars Hand #3955900557:  Hold'em No Limit ($2.50/$5) - 2020/06/04 19:17:41 ET
Table 'Zone Poker ID 1612' 9-max Seat #3 is the button
Seat 1: Small Blind ($1284.64 in chips) 
Seat 2: Hero ($548.63 in chips) 
Seat 3: Dealer ($533.87 in chips) 
Small Blind: posts small blind $2.50
Hero: posts big blind $5
*** HOLE CARDS ***
Dealt to Hero [Th Kc]
Dealer: folds 
Small Blind: raises $7.50 to $12.50
Hero: calls $7.50
*** FLOP *** [Tc 4d 3s]
Small Blind: checks 
Hero: bets $18
Small Blind: raises $29.88 to $47.88
Hero: calls $29.88
*** TURN *** [Tc 4d 3s] [Js]
Small Blind: checks 
Hero: checks 
*** RIVER *** [Tc 4d 3s Js] [Ad]
Small Blind: bets $75
Hero: calls $75
*** SHOW DOWN ***
Small Blind: shows [8d As] (a hand...)
Dealer: shows [9d 6h] (a hand...)
Hero: shows [Th Kc] (a hand...)
Small Blind collected $268.76 from pot
*** SUMMARY ***
Total pot $270.76 | Rake $2.00
Board [Tc 4d 3s Js Ad]
Seat 1: Small Blind showed [8d As] and won ($268.76)
Seat 2: Hero showed [Th Kc] and lost with...
Seat 3: Dealer folded



PokerStars Hand #3955780729:  Hold'em No Limit ($2.50/$5) - 2020/06/04 14:16:48 ET
Table 'Zone Poker ID 1612' 9-max Seat #2 is the button
Seat 1: Big Blind ($507.50 in chips) 
Seat 2: Hero ($978.12 in chips) 
Seat 3: Small Blind ($564.40 in chips) 
Small Blind: posts small blind $2.50
Big Blind: posts big blind $5
*** HOLE CARDS ***
Dealt to Hero [Tc 9s]
Hero: raises $7.50 to $12.50
Small Blind: calls $10
Big Blind: calls $7.50
*** FLOP *** [6s 3c 9h]
Small Blind: checks 
Big Blind: checks 
Hero: checks 
*** TURN *** [6s 3c 9h] [3s]
Small Blind: checks 
Big Blind: bets $35.63
Hero: calls $35.63
Small Blind: folds 
*** RIVER *** [6s 3c 9h 3s] [7c]
Big Blind: bets $106.76
Hero: folds 
*** SHOW DOWN ***
Small Blind: shows [Js Kd] (a hand...)
Big Blind: shows [5d Ad] (a hand...)
Hero: shows [Tc 9s] (a hand...)
Uncalled bet ($106.76) returned to Big Blind
Big Blind collected $106.76 from pot
*** SUMMARY ***
Total pot $108.76 | Rake $2.00
Board [6s 3c 9h 3s 7c]
Seat 1: Big Blind collected ($106.76)
Seat 2: Hero folded
Seat 3: Small Blind folded



PokerStars Hand #3955780582:  Hold'em No Limit ($2.50/$5) - 2020/06/04 14:16:21 ET
Table 'Zone Poker ID 1612' 9-max Seat #2 is the button
Seat 1: Big Blind ($439.28 in chips) 
Seat 2: Dealer ($953.90 in chips) 
Seat 3: Hero ($1452.87 in chips) 
Hero: posts small blind $2.50
Big Blind: posts big blind $5
*** HOLE CARDS ***
Dealt to Hero [8c As]
Dealer: folds 
Hero: raises $10.00 to $15
Big Blind: calls $10
*** FLOP *** [7c 9s Tc]
Hero: checks 
Big Blind: checks 
*** TURN *** [7c 9s Tc] [Kh]
Hero: checks 
Big Blind: bets $21.38
Hero: calls $21.38
*** RIVER *** [7c 9s Tc Kh] [Td]
Hero: checks 
Big Blind: bets $53.07
Hero: folds 
*** SHOW DOWN ***
Dealer: shows [Ts 4c] (a hand...)
Big Blind: shows [Qc 6c] (a hand...)
Hero: shows [8c As] (a hand...)
Uncalled bet ($53.07) returned to Big Blind
Big Blind collected $70.76 from pot
*** SUMMARY ***
Total pot $72.76 | Rake $2.00
Board [7c 9s Tc Kh Td]
Seat 1: Big Blind collected ($70.76)
Seat 2: Dealer folded
Seat 3: Hero folded



PokerStars Hand #3955780254:  Hold'em No Limit ($2.50/$5) - 2020/06/04 14:15:21 ET
Table 'Zone Poker ID 1612' 9-max Seat #2 is the button
Seat 1: Big Blind ($550.77 in chips) 
Seat 2: Hero ($990.62 in chips) 
Seat 3: Small Blind ($924.90 in chips) 
Small Blind: posts small blind $2.50
Big Blind: posts big blind $5
*** HOLE CARDS ***
Dealt to Hero [Kd Td]
Hero: raises $7.50 to $12.50
Small Blind: folds 
Big Blind: calls $7.50
*** FLOP *** [6c 4h 8c]
Big Blind: checks 
Hero: checks 
*** TURN *** [6c 4h 8c] [4s]
Big Blind: checks 
Hero: checks 
*** RIVER *** [6c 4h 8c 4s] [2s]
Big Blind: bets $15
Hero: folds 
*** SHOW DOWN ***
Small Blind: shows [Jd 9d] (a hand...)
Big Blind: shows [Kh 2h] (a hand...)
Hero: shows [Kd Td] (a hand...)
Uncalled bet ($15.00) returned to Big Blind
Big Blind collected $26.13 from pot
*** SUMMARY ***
Total pot $27.50 | Rake $1.37
Board [6c 4h 8c 4s 2s]
Seat 1: Big Blind collected ($26.13)
Seat 2: Hero folded
Seat 3: Small Blind folded



PokerStars Hand #3955779534:  Hold'em No Limit ($2.50/$5) - 2020/06/04 14:13:05 ET
Table 'Zone Poker ID 1612' 9-max Seat #3 is the button
Seat 1: Small Blind ($376.78 in chips) 
Seat 2: Hero ($1016.97 in chips) 
Seat 3: Dealer ($893.77 in chips) 
Small Blind: posts small blind $2.50
Hero: posts big blind $5
*** HOLE CARDS ***
Dealt to Hero [Qd 6d]
Dealer: folds 
Small Blind: raises $10.00 to $15
Hero: calls $10
*** FLOP *** [Qh As 5h]
Small Blind: bets $14.25
Hero: calls $14.25
*** TURN *** [Qh As 5h] [Ah]
Small Blind: bets $28.25
Hero: calls $28.25
*** RIVER *** [Qh As 5h Ah] [5c]
Small Blind: bets $56.50
Hero: calls $56.50
*** SHOW DOWN ***
Small Blind: shows [9s Ac] (a hand...)
Dealer: shows [3s Kd] (a hand...)
Hero: shows [Qd 6d] (a hand...)
Small Blind collected $226 from pot
*** SUMMARY ***
Total pot $228.00 | Rake $2.00
Board [Qh As 5h Ah 5c]
Seat 1: Small Blind showed [9s Ac] and won ($226)
Seat 2: Hero showed [Qd 6d] and lost with...
Seat 3: Dealer folded



PokerStars Hand #3955779224:  Hold'em No Limit ($2.50/$5) - 2020/06/04 14:12:05 ET
Table 'Zone Poker ID 1612' 9-max Seat #3 is the button
Seat 1: Small Blind ($375.54 in chips) 
Seat 2: Hero ($1044.47 in chips) 
Seat 3: Dealer ($221.67 in chips) 
Small Blind: posts small blind $2.50
Hero: posts big blind $5
*** HOLE CARDS ***
Dealt to Hero [Jc 3c]
Dealer: folds 
Small Blind: raises $5.00 to $10
Hero: calls $5
*** FLOP *** [4s 6d Ah]
Small Blind: checks 
Hero: checks 
*** TURN *** [4s 6d Ah] [Kd]
Small Blind: checks 
Hero: checks 
*** RIVER *** [4s 6d Ah Kd] [8s]
Small Blind: bets $9.50
Hero: folds 
*** SHOW DOWN ***
Small Blind: shows [7s Ad] (a hand...)
Dealer: shows [Qc 3h] (a hand...)
Hero: shows [Jc 3c] (a hand...)
Uncalled bet ($9.50) returned to Small Blind
Small Blind collected $19 from pot
*** SUMMARY ***
Total pot $20.00 | Rake $1.00
Board [4s 6d Ah Kd 8s]
Seat 1: Small Blind collected ($19)
Seat 2: Hero folded
Seat 3: Dealer folded



PokerStars Hand #3955776499:  Hold'em No Limit ($2.50/$5) - 2020/06/04 14:03:15 ET
Table 'Zone Poker ID 1612' 9-max Seat #3 is the button
Seat 1: Small Blind ($355.75 in chips) 
Seat 2: Hero ($1253.27 in chips) 
Seat 3: Dealer ($616.60 in chips) 
Small Blind: posts small blind $2.50
Hero: posts big blind $5
*** HOLE CARDS ***
Dealt to Hero [Ac Jc]
Dealer: raises $10 to $15
Small Blind: calls $12.50
Hero: raises $62.50 to $77.50
Dealer: folds 
Small Blind: calls $62.50
*** FLOP *** [7h 4h Td]
Small Blind: checks 
Hero: checks 
*** TURN *** [7h 4h Td] [5h]
Small Blind: checks 
Hero: checks 
*** RIVER *** [7h 4h Td 5h] [Ad]
Small Blind: bets $278.25 and is all-in
Hero: folds 
*** SHOW DOWN ***
Small Blind: shows [Jd As] (a hand...)
Dealer: shows [Qs 7s] (a hand...)
Hero: shows [Ac Jc] (a hand...)
Uncalled bet ($278.25) returned to Small Blind
Small Blind collected $168 from pot
*** SUMMARY ***
Total pot $170.00 | Rake $2.00
Board [7h 4h Td 5h Ad]
Seat 1: Small Blind collected ($168)
Seat 2: Hero folded
Seat 3: Dealer folded



PokerStars Hand #3955776220:  Hold'em No Limit ($2.50/$5) - 2020/06/04 14:02:23 ET
Table 'Zone Poker ID 1612' 9-max Seat #3 is the button
Seat 1: Big Blind ($500.00 in chips) 
Seat 2: Hero ($1099.52 in chips) 
Seat 3: Dealer ($646.60 in chips) 
Seat 4: Small Blind ($391.04 in chips) 
Small Blind: posts small blind $2.50
Big Blind: posts big blind $5
*** HOLE CARDS ***
Dealt to Hero [Ad Kc]
Hero: raises $7.50 to $12.50
Dealer: folds 
Small Blind: calls $10
Big Blind: calls $7.50
*** FLOP *** [Ac 7h 5s]
Small Blind: checks 
Big Blind: checks 
Hero: bets $20
Small Blind: folds 
Big Blind: calls $20
*** TURN *** [Ac 7h 5s] [6d]
Big Blind: bets $37.25
Hero: calls $37.25
*** RIVER *** [Ac 7h 5s 6d] [Qc]
Big Blind: bets $74.50
Hero: calls $74.50
*** SHOW DOWN ***
Small Blind: shows [9c Qh] (a hand...)
Dealer: shows [Kd 4s] (a hand...)
Big Blind: shows [3h Ah] (a hand...)
Hero: shows [Ad Kc] (a hand...)
Hero collected $298 from pot
*** SUMMARY ***
Total pot $301.00 | Rake $3.00
Board [Ac 7h 5s 6d Qc]
Seat 1: Big Blind showed [3h Ah] and lost with...
Seat 2: Hero showed [Ad Kc] and won ($298)
Seat 3: Dealer folded
Seat 4: Small Blind folded



PokerStars Hand #3955771900:  Hold'em No Limit ($2.50/$5) - 2020/06/04 13:49:09 ET
Table 'Zone Poker ID 1612' 9-max Seat #2 is the button
Seat 1: Hero ($907.25 in chips) 
Seat 2: Dealer ($433.50 in chips) 
Seat 3: Small Blind ($722.85 in chips) 
Small Blind: posts small blind $2.50
Hero: posts big blind $5
*** HOLE CARDS ***
Dealt to Hero [3c 5d]
Dealer: calls $5
Small Blind: folds 
Hero: checks 
*** FLOP *** [Ts 7d 8s]
Hero: checks 
Dealer: checks 
*** TURN *** [Ts 7d 8s] [3h]
Hero: checks 
Dealer: checks 
*** RIVER *** [Ts 7d 8s 3h] [Qs]
Hero: checks 
Dealer: bets $5.94
Hero: folds 
*** SHOW DOWN ***
Small Blind: shows [9s 2d] (a hand...)
Dealer: shows [Th Td] (a hand...)
Hero: shows [3c 5d] (a hand...)
Uncalled bet ($5.94) returned to Dealer
Dealer collected $11.88 from pot
*** SUMMARY ***
Total pot $12.50 | Rake $0.62
Board [Ts 7d 8s 3h Qs]
Seat 1: Hero folded
Seat 2: Dealer collected ($11.88)
Seat 3: Small Blind folded



PokerStars Hand #3955767051:  Hold'em No Limit ($2.50/$5) - 2020/06/04 13:33:56 ET
Table 'Zone Poker ID 1612' 9-max Seat #3 is the button
Seat 1: Big Blind ($650.49 in chips) 
Seat 2: Hero ($548.79 in chips) 
Seat 3: Dealer ($355.34 in chips) 
Seat 4: Small Blind ($545.13 in chips) 
Small Blind: posts small blind $2.50
Big Blind: posts big blind $5
*** HOLE CARDS ***
Dealt to Hero [Kc Js]
Hero: raises $7.50 to $12.50
Dealer: folds 
Small Blind: calls $10
Big Blind: calls $7.50
*** FLOP *** [8c 8s 3d]
Small Blind: checks 
Big Blind: checks 
Hero: checks 
*** TURN *** [8c 8s 3d] [5s]
Small Blind: checks 
Big Blind: checks 
Hero: checks 
*** RIVER *** [8c 8s 3d 5s] [7h]
Small Blind: checks 
Big Blind: bets $17.82
Hero: folds 
Small Blind: calls $17.82
*** SHOW DOWN ***
Small Blind: shows [Qc Ac] (a hand...)
Dealer: shows [Jd 7s] (a hand...)
Big Blind: shows [Qh Ts] (a hand...)
Hero: shows [Kc Js] (a hand...)
Small Blind collected $70.14 from pot
*** SUMMARY ***
Total pot $73.14 | Rake $3.00
Board [8c 8s 3d 5s 7h]
Seat 1: Big Blind showed [Qh Ts] and lost with...
Seat 2: Hero folded
Seat 3: Dealer folded
Seat 4: Small Blind showed [Qc Ac] and won ($70.14)



PokerStars Hand #3955344609:  Hold'em No Limit ($2.50/$5) - 2020/06/03 17:12:10 ET
Table 'Zone Poker ID 1612' 9-max Seat #2 is the button
Seat 1: UTG+1 ($690.75 in chips) 
Seat 2: Dealer ($500.00 in chips) 
Seat 3: Hero ($723.43 in chips) 
Seat 4: Big Blind ($512.68 in chips) 
Seat 5: UTG ($527.52 in chips) 
Hero: posts small blind $2.50
Big Blind: posts big blind $5
*** HOLE CARDS ***
Dealt to Hero [9d Ts]
UTG: folds 
UTG+1: folds 
Dealer: folds 
Hero: raises $10.00 to $15
Big Blind: calls $10
*** FLOP *** [4c Qh Kh]
Hero: bets $8.55
Big Blind: calls $8.55
*** TURN *** [4c Qh Kh] [Qc]
Hero: bets $33.56
Big Blind: calls $33.56
*** RIVER *** [4c Qh Kh Qc] [Qs]
Hero: checks 
Big Blind: bets $55.61
Hero: folds 
*** SHOW DOWN ***
Big Blind: shows [Ks Jc] (a hand...)
Hero: shows [9d Ts] (a hand...)
Dealer: shows [7c 2h] (a hand...)
UTG: shows [4h 5c] (a hand...)
UTG+1: shows [Ac 6s] (a hand...)
Uncalled bet ($55.61) returned to Big Blind
Big Blind collected $111.22 from pot
*** SUMMARY ***
Total pot $114.22 | Rake $3.00
Board [4c Qh Kh Qc Qs]
Seat 1: UTG+1 folded
Seat 2: Dealer folded
Seat 3: Hero folded
Seat 4: Big Blind collected ($111.22)
Seat 5: UTG folded



PokerStars Hand #3955344163:  Hold'em No Limit ($2.50/$5) - 2020/06/03 17:11:01 ET
Table 'Zone Poker ID 1612' 9-max Seat #4 is the button
Seat 1: Hero ($706.61 in chips) 
Seat 2: UTG ($520.18 in chips) 
Seat 3: UTG+1 ($1151.43 in chips) 
Seat 4: Dealer ($717.52 in chips) 
Seat 5: Small Blind ($769.52 in chips) 
Small Blind: posts small blind $2.50
Hero: posts big blind $5
*** HOLE CARDS ***
Dealt to Hero [5s 7s]
UTG: folds 
UTG+1: folds 
Dealer: raises $7.50 to $12.50
Small Blind: folds 
Hero: calls $7.50
*** FLOP *** [2d Ac 7c]
Hero: checks 
Dealer: bets $8.07
Hero: calls $8.07
*** TURN *** [2d Ac 7c] [4c]
Hero: checks 
Dealer: checks 
*** RIVER *** [2d Ac 7c 4c] [Kh]
Hero: checks 
Dealer: bets $10.73
Hero: folds 
*** SHOW DOWN ***
Small Blind: shows [3h 5d] (a hand...)
Hero: shows [5s 7s] (a hand...)
Dealer: shows [Ts 9d] (a hand...)
UTG: shows [6d As] (a hand...)
UTG+1: shows [4d 9h] (a hand...)
Uncalled bet ($10.73) returned to Dealer
Dealer collected $41.46 from pot
*** SUMMARY ***
Total pot $43.64 | Rake $2.18
Board [2d Ac 7c 4c Kh]
Seat 1: Hero folded
Seat 2: UTG folded
Seat 3: UTG+1 folded
Seat 4: Dealer collected ($41.46)
Seat 5: Small Blind folded



PokerStars Hand #3955343663:  Hold'em No Limit ($2.50/$5) - 2020/06/03 17:09:41 ET
Table 'Zone Poker ID 1612' 9-max Seat #1 is the button
Seat 1: Hero ($709.00 in chips) 
Seat 2: Small Blind ($952.32 in chips) 
Seat 3: Big Blind ($250.00 in chips) 
Seat 4: UTG ($742.92 in chips) 
Seat 5: UTG+1 ($937.42 in chips) 
Small Blind: posts small blind $2.50
Big Blind: posts big blind $5
*** HOLE CARDS ***
Dealt to Hero [9h 8s]
UTG: folds 
UTG+1: folds 
Hero: raises $7.50 to $12.50
Small Blind: folds 
Big Blind: calls $7.50
*** FLOP *** [9s Qd Ks]
Big Blind: checks 
Hero: bets $8.07
Big Blind: calls $8.07
*** TURN *** [9s Qd Ks] [Jh]
Big Blind: checks 
Hero: checks 
*** RIVER *** [9s Qd Ks Jh] [5c]
Big Blind: bets $20.73
Hero: folds 
*** SHOW DOWN ***
Small Blind: shows [5d 3c] (a hand...)
Big Blind: shows [Th 6c] (a hand...)
Hero: shows [9h 8s] (a hand...)
UTG: shows [6d 7c] (a hand...)
UTG+1: shows [8c 2d] (a hand...)
Uncalled bet ($20.73) returned to Big Blind
Big Blind collected $41.46 from pot
*** SUMMARY ***
Total pot $43.64 | Rake $2.18
Board [9s Qd Ks Jh 5c]
Seat 1: Hero folded
Seat 2: Small Blind folded
Seat 3: Big Blind collected ($41.46)
Seat 4: UTG folded
Seat 5: UTG+1 folded



PokerStars Hand #3955343623:  Hold'em No Limit ($2.50/$5) - 2020/06/03 17:09:36 ET
Table 'Zone Poker ID 1612' 9-max Seat #4 is the button
Seat 1: Hero ($791.12 in chips) 
Seat 2: UTG ($1069.92 in chips) 
Seat 3: UTG+1 ($701.52 in chips) 
Seat 4: Dealer ($937.42 in chips) 
Seat 5: Small Blind ($916.98 in chips) 
Small Blind: posts small blind $2.50
Hero: posts big blind $5
*** HOLE CARDS ***
Dealt to Hero [2d Ad]
UTG: raises $7.50 to $12.50
UTG+1: folds 
Dealer: folds 
Small Blind: folds 
Hero: calls $7.50
*** FLOP *** [Th Ah 5c]
Hero: checks 
UTG: bets $8.62
Hero: calls $8.62
*** TURN *** [Th Ah 5c] [8h]
Hero: checks 
UTG: bets $21.26
Hero: calls $21.26
*** RIVER *** [Th Ah 5c 8h] [7s]
Hero: checks 
UTG: bets $42.13
Hero: calls $42.13
*** SHOW DOWN ***
Small Blind: shows [Js 9h] (a hand...)
Hero: shows [2d Ad] (a hand...)
Dealer: shows [Kc 2s] (a hand...)
UTG: shows [As 5s] (a hand...)
UTG+1: shows [2c 7h] (a hand...)
UTG collected $168.52 from pot
*** SUMMARY ***
Total pot $171.52 | Rake $3.00
Board [Th Ah 5c 8h 7s]
Seat 1: Hero showed [2d Ad] and lost with...
Seat 2: UTG showed [As 5s] and won ($168.52)
Seat 3: UTG+1 folded
Seat 4: Dealer folded
Seat 5: Small Blind folded



PokerStars Hand #3955342884:  Hold'em No Limit ($2.50/$5) - 2020/06/03 17:07:42 ET
Table 'Zone Poker ID 1612' 9-max Seat #1 is the button
Seat 1: Dealer ($954.82 in chips) 
Seat 2: Small Blind ($1138.13 in chips) 
Seat 3: Hero ($718.41 in chips) 
Seat 4: UTG ($414.00 in chips) 
Seat 5: UTG+1 ($730.14 in chips) 
Small Blind: posts small blind $2.50
Hero: posts big blind $5
*** HOLE CARDS ***
Dealt to Hero [Ks Td]
UTG: folds 
UTG+1: folds 
Dealer: folds 
Small Blind: raises $7.50 to $12.50
Hero: calls $7.50
*** FLOP *** [8h Jc Kc]
Small Blind: checks 
Hero: checks 
*** TURN *** [8h Jc Kc] [Js]
Small Blind: bets $11.88
Hero: calls $11.88
*** RIVER *** [8h Jc Kc Js] [4c]
Small Blind: bets $46.33
Hero: calls $46.33
*** SHOW DOWN ***
Small Blind: shows [9c 5d] (a hand...)
Hero: shows [Ks Td] (a hand...)
Dealer: shows [9s 3s] (a hand...)
UTG: shows [8s Jd] (a hand...)
UTG+1: shows [Qs 3h] (a hand...)
Hero collected $138.42 from pot
*** SUMMARY ***
Total pot $141.42 | Rake $3.00
Board [8h Jc Kc Js 4c]
Seat 1: Dealer folded
Seat 2: Small Blind showed [9c 5d] and lost with...
Seat 3: Hero showed [Ks Td] and won ($138.42)
Seat 4: UTG folded
Seat 5: UTG+1 folded



PokerStars Hand #3955341443:  Hold'em No Limit ($2.50/$5) - 2020/06/03 17:03:56 ET
Table 'Zone Poker ID 1612' 9-max Seat #4 is the button
Seat 1: Big Blind ($500.00 in chips) 
Seat 2: UTG ($634.75 in chips) 
Seat 3: UTG+1 ($931.36 in chips) 
Seat 4: Dealer ($701.29 in chips) 
Seat 5: Hero ($638.91 in chips) 
Hero: posts small blind $2.50
Big Blind: posts big blind $5
*** HOLE CARDS ***
Dealt to Hero [As 2s]
UTG: folds 
UTG+1: folds 
Dealer: raises $7.50 to $12.50
Hero: raises $42.50 to $55
Big Blind: folds 
Dealer: calls $42.50
*** FLOP *** [Ad 7h 5d]
Hero: checks 
Dealer: bets $41
Hero: calls $41
*** TURN *** [Ad 7h 5d] [Kc]
Hero: checks 
Dealer: checks 
*** RIVER *** [Ad 7h 5d Kc] [9d]
Hero: checks 
Dealer: bets $605.29 and is all-in
Hero: folds 
*** SHOW DOWN ***
Big Blind: shows [3d 9c] (a hand...)
Hero: shows [As 2s] (a hand...)
Dealer: shows [7d 6d] (a hand...)
UTG: shows [8h 2c] (a hand...)
UTG+1: shows [6c 3s] (a hand...)
Uncalled bet ($605.29) returned to Dealer
Dealer collected $194 from pot
*** SUMMARY ***
Total pot $197.00 | Rake $3.00
Board [Ad 7h 5d Kc 9d]
Seat 1: Big Blind folded
Seat 2: UTG folded
Seat 3: UTG+1 folded
Seat 4: Dealer collected ($194)
Seat 5: Hero folded



PokerStars Hand #3955339121:  Hold'em No Limit ($2.50/$5) - 2020/06/03 16:57:57 ET
Table 'Zone Poker ID 1612' 9-max Seat #6 is the button
Seat 1: Small Blind ($464.88 in chips) 
Seat 2: Hero ($662.18 in chips) 
Seat 3: UTG ($486.33 in chips) 
Seat 4: UTG+1 ($518.63 in chips) 
Seat 5: UTG+2 ($502.50 in chips) 
Seat 6: Dealer ($559.23 in chips) 
Small Blind: posts small blind $2.50
Hero: posts big blind $5
*** HOLE CARDS ***
Dealt to Hero [Kh 5h]
UTG: folds 
UTG+1: folds 
UTG+2: raises $6.75 to $11.75
Dealer: folds 
Small Blind: folds 
Hero: calls $6.75
*** FLOP *** [8c 3c 8h]
Hero: checks 
UTG+2: bets $6.18
Hero: calls $6.18
*** TURN *** [8c 3c 8h] [9s]
Hero: checks 
UTG+2: checks 
*** RIVER *** [8c 3c 8h 9s] [5c]
Hero: checks 
UTG+2: bets $5
Hero: calls $5
*** SHOW DOWN ***
Small Blind: shows [5s Tc] (a hand...)
Hero: shows [Kh 5h] (a hand...)
UTG+2: shows [8d 6d] (a hand...)
Dealer: shows [Kc 6h] (a hand...)
UTG: shows [Jh 3s] (a hand...)
UTG+1: shows [5d 7c] (a hand...)
UTG+2 collected $45.95 from pot
*** SUMMARY ***
Total pot $48.36 | Rake $2.41
Board [8c 3c 8h 9s 5c]
Seat 1: Small Blind folded
Seat 2: Hero showed [Kh 5h] and lost with...
Seat 3: UTG folded
Seat 4: UTG+1 folded
Seat 5: UTG+2 showed [8d 6d] and won ($45.95)
Seat 6: Dealer folded



PokerStars Hand #3955334842:  Hold'em No Limit ($2.50/$5) - 2020/06/03 16:47:07 ET
Table 'Zone Poker ID 1612' 9-max Seat #5 is the button
Seat 1: Hero ($484.87 in chips) 
Seat 2: Big Blind ($1133.89 in chips) 
Seat 3: UTG ($627.54 in chips) 
Seat 4: UTG+1 ($495.00 in chips) 
Seat 5: Dealer ($406.63 in chips) 
Hero: posts small blind $2.50
Big Blind: posts big blind $5
*** HOLE CARDS ***
Dealt to Hero [Td 6d]
UTG: folds 
UTG+1: folds 
Dealer: folds 
Hero: raises $10.00 to $15
Big Blind: calls $10
*** FLOP *** [3s 9h Qd]
Hero: bets $20
Big Blind: calls $20
*** TURN *** [3s 9h Qd] [6c]
Hero: bets $50.25
Big Blind: calls $50.25
*** RIVER *** [3s 9h Qd 6c] [9d]
Hero: checks 
Big Blind: bets $195
Hero: folds 
*** SHOW DOWN ***
Big Blind: shows [9c Kc] (a hand...)
Hero: shows [Td 6d] (a hand...)
Dealer: shows [Qc 2d] (a hand...)
UTG: shows [Ac 5h] (a hand...)
UTG+1: shows [7c Ah] (a hand...)
Uncalled bet ($195.00) returned to Big Blind
Big Blind collected $167.50 from pot
*** SUMMARY ***
Total pot $170.50 | Rake $3.00
Board [3s 9h Qd 6c 9d]
Seat 1: Hero folded
Seat 2: Big Blind collected ($167.50)
Seat 3: UTG folded
Seat 4: UTG+1 folded
Seat 5: Dealer folded



PokerStars Hand #3955333240:  Hold'em No Limit ($2.50/$5) - 2020/06/03 16:43:05 ET
Table 'Zone Poker ID 1612' 9-max Seat #4 is the button
Seat 1: Small Blind ($1305.46 in chips) 
Seat 2: Big Blind ($842.54 in chips) 
Seat 3: Hero ($497.50 in chips) 
Seat 4: Dealer ($484.50 in chips) 
Small Blind: posts small blind $2.50
Big Blind: posts big blind $5
*** HOLE CARDS ***
Dealt to Hero [Ah As]
Hero: raises $6.25 to $11.25
Dealer: folds 
Small Blind: raises $36.25 to $47.50
Big Blind: folds 
Hero: raises $67.50 to $115
Small Blind: calls $67.50
*** FLOP *** [7d Ks 6s]
Small Blind: checks 
Hero: bets $66.72
Small Blind: calls $66.72
*** TURN *** [7d Ks 6s] [6d]
Small Blind: checks 
Hero: checks 
*** RIVER *** [7d Ks 6s 6d] [Ts]
Small Blind: bets $1123.74 and is all-in
Hero: calls $315.78 and is all-in
*** SHOW DOWN ***
Small Blind: shows [8s 8h] (a hand...)
Dealer: shows [2c 3h] (a hand...)
Big Blind: shows [5s Ad] (a hand...)
Hero: shows [Ah As] (a hand...)
Uncalled bet ($807.96) returned to Small Blind
Hero collected $997 from pot
*** SUMMARY ***
Total pot $1000.00 | Rake $3.00
Board [7d Ks 6s 6d Ts]
Seat 1: Small Blind showed [8s 8h] and lost with...
Seat 2: Big Blind folded
Seat 3: Hero showed [Ah As] and won ($997)
Seat 4: Dealer folded



PokerStars Hand #3955309742:  Hold'em No Limit ($2.50/$5) - 2020/06/03 15:40:19 ET
Table 'Zone Poker ID 1612' 9-max Seat #1 is the button
Seat 1: Dealer ($627.83 in chips) 
Seat 2: Small Blind ($1494.40 in chips) 
Seat 3: Hero ($588.21 in chips) 
Small Blind: posts small blind $2.50
Hero: posts big blind $5
*** HOLE CARDS ***
Dealt to Hero [Qh Tc]
Dealer: folds 
Small Blind: raises $7.50 to $12.50
Hero: calls $7.50
*** FLOP *** [Qc 4d 6s]
Small Blind: checks 
Hero: bets $11.88
Small Blind: raises $23.76 to $35.64
Hero: calls $23.76
*** TURN *** [Qc 4d 6s] [5h]
Small Blind: bets $60
Hero: calls $60
*** RIVER *** [Qc 4d 6s 5h] [9h]
Small Blind: bets $160.71
Hero: folds 
*** SHOW DOWN ***
Small Blind: shows [3h Ad] (a hand...)
Dealer: shows [6h Kc] (a hand...)
Hero: shows [Qh Tc] (a hand...)
Uncalled bet ($160.71) returned to Small Blind
Small Blind collected $214.28 from pot
*** SUMMARY ***
Total pot $216.28 | Rake $2.00
Board [Qc 4d 6s 5h 9h]
Seat 1: Dealer folded
Seat 2: Small Blind collected ($214.28)
Seat 3: Hero folded



PokerStars Hand #3955309312:  Hold'em No Limit ($2.50/$5) - 2020/06/03 15:39:03 ET
Table 'Zone Poker ID 1612' 9-max Seat #2 is the button
Seat 1: Hero ($618.21 in chips) 
Seat 2: Dealer ($557.80 in chips) 
Seat 3: Small Blind ($546.22 in chips) 
Small Blind: posts small blind $2.50
Hero: posts big blind $5
*** HOLE CARDS ***
Dealt to Hero [4d 4s]
Dealer: folds 
Small Blind: raises $10.00 to $15
Hero: calls $10
*** FLOP *** [Js 5d 6d]
Small Blind: bets $10
Hero: calls $10
*** TURN *** [Js 5d 6d] [2c]
Small Blind: checks 
Hero: checks 
*** RIVER *** [Js 5d 6d 2c] [9h]
Small Blind: bets $75
Hero: folds 
*** SHOW DOWN ***
Small Blind: shows [Qd 8c] (a hand...)
Dealer: shows [6h 3d] (a hand...)
Hero: shows [4d 4s] (a hand...)
Uncalled bet ($75.00) returned to Small Blind
Small Blind collected $48 from pot
*** SUMMARY ***
Total pot $50.00 | Rake $2.00
Board [Js 5d 6d 2c 9h]
Seat 1: Hero folded
Seat 2: Dealer folded
Seat 3: Small Blind collected ($48)



PokerStars Hand #3955308928:  Hold'em No Limit ($2.50/$5) - 2020/06/03 15:37:56 ET
Table 'Zone Poker ID 1612' 9-max Seat #1 is the button
Seat 1: Hero ($744.05 in chips) 
Seat 2: Small Blind ($347.96 in chips) 
Seat 3: Big Blind ($752.73 in chips) 
Small Blind: posts small blind $2.50
Big Blind: posts big blind $5
*** HOLE CARDS ***
Dealt to Hero [9c Ah]
Hero: raises $6.25 to $11.25
Small Blind: folds 
Big Blind: calls $6.25
*** FLOP *** [8h 7c 3c]
Big Blind: checks 
Hero: checks 
*** TURN *** [8h 7c 3c] [Jc]
Big Blind: bets $15.83
Hero: calls $15.83
*** RIVER *** [8h 7c 3c Jc] [Qh]
Big Blind: bets $36.44
Hero: folds 
*** SHOW DOWN ***
Small Blind: shows [9s 2d] (a hand...)
Big Blind: shows [9h Kh] (a hand...)
Hero: shows [9c Ah] (a hand...)
Uncalled bet ($36.44) returned to Big Blind
Big Blind collected $54.66 from pot
*** SUMMARY ***
Total pot $56.66 | Rake $2.00
Board [8h 7c 3c Jc Qh]
Seat 1: Hero folded
Seat 2: Small Blind folded
Seat 3: Big Blind collected ($54.66)



PokerStars Hand #3955308108:  Hold'em No Limit ($2.50/$5) - 2020/06/03 15:35:33 ET
Table 'Zone Poker ID 1612' 9-max Seat #3 is the button
Seat 1: Hero ($874.37 in chips) 
Seat 2: Big Blind ($1426.52 in chips) 
Seat 3: Dealer ($505.00 in chips) 
Hero: posts small blind $2.50
Big Blind: posts big blind $5
*** HOLE CARDS ***
Dealt to Hero [3h Ah]
Dealer: raises $7.50 to $12.50
Hero: raises $40.00 to $52.50
Big Blind: folds 
Dealer: calls $40
*** FLOP *** [2h 8d Jd]
Hero: bets $61.57
Dealer: calls $61.57
*** TURN *** [2h 8d Jd] [9c]
Hero: checks 
Dealer: checks 
*** RIVER *** [2h 8d Jd 9c] [4h]
Hero: checks 
Dealer: bets $154.08
Hero: folds 
*** SHOW DOWN ***
Dealer: shows [Jc Qc] (a hand...)
Big Blind: shows [6h Qh] (a hand...)
Hero: shows [3h Ah] (a hand...)
Uncalled bet ($154.08) returned to Dealer
Dealer collected $231.14 from pot
*** SUMMARY ***
Total pot $233.14 | Rake $2.00
Board [2h 8d Jd 9c 4h]
Seat 1: Hero folded
Seat 2: Big Blind folded
Seat 3: Dealer collected ($231.14)



PokerStars Hand #3955307182:  Hold'em No Limit ($2.50/$5) - 2020/06/03 15:32:57 ET
Table 'Zone Poker ID 1612' 9-max Seat #1 is the button
Seat 1: Dealer ($1140.77 in chips) 
Seat 2: Small Blind ($1449.19 in chips) 
Seat 3: Hero ($912.76 in chips) 
Small Blind: posts small blind $2.50
Hero: posts big blind $5
*** HOLE CARDS ***
Dealt to Hero [Kh 2s]
Dealer: folds 
Small Blind: raises $7.50 to $12.50
Hero: calls $7.50
*** FLOP *** [Th Jd 3c]
Small Blind: checks 
Hero: checks 
*** TURN *** [Th Jd 3c] [Kd]
Small Blind: bets $11.88
Hero: calls $11.88
*** RIVER *** [Th Jd 3c Kd] [8c]
Small Blind: bets $23.38
Hero: calls $23.38
*** SHOW DOWN ***
Small Blind: shows [8s Ks] (a hand...)
Dealer: shows [3s 9h] (a hand...)
Hero: shows [Kh 2s] (a hand...)
Small Blind collected $93.52 from pot
*** SUMMARY ***
Total pot $95.52 | Rake $2.00
Board [Th Jd 3c Kd 8c]
Seat 1: Dealer folded
Seat 2: Small Blind showed [8s Ks] and won ($93.52)
Seat 3: Hero showed [Kh 2s] and lost with...



PokerStars Hand #3955306900:  Hold'em No Limit ($2.50/$5) - 2020/06/03 15:32:11 ET
Table 'Zone Poker ID 1612' 9-max Seat #2 is the button
Seat 1: Hero ($942.75 in chips) 
Seat 2: Dealer ($385.55 in chips) 
Seat 3: Small Blind ($599.54 in chips) 
Small Blind: posts small blind $2.50
Hero: posts big blind $5
*** HOLE CARDS ***
Dealt to Hero [4h Kh]
Dealer: folds 
Small Blind: raises $7.50 to $12.50
Hero: calls $7.50
*** FLOP *** [Ad 2s 5s]
Small Blind: checks 
Hero: checks 
*** TURN *** [Ad 2s 5s] [4s]
Small Blind: bets $11.88
Hero: calls $11.88
*** RIVER *** [Ad 2s 5s 4s] [Qh]
Small Blind: bets $23.38
Hero: calls $23.38
*** SHOW DOWN ***
Small Blind: shows [8h Ah] (a hand...)
Dealer: shows [5d 4d] (a hand...)
Hero: shows [4h Kh] (a hand...)
Small Blind collected $93.52 from pot
*** SUMMARY ***
Total pot $95.52 | Rake $2.00
Board [Ad 2s 5s 4s Qh]
Seat 1: Hero showed [4h Kh] and lost with...
Seat 2: Dealer folded
Seat 3: Small Blind showed [8h Ah] and won ($93.52)



PokerStars Hand #3955303614:  Hold'em No Limit ($2.50/$5) - 2020/06/03 15:22:57 ET
Table 'Zone Poker ID 1612' 9-max Seat #2 is the button
Seat 1: Big Blind ($495.00 in chips) 
Seat 2: Hero ($762.13 in chips) 
Seat 3: Small Blind ($510.88 in chips) 
Small Blind: posts small blind $2.50
Big Blind: posts big blind $5
*** HOLE CARDS ***
Dealt to Hero [Ah 2d]
Hero: raises $6.25 to $11.25
Small Blind: folds 
Big Blind: calls $6.25
*** FLOP *** [6c 3h 8d]
Big Blind: checks 
Hero: checks 
*** TURN *** [6c 3h 8d] [6d]
Big Blind: checks 
Hero: checks 
*** RIVER *** [6c 3h 8d 6d] [9s]
Big Blind: bets $23.75
Hero: folds 
*** SHOW DOWN ***
Small Blind: shows [Td 6s] (a hand...)
Big Blind: shows [9h Ac] (a hand...)
Hero: shows [Ah 2d] (a hand...)
Uncalled bet ($23.75) returned to Big Blind
Big Blind collected $23.75 from pot
*** SUMMARY ***
Total pot $25.00 | Rake $1.25
Board [6c 3h 8d 6d 9s]
Seat 1: Big Blind collected ($23.75)
Seat 2: Hero folded
Seat 3: Small Blind folded



PokerStars Hand #3955299699:  Hold'em No Limit ($2.50/$5) - 2020/06/03 15:11:39 ET
Table 'Zone Poker ID 1612' 9-max Seat #1 is the button
Seat 1: Dealer ($1615.03 in chips) 
Seat 2: Small Blind ($673.46 in chips) 
Seat 3: Hero ($605.25 in chips) 
Small Blind: posts small blind $2.50
Hero: posts big blind $5
*** HOLE CARDS ***
Dealt to Hero [9s Td]
Dealer: raises $6 to $11
Small Blind: folds 
Hero: calls $6
*** FLOP *** [Tc 4h Jh]
Hero: checks 
Dealer: bets $7.68
Hero: calls $7.68
*** TURN *** [Tc 4h Jh] [4d]
Hero: checks 
Dealer: bets $18.94
Hero: calls $18.94
*** RIVER *** [Tc 4h Jh 4d] [2c]
Hero: checks 
Dealer: bets $40
Hero: calls $40
*** SHOW DOWN ***
Small Blind: shows [Ts 9d] (a hand...)
Dealer: shows [8d 7h] (a hand...)
Hero: shows [9s Td] (a hand...)
Hero collected $155.74 from pot
*** SUMMARY ***
Total pot $157.74 | Rake $2.00
Board [Tc 4h Jh 4d 2c]
Seat 1: Dealer showed [8d 7h] and lost with...
Seat 2: Small Blind folded
Seat 3: Hero showed [9s Td] and won ($155.74)



PokerStars Hand #3955299560:  Hold'em No Limit ($2.50/$5) - 2020/06/03 15:11:14 ET
Table 'Zone Poker ID 1612' 9-max Seat #1 is the button
Seat 1: Hero ($583.91 in chips) 
Seat 2: Small Blind ($574.91 in chips) 
Seat 3: Big Blind ($451.05 in chips) 
Small Blind: posts small blind $2.50
Big Blind: posts big blind $5
*** HOLE CARDS ***
Dealt to Hero [Qc 7c]
Hero: raises $6.25 to $11.25
Small Blind: folds 
Big Blind: calls $6.25
*** FLOP *** [4d 9s 2c]
Big Blind: checks 
Hero: bets $18
Big Blind: raises $29.88 to $47.88
Hero: raises $62.37 to $110.25
Big Blind: calls $62.37
*** TURN *** [4d 9s 2c] [6c]
Big Blind: checks 
Hero: checks 
*** RIVER *** [4d 9s 2c 6c] [6s]
Big Blind: bets $111.75
Hero: folds 
*** SHOW DOWN ***
Small Blind: shows [Jc 2s] (a hand...)
Big Blind: shows [Tc 9c] (a hand...)
Hero: shows [Qc 7c] (a hand...)
Uncalled bet ($111.75) returned to Big Blind
Big Blind collected $243.50 from pot
*** SUMMARY ***
Total pot $245.50 | Rake $2.00
Board [4d 9s 2c 6c 6s]
Seat 1: Hero folded
Seat 2: Small Blind folded
Seat 3: Big Blind collected ($243.50)



PokerStars Hand #3955299307:  Hold'em No Limit ($2.50/$5) - 2020/06/03 15:10:30 ET
Table 'Zone Poker ID 1612' 9-max Seat #3 is the button
Seat 1: Small Blind ($518.66 in chips) 
Seat 2: Big Blind ($622.28 in chips) 
Seat 3: Hero ($639.59 in chips) 
Small Blind: posts small blind $2.50
Big Blind: posts big blind $5
*** HOLE CARDS ***
Dealt to Hero [Ks 3s]
Hero: raises $6.25 to $11.25
Small Blind: folds 
Big Blind: calls $6.25
*** FLOP *** [6c 9s Kc]
Big Blind: checks 
Hero: bets $7.13
Big Blind: calls $7.13
*** TURN *** [6c 9s Kc] [Qc]
Big Blind: checks 
Hero: checks 
*** RIVER *** [6c 9s Kc Qc] [4h]
Big Blind: bets $37.30
Hero: calls $37.30
*** SHOW DOWN ***
Small Blind: shows [5h Jc] (a hand...)
Big Blind: shows [Td Jh] (a hand...)
Hero: shows [Ks 3s] (a hand...)
Big Blind collected $111.86 from pot
*** SUMMARY ***
Total pot $113.86 | Rake $2.00
Board [6c 9s Kc Qc 4h]
Seat 1: Small Blind folded
Seat 2: Big Blind showed [Td Jh] and won ($111.86)
Seat 3: Hero showed [Ks 3s] and lost with...



PokerStars Hand #3955297513:  Hold'em No Limit ($2.50/$5) - 2020/06/03 15:05:17 ET
Table 'Zone Poker ID 1612' 9-max Seat #2 is the button
Seat 1: Big Blind ($495.00 in chips) 
Seat 2: Dealer ($495.00 in chips) 
Seat 3: Hero ($559.60 in chips) 
Hero: posts small blind $2.50
Big Blind: posts big blind $5
*** HOLE CARDS ***
Dealt to Hero [Td As]
Dealer: folds 
Hero: raises $10.00 to $15
Big Blind: calls $10
*** FLOP *** [5c Kd Jh]
Hero: bets $8.55
Big Blind: calls $8.55
*** TURN *** [5c Kd Jh] [9h]
Hero: checks 
Big Blind: bets $17.55
Hero: calls $17.55
*** RIVER *** [5c Kd Jh 9h] [3s]
Hero: checks 
Big Blind: bets $133.48
Hero: folds 
*** SHOW DOWN ***
Dealer: shows [3c 4s] (a hand...)
Big Blind: shows [Kh Jc] (a hand...)
Hero: shows [Td As] (a hand...)
Uncalled bet ($133.48) returned to Big Blind
Big Blind collected $80.20 from pot
*** SUMMARY ***
Total pot $82.20 | Rake $2.00
Board [5c Kd Jh 9h 3s]
Seat 1: Big Blind collected ($80.20)
Seat 2: Dealer folded
Seat 3: Hero folded



PokerStars Hand #3955296834:  Hold'em No Limit ($2.50/$5) - 2020/06/03 15:03:25 ET
Table 'Zone Poker ID 1612' 9-max Seat #2 is the button
Seat 1: Hero ($514.94 in chips) 
Seat 2: Dealer ($695.40 in chips) 
Seat 3: Small Blind ($342.60 in chips) 
Small Blind: posts small blind $2.50
Hero: posts big blind $5
*** HOLE CARDS ***
Dealt to Hero [Qs Jd]
Dealer: raises $7.50 to $12.50
Small Blind: folds 
Hero: calls $7.50
*** FLOP *** [Jh 7c Ac]
Hero: checks 
Dealer: checks 
*** TURN *** [Jh 7c Ac] [8s]
Hero: checks 
Dealer: checks 
*** RIVER *** [Jh 7c Ac 8s] [Qd]
Hero: bets $9.25
Dealer: raises $22.41 to $31.66
Hero: calls $22.41
*** SHOW DOWN ***
Small Blind: shows [9s Kc] (a hand...)
Dealer: shows [Td 8c] (a hand...)
Hero: shows [Qs Jd] (a hand...)
Hero collected $88.82 from pot
*** SUMMARY ***
Total pot $90.82 | Rake $2.00
Board [Jh 7c Ac 8s Qd]
Seat 1: Hero showed [Qs Jd] and won ($88.82)
Seat 2: Dealer showed [Td 8c] and lost with...
Seat 3: Small Blind folded



PokerStars Hand #3955296096:  Hold'em No Limit ($2.50/$5) - 2020/06/03 15:01:17 ET
Table 'Zone Poker ID 1612' 9-max Seat #3 is the button
Seat 1: Small Blind ($450.44 in chips) 
Seat 2: Hero ($498.69 in chips) 
Seat 3: Dealer ($1349.42 in chips) 
Small Blind: posts small blind $2.50
Hero: posts big blind $5
*** HOLE CARDS ***
Dealt to Hero [6d Kh]
Dealer: folds 
Small Blind: raises $10.00 to $15
Hero: calls $10
*** FLOP *** [Jd Js Kc]
Small Blind: bets $9.25
Hero: calls $9.25
*** TURN *** [Jd Js Kc] [4h]
Small Blind: checks 
Hero: checks 
*** RIVER *** [Jd Js Kc 4h] [8c]
Small Blind: bets $66.50
Hero: folds 
*** SHOW DOWN ***
Small Blind: shows [Qs 7c] (a hand...)
Dealer: shows [8s 5d] (a hand...)
Hero: shows [6d Kh] (a hand...)
Uncalled bet ($66.50) returned to Small Blind
Small Blind collected $46.50 from pot
*** SUMMARY ***
Total pot $48.50 | Rake $2.00
Board [Jd Js Kc 4h 8c]
Seat 1: Small Blind collected ($46.50)
Seat 2: Hero folded
Seat 3: Dealer folded



PokerStars Hand #3955295071:  Hold'em No Limit ($2.50/$5) - 2020/06/03 14:58:15 ET
Table 'Zone Poker ID 1612' 9-max Seat #1 is the button
Seat 1: Dealer ($586.70 in chips) 
Seat 2: Small Blind ($1521.79 in chips) 
Seat 3: Hero ($476.32 in chips) 
Small Blind: posts small blind $2.50
Hero: posts big blind $5
*** HOLE CARDS ***
Dealt to Hero [4h As]
Dealer: folds 
Small Blind: raises $10.00 to $15
Hero: calls $10
*** FLOP *** [8d Ah Th]
Small Blind: bets $14.25
Hero: calls $14.25
*** TURN *** [8d Ah Th] [8h]
Small Blind: checks 
Hero: checks 
*** RIVER *** [8d Ah Th 8h] [4c]
Small Blind: bets $20
Hero: calls $20
*** SHOW DOWN ***
Small Blind: shows [7d 7c] (a hand...)
Dealer: shows [Qs 3c] (a hand...)
Hero: shows [4h As] (a hand...)
Hero collected $96.50 from pot
*** SUMMARY ***
Total pot $98.50 | Rake $2.00
Board [8d Ah Th 8h 4c]
Seat 1: Dealer folded
Seat 2: Small Blind showed [7d 7c] and lost with...
Seat 3: Hero showed [4h As] and won ($96.50)



PokerStars Hand #3955294609:  Hold'em No Limit ($2.50/$5) - 2020/06/03 14:56:54 ET
Table 'Zone Poker ID 1612' 9-max Seat #3 is the button
Seat 1: Small Blind ($1135.35 in chips) 
Seat 2: Hero ($512.50 in chips) 
Seat 3: Dealer ($1362.17 in chips) 
Small Blind: posts small blind $2.50
Hero: posts big blind $5
*** HOLE CARDS ***
Dealt to Hero [9h Jc]
Dealer: raises $6 to $11
Small Blind: folds 
Hero: calls $6
*** FLOP *** [9d 6c Qh]
Hero: checks 
Dealer: bets $7.68
Hero: calls $7.68
*** TURN *** [9d 6c Qh] [6s]
Hero: checks 
Dealer: checks 
*** RIVER *** [9d 6c Qh 6s] [5c]
Hero: bets $12.50
Dealer: raises $31.44 to $43.94
Hero: folds 
*** SHOW DOWN ***
Small Blind: shows [Js 7c] (a hand...)
Dealer: shows [Qs Kh] (a hand...)
Hero: shows [9h Jc] (a hand...)
Uncalled bet ($31.44) returned to Dealer
Dealer collected $62.86 from pot
*** SUMMARY ***
Total pot $64.86 | Rake $2.00
Board [9d 6c Qh 6s 5c]
Seat 1: Small Blind folded
Seat 2: Hero folded
Seat 3: Dealer collected ($62.86)



PokerStars Hand #3955293953:  Hold'em No Limit ($2.50/$5) - 2020/06/03 14:54:57 ET
Table 'Zone Poker ID 1612' 9-max Seat #3 is the button
Seat 1: Small Blind ($1111.59 in chips) 
Seat 2: Big Blind ($1640.55 in chips) 
Seat 3: Hero ($465.00 in chips) 
Small Blind: posts small blind $2.50
Big Blind: posts big blind $5
*** HOLE CARDS ***
Dealt to Hero [Jc Ac]
Hero: raises $7.50 to $12.50
Small Blind: folds 
Big Blind: calls $7.50
*** FLOP *** [4h Ts 2c]
Big Blind: checks 
Hero: bets $20
Big Blind: calls $20
*** TURN *** [4h Ts 2c] [7d]
Big Blind: checks 
Hero: checks 
*** RIVER *** [4h Ts 2c 7d] [4s]
Big Blind: bets $65.50
Hero: folds 
*** SHOW DOWN ***
Small Blind: shows [6d Ah] (a hand...)
Big Blind: shows [5s Ad] (a hand...)
Hero: shows [Jc Ac] (a hand...)
Uncalled bet ($65.50) returned to Big Blind
Big Blind collected $65.50 from pot
*** SUMMARY ***
Total pot $67.50 | Rake $2.00
Board [4h Ts 2c 7d 4s]
Seat 1: Small Blind folded
Seat 2: Big Blind collected ($65.50)
Seat 3: Hero folded



PokerStars Hand #3955293790:  Hold'em No Limit ($2.50/$5) - 2020/06/03 14:54:31 ET
Table 'Zone Poker ID 1612' 9-max Seat #2 is the button
Seat 1: Hero ($488.50 in chips) 
Seat 2: Dealer ($1171.74 in chips) 
Seat 3: Small Blind ($1225.35 in chips) 
Small Blind: posts small blind $2.50
Hero: posts big blind $5
*** HOLE CARDS ***
Dealt to Hero [Js Th]
Dealer: raises $6 to $11
Small Blind: folds 
Hero: calls $6
*** FLOP *** [5s 2d Jc]
Hero: checks 
Dealer: bets $7.68
Hero: calls $7.68
*** TURN *** [5s 2d Jc] [8h]
Hero: checks 
Dealer: bets $18.94
Hero: calls $18.94
*** RIVER *** [5s 2d Jc 8h] [Kc]
Hero: checks 
Dealer: bets $56.81
Hero: calls $56.81
*** SHOW DOWN ***
Small Blind: shows [4h 5d] (a hand...)
Dealer: shows [8s 8d] (a hand...)
Hero: shows [Js Th] (a hand...)
Dealer collected $189.36 from pot
*** SUMMARY ***
Total pot $191.36 | Rake $2.00
Board [5s 2d Jc 8h Kc]
Seat 1: Hero showed [Js Th] and lost with...
Seat 2: Dealer showed [8s 8d] and won ($189.36)
Seat 3: Small Blind folded



PokerStars Hand #3955292008:  Hold'em No Limit ($2.50/$5) - 2020/06/03 14:49:26 ET
Table 'Zone Poker ID 1612' 9-max Seat #3 is the button
Seat 1: Hero ($500.00 in chips) 
Seat 2: Big Blind ($1086.50 in chips) 
Seat 3: Dealer ($748.53 in chips) 
Hero: posts small blind $2.50
Big Blind: posts big blind $5
*** HOLE CARDS ***
Dealt to Hero [Ac 6d]
Dealer: folds 
Hero: raises $10.00 to $15
Big Blind: calls $10
*** FLOP *** [3h 7c 6c]
Hero: checks 
Big Blind: bets $14.25
Hero: calls $14.25
*** TURN *** [3h 7c 6c] [7h]
Hero: checks 
Big Blind: bets $42.38
Hero: calls $42.38
*** RIVER *** [3h 7c 6c 7h] [9d]
Hero: checks 
Big Blind: bets $165.92
Hero: calls $165.92
*** SHOW DOWN ***
Dealer: shows [2d 4h] (a hand...)
Big Blind: shows [Th 8d] (a hand...)
Hero: shows [Ac 6d] (a hand...)
Big Blind collected $473.10 from pot
*** SUMMARY ***
Total pot $475.10 | Rake $2.00
Board [3h 7c 6c 7h 9d]
Seat 1: Hero showed [Ac 6d] and lost with...
Seat 2: Big Blind showed [Th 8d] and won ($473.10)
Seat 3: Dealer folded



PokerStars Hand #3955290825:  Hold'em No Limit ($2.50/$5) - 2020/06/03 14:46:10 ET
Table 'Zone Poker ID 1612' 9-max Seat #3 is the button
Seat 1: Small Blind ($1215.23 in chips) 
Seat 2: Hero ($491.88 in chips) 
Seat 3: Dealer ($679.92 in chips) 
Small Blind: posts small blind $2.50
Hero: posts big blind $5
*** HOLE CARDS ***
Dealt to Hero [7s 8s]
Dealer: raises $7.50 to $12.50
Small Blind: folds 
Hero: raises $45.00 to $57.50
Dealer: calls $45
*** FLOP *** [7c Jh 9h]
Hero: checks 
Dealer: bets $37.75
Hero: calls $37.75
*** TURN *** [7c Jh 9h] [Jc]
Hero: checks 
Dealer: checks 
*** RIVER *** [7c Jh 9h Jc] [4s]
Hero: checks 
Dealer: bets $143.25
Hero: folds 
*** SHOW DOWN ***
Small Blind: shows [6s 7d] (a hand...)
Dealer: shows [9s Js] (a hand...)
Hero: shows [7s 8s] (a hand...)
Uncalled bet ($143.25) returned to Dealer
Dealer collected $191 from pot
*** SUMMARY ***
Total pot $193.00 | Rake $2.00
Board [7c Jh 9h Jc 4s]
Seat 1: Small Blind folded
Seat 2: Hero folded
Seat 3: Dealer collected ($191)



PokerStars Hand #3955289617:  Hold'em No Limit ($2.50/$5) - 2020/06/03 14:42:49 ET
Table 'Zone Poker ID 1612' 9-max Seat #3 is the button
Seat 1: Small Blind ($650.19 in chips) 
Seat 2: Big Blind ($1105.24 in chips) 
Seat 3: Hero ($474.32 in chips) 
Small Blind: posts small blind $2.50
Big Blind: posts big blind $5
*** HOLE CARDS ***
Dealt to Hero [7d 8d]
Hero: raises $7.50 to $12.50
Small Blind: folds 
Big Blind: calls $7.50
*** FLOP *** [5s 2d Td]
Big Blind: checks 
Hero: bets $20
Big Blind: calls $20
*** TURN *** [5s 2d Td] [7h]
Big Blind: checks 
Hero: bets $42.50
Big Blind: raises $75.25 to $117.75
Hero: calls $75.25
*** RIVER *** [5s 2d Td 7h] [Ts]
Big Blind: bets $225.75
Hero: calls $225.75
*** SHOW DOWN ***
Small Blind: shows [6c 5h] (a hand...)
Big Blind: shows [2c 2h] (a hand...)
Hero: shows [7d 8d] (a hand...)
Big Blind collected $752.50 from pot
*** SUMMARY ***
Total pot $754.50 | Rake $2.00
Board [5s 2d Td 7h Ts]
Seat 1: Small Blind folded
Seat 2: Big Blind showed [2c 2h] and won ($752.50)
Seat 3: Hero showed [7d 8d] and lost with...



PokerStars Hand #3955289329:  Hold'em No Limit ($2.50/$5) - 2020/06/03 14:41:56 ET
Table 'Zone Poker ID 1612' 9-max Seat #3 is the button
Seat 1: Small Blind ($1295.18 in chips) 
Seat 2: Hero ($513.00 in chips) 
Seat 3: Dealer ($478.57 in chips) 
Small Blind: posts small blind $2.50
Hero: posts big blind $5
*** HOLE CARDS ***
Dealt to Hero [8d 6s]
Dealer: folds 
Small Blind: raises $7.50 to $12.50
Hero: calls $7.50
*** FLOP *** [7s Ks 3s]
Small Blind: checks 
Hero: checks 
*** TURN *** [7s Ks 3s] [6d]
Small Blind: bets $11.88
Hero: calls $11.88
*** RIVER *** [7s Ks 3s 6d] [9s]
Small Blind: bets $15
Hero: calls $15
*** SHOW DOWN ***
Small Blind: shows [Tc 8c] (a hand...)
Dealer: shows [Kd 4h] (a hand...)
Hero: shows [8d 6s] (a hand...)
Hero collected $76.76 from pot
*** SUMMARY ***
Total pot $78.76 | Rake $2.00
Board [7s Ks 3s 6d 9s]
Seat 1: Small Blind showed [Tc 8c] and lost with...
Seat 2: Hero showed [8d 6s] and won ($76.76)
Seat 3: Dealer folded



PokerStars Hand #3955288833:  Hold'em No Limit ($2.50/$5) - 2020/06/03 14:40:34 ET
Table 'Zone Poker ID 1612' 9-max Seat #2 is the button
Seat 1: Big Blind ($757.78 in chips) 
Seat 2: Hero ($480.00 in chips) 
Seat 3: Small Blind ($1167.82 in chips) 
Small Blind: posts small blind $2.50
Big Blind: posts big blind $5
*** HOLE CARDS ***
Dealt to Hero [7s 7c]
Hero: raises $7.50 to $12.50
Small Blind: folds 
Big Blind: calls $7.50
*** FLOP *** [3d Kd 8c]
Big Blind: checks 
Hero: bets $7.84
Big Blind: calls $7.84
*** TURN *** [3d Kd 8c] [5c]
Big Blind: checks 
Hero: checks 
*** RIVER *** [3d Kd 8c 5c] [3h]
Big Blind: bets $10.59
Hero: calls $10.59
*** SHOW DOWN ***
Small Blind: shows [Ad 2s] (a hand...)
Big Blind: shows [Ac 8s] (a hand...)
Hero: shows [7s 7c] (a hand...)
Big Blind collected $62.36 from pot
*** SUMMARY ***
Total pot $64.36 | Rake $2.00
Board [3d Kd 8c 5c 3h]
Seat 1: Big Blind showed [Ac 8s] and won ($62.36)
Seat 2: Hero showed [7s 7c] and lost with...
Seat 3: Small Blind folded



PokerStars Hand #3954941281:  Hold'em No Limit ($2.50/$5) - 2020/06/02 19:48:49 ET
Table 'Zone Poker ID 1588' 9-max Seat #2 is the button
Seat 1: Big Blind ($1138.83 in chips) 
Seat 2: Hero ($1723.57 in chips) 
Seat 3: Small Blind ($571.05 in chips) 
Small Blind: posts small blind $2.50
Big Blind: posts big blind $5
*** HOLE CARDS ***
Dealt to Hero [9s 7s]
Hero: raises $7.50 to $12.50
Small Blind: raises $37.50 to $50
Big Blind: folds 
Hero: calls $37.50
*** FLOP *** [9h 6d Jd]
Small Blind: bets $51.50
Hero: calls $51.50
*** TURN *** [9h 6d Jd] [Ts]
Small Blind: bets $78
Hero: calls $78
*** RIVER *** [9h 6d Jd Ts] [7h]
Small Blind: bets $391.55 and is all-in
Hero: calls $391.55
*** SHOW DOWN ***
Small Blind: shows [Qd As] (a hand...)
Big Blind: shows [8h Td] (a hand...)
Hero: shows [9s 7s] (a hand...)
Hero collected $1145.10 from pot
*** SUMMARY ***
Total pot $1147.10 | Rake $2.00
Board [9h 6d Jd Ts 7h]
Seat 1: Big Blind folded
Seat 2: Hero showed [9s 7s] and won ($1145.10)
Seat 3: Small Blind showed [Qd As] and lost with...



PokerStars Hand #3954940956:  Hold'em No Limit ($2.50/$5) - 2020/06/02 19:48:05 ET
Table 'Zone Poker ID 1588' 9-max Seat #2 is the button
Seat 1: Big Blind ($1252.41 in chips) 
Seat 2: Dealer ($1121.33 in chips) 
Seat 3: Hero ($586.93 in chips) 
Hero: posts small blind $2.50
Big Blind: posts big blind $5
*** HOLE CARDS ***
Dealt to Hero [8s Ad]
Dealer: folds 
Hero: raises $10.00 to $15
Big Blind: calls $10
*** FLOP *** [9d Th Ah]
Hero: checks 
Big Blind: bets $9.25
Hero: calls $9.25
*** TURN *** [9d Th Ah] [8c]
Hero: checks 
Big Blind: bets $34.88
Hero: calls $34.88
*** RIVER *** [9d Th Ah 8c] [7c]
Hero: checks 
Big Blind: bets $116.26
Hero: folds 
*** SHOW DOWN ***
Dealer: shows [2h Qd] (a hand...)
Big Blind: shows [Js Kd] (a hand...)
Hero: shows [8s Ad] (a hand...)
Uncalled bet ($116.26) returned to Big Blind
Big Blind collected $116.26 from pot
*** SUMMARY ***
Total pot $118.26 | Rake $2.00
Board [9d Th Ah 8c 7c]
Seat 1: Big Blind collected ($116.26)
Seat 2: Dealer folded
Seat 3: Hero folded



PokerStars Hand #3954940501:  Hold'em No Limit ($2.50/$5) - 2020/06/02 19:47:02 ET
Table 'Zone Poker ID 1588' 9-max Seat #2 is the button
Seat 1: UTG+1 ($917.09 in chips) 
Seat 2: Hero ($1688.07 in chips) 
Seat 3: Small Blind ($753.12 in chips) 
Seat 4: Big Blind ($830.77 in chips) 
Seat 5: UTG ($1064.50 in chips) 
Small Blind: posts small blind $2.50
Big Blind: posts big blind $5
*** HOLE CARDS ***
Dealt to Hero [4s Ac]
UTG: folds 
UTG+1: folds 
Hero: raises $7.50 to $12.50
Small Blind: calls $10
Big Blind: folds 
*** FLOP *** [6s Ad 9c]
Small Blind: checks 
Hero: checks 
*** TURN *** [6s Ad 9c] [Kc]
Small Blind: bets $15
Hero: calls $15
*** RIVER *** [6s Ad 9c Kc] [2s]
Small Blind: bets $18.50
Hero: calls $18.50
*** SHOW DOWN ***
Small Blind: shows [4c Th] (a hand...)
Big Blind: shows [Ks Kd] (a hand...)
Hero: shows [4s Ac] (a hand...)
UTG: shows [Jh 8s] (a hand...)
UTG+1: shows [8c 7h] (a hand...)
Hero collected $94 from pot
*** SUMMARY ***
Total pot $97.00 | Rake $3.00
Board [6s Ad 9c Kc 2s]
Seat 1: UTG+1 folded
Seat 2: Hero showed [4s Ac] and won ($94)
Seat 3: Small Blind showed [4c Th] and lost with...
Seat 4: Big Blind folded
Seat 5: UTG folded



PokerStars Hand #3954932927:  Hold'em No Limit ($2.50/$5) - 2020/06/02 19:30:37 ET
Table 'Zone Poker ID 1588' 9-max Seat #4 is the button
Seat 1: Big Blind ($980.96 in chips) 
Seat 2: UTG ($1617.99 in chips) 
Seat 3: UTG+1 ($495.00 in chips) 
Seat 4: Hero ($529.48 in chips) 
Seat 5: Small Blind ($512.50 in chips) 
Small Blind: posts small blind $2.50
Big Blind: posts big blind $5
*** HOLE CARDS ***
Dealt to Hero [Ad 4d]
UTG: folds 
UTG+1: folds 
Hero: raises $7.50 to $12.50
Small Blind: folds 
Big Blind: calls $7.50
*** FLOP *** [Js 6h Td]
Big Blind: checks 
Hero: bets $20
Big Blind: calls $20
*** TURN *** [Js 6h Td] [7d]
Big Blind: bets $22.25
Hero: calls $22.25
*** RIVER *** [Js 6h Td 7d] [4c]
Big Blind: bets $159
Hero: folds 
*** SHOW DOWN ***
Small Blind: shows [2c Qh] (a hand...)
Big Blind: shows [9h Kh] (a hand...)
Hero: shows [Ad 4d] (a hand...)
UTG: shows [2s Ah] (a hand...)
UTG+1: shows [9c 8s] (a hand...)
Uncalled bet ($159.00) returned to Big Blind
Big Blind collected $109 from pot
*** SUMMARY ***
Total pot $112.00 | Rake $3.00
Board [Js 6h Td 7d 4c]
Seat 1: Big Blind collected ($109)
Seat 2: UTG folded
Seat 3: UTG+1 folded
Seat 4: Hero folded
Seat 5: Small Blind folded



PokerStars Hand #3954932680:  Hold'em No Limit ($2.50/$5) - 2020/06/02 19:30:05 ET
Table 'Zone Poker ID 1588' 9-max Seat #3 is the button
Seat 1: UTG+1 ($507.50 in chips) 
Seat 2: UTG+2 ($247.58 in chips) 
Seat 3: Dealer ($253.29 in chips) 
Seat 4: Small Blind ($561.18 in chips) 
Seat 5: Hero ($594.50 in chips) 
Seat 6: UTG ($2753.33 in chips) 
Small Blind: posts small blind $2.50
Hero: posts big blind $5
*** HOLE CARDS ***
Dealt to Hero [Qc 8c]
UTG: raises $10 to $15
UTG+1: folds 
UTG+2: folds 
Dealer: folds 
Small Blind: folds 
Hero: calls $10
*** FLOP *** [7c 5d 7d]
Hero: checks 
UTG: checks 
*** TURN *** [7c 5d 7d] [Ts]
Hero: bets $20
UTG: calls $20
*** RIVER *** [7c 5d 7d Ts] [Kc]
Hero: checks 
UTG: bets $34.44
Hero: folds 
*** SHOW DOWN ***
Small Blind: shows [3s 7h] (a hand...)
Hero: shows [Qc 8c] (a hand...)
Dealer: shows [Tc 2h] (a hand...)
UTG+2: shows [5h 4h] (a hand...)
UTG: shows [As 8s] (a hand...)
UTG+1: shows [Th Jc] (a hand...)
Uncalled bet ($34.44) returned to UTG
UTG collected $68.88 from pot
*** SUMMARY ***
Total pot $72.50 | Rake $3.62
Board [7c 5d 7d Ts Kc]
Seat 1: UTG+1 folded
Seat 2: UTG+2 folded
Seat 3: Dealer folded
Seat 4: Small Blind folded
Seat 5: Hero folded
Seat 6: UTG collected ($68.88)



PokerStars Hand #3954928754:  Hold'em No Limit ($2.50/$5) - 2020/06/02 19:21:38 ET
Table 'Zone Poker ID 1588' 9-max Seat #1 is the button
Seat 1: Hero ($500.00 in chips) 
Seat 2: Small Blind ($562.00 in chips) 
Seat 3: Big Blind ($739.07 in chips) 
Seat 4: UTG ($746.08 in chips) 
Seat 5: UTG+1 ($649.13 in chips) 
Small Blind: posts small blind $2.50
Big Blind: posts big blind $5
*** HOLE CARDS ***
Dealt to Hero [Ad Jc]
UTG: folds 
UTG+1: folds 
Hero: raises $7.50 to $12.50
Small Blind: folds 
Big Blind: raises $39.50 to $52
Hero: calls $39.50
*** FLOP *** [3s 7h Ah]
Big Blind: bets $35
Hero: calls $35
*** TURN *** [3s 7h Ah] [Qh]
Big Blind: checks 
Hero: checks 
*** RIVER *** [3s 7h Ah Qh] [Td]
Big Blind: bets $125
Hero: calls $125
*** SHOW DOWN ***
Small Blind: shows [Qd Ts] (a hand...)
Big Blind: shows [5d 6d] (a hand...)
Hero: shows [Ad Jc] (a hand...)
UTG: shows [2c Tc] (a hand...)
UTG+1: shows [2h Jh] (a hand...)
Hero collected $423.50 from pot
*** SUMMARY ***
Total pot $426.50 | Rake $3.00
Board [3s 7h Ah Qh Td]
Seat 1: Hero showed [Ad Jc] and won ($423.50)
Seat 2: Small Blind folded
Seat 3: Big Blind showed [5d 6d] and lost with...
Seat 4: UTG folded
Seat 5: UTG+1 folded



PokerStars Hand #3954928371:  Hold'em No Limit ($2.50/$5) - 2020/06/02 19:20:48 ET
Table 'Zone Poker ID 1588' 9-max Seat #5 is the button
Seat 1: Small Blind ($564.50 in chips) 
Seat 2: Big Blind ($500.00 in chips) 
Seat 3: UTG ($2421.45 in chips) 
Seat 4: UTG+1 ($1502.36 in chips) 
Seat 5: Hero ($523.50 in chips) 
Small Blind: posts small blind $2.50
Big Blind: posts big blind $5
*** HOLE CARDS ***
Dealt to Hero [3s As]
UTG: calls $5
UTG+1: folds 
Hero: raises $15 to $20
Small Blind: folds 
Big Blind: folds 
UTG: calls $15
*** FLOP *** [4h 9s Tc]
UTG: checks 
Hero: checks 
*** TURN *** [4h 9s Tc] [7s]
UTG: bets $12.57
Hero: calls $12.57
*** RIVER *** [4h 9s Tc 7s] [5h]
UTG: bets $52.23
Hero: folds 
*** SHOW DOWN ***
Small Blind: shows [Jd 5d] (a hand...)
Big Blind: shows [6h 9c] (a hand...)
Hero: shows [3s As] (a hand...)
UTG: shows [Kd Kc] (a hand...)
UTG+1: shows [Td 8s] (a hand...)
Uncalled bet ($52.23) returned to UTG
UTG collected $69.64 from pot
*** SUMMARY ***
Total pot $72.64 | Rake $3.00
Board [4h 9s Tc 7s 5h]
Seat 1: Small Blind folded
Seat 2: Big Blind folded
Seat 3: UTG collected ($69.64)
Seat 4: UTG+1 folded
Seat 5: Hero folded



PokerStars Hand #3954928214:  Hold'em No Limit ($2.50/$5) - 2020/06/02 19:20:28 ET
Table 'Zone Poker ID 1588' 9-max Seat #3 is the button
Seat 1: UTG ($1358.48 in chips) 
Seat 2: UTG+1 ($592.34 in chips) 
Seat 3: Hero ($502.50 in chips) 
Seat 4: Small Blind ($575.50 in chips) 
Seat 5: Big Blind ($199.23 in chips) 
Small Blind: posts small blind $2.50
Big Blind: posts big blind $5
*** HOLE CARDS ***
Dealt to Hero [9d Js]
UTG: folds 
UTG+1: folds 
Hero: raises $7.50 to $12.50
Small Blind: folds 
Big Blind: calls $7.50
*** FLOP *** [4c Jd 7s]
Big Blind: checks 
Hero: bets $7.84
Big Blind: calls $7.84
*** TURN *** [4c Jd 7s] [Qd]
Big Blind: checks 
Hero: checks 
*** RIVER *** [4c Jd 7s Qd] [Td]
Big Blind: bets $30.77
Hero: calls $30.77
*** SHOW DOWN ***
Small Blind: shows [2c 9h] (a hand...)
Big Blind: shows [Th 7h] (a hand...)
Hero: shows [9d Js] (a hand...)
UTG: shows [4h 8h] (a hand...)
UTG+1: shows [7d 8c] (a hand...)
Big Blind collected $101.72 from pot
*** SUMMARY ***
Total pot $104.72 | Rake $3.00
Board [4c Jd 7s Qd Td]
Seat 1: UTG folded
Seat 2: UTG+1 folded
Seat 3: Hero showed [9d Js] and lost with...
Seat 4: Small Blind folded
Seat 5: Big Blind showed [Th 7h] and won ($101.72)



PokerStars Hand #3952812800:  Hold'em No Limit ($2.50/$5) - 2020/05/29 16:46:07 ET
Table 'Zone Poker ID 1588' 9-max Seat #4 is the button
Seat 1: Small Blind ($1307.50 in chips) 
Seat 2: Hero ($678.25 in chips) 
Seat 3: UTG ($522.00 in chips) 
Seat 4: Dealer ($382.84 in chips) 
Small Blind: posts small blind $2.50
Hero: posts big blind $5
*** HOLE CARDS ***
Dealt to Hero [Ac 8c]
UTG: raises $7.50 to $12.50
Dealer: folds 
Small Blind: folds 
Hero: calls $7.50
*** FLOP *** [4h Jc 5s]
Hero: checks 
UTG: bets $8.07
Hero: raises $26.65 to $34.72
UTG: calls $26.65
*** TURN *** [4h Jc 5s] [Js]
Hero: checks 
UTG: checks 
*** RIVER *** [4h Jc 5s Js] [7h]
Hero: checks 
UTG: bets $36.97
Hero: folds 
*** SHOW DOWN ***
Small Blind: shows [3c Kc] (a hand...)
UTG: shows [Kh Kd] (a hand...)
Dealer: shows [4s 5h] (a hand...)
Hero: shows [Ac 8c] (a hand...)
Uncalled bet ($36.97) returned to UTG
UTG collected $93.94 from pot
*** SUMMARY ***
Total pot $96.94 | Rake $3.00
Board [4h Jc 5s Js 7h]
Seat 1: Small Blind folded
Seat 2: Hero folded
Seat 3: UTG collected ($93.94)
Seat 4: Dealer folded



PokerStars Hand #3952811297:  Hold'em No Limit ($2.50/$5) - 2020/05/29 16:42:42 ET
Table 'Zone Poker ID 1588' 9-max Seat #2 is the button
Seat 1: Hero ($507.50 in chips) 
Seat 2: Dealer ($541.07 in chips) 
Seat 3: Small Blind ($1355.51 in chips) 
Small Blind: posts small blind $2.50
Hero: posts big blind $5
*** HOLE CARDS ***
Dealt to Hero [7s Th]
Dealer: folds 
Small Blind: raises $7.50 to $12.50
Hero: calls $7.50
*** FLOP *** [Js Td 6c]
Small Blind: checks 
Hero: checks 
*** TURN *** [Js Td 6c] [5d]
Small Blind: bets $11.88
Hero: calls $11.88
*** RIVER *** [Js Td 6c 5d] [2h]
Small Blind: bets $23.38
Hero: calls $23.38
*** SHOW DOWN ***
Small Blind: shows [9c 4h] (a hand...)
Dealer: shows [3c 9s] (a hand...)
Hero: shows [7s Th] (a hand...)
Hero collected $93.52 from pot
*** SUMMARY ***
Total pot $95.52 | Rake $2.00
Board [Js Td 6c 5d 2h]
Seat 1: Hero showed [7s Th] and won ($93.52)
Seat 2: Dealer folded
Seat 3: Small Blind showed [9c 4h] and lost with...



PokerStars Hand #3952809982:  Hold'em No Limit ($2.50/$5) - 2020/05/29 16:39:32 ET
Table 'Zone Poker ID 1588' 9-max Seat #2 is the button
Seat 1: Big Blind ($1237.21 in chips) 
Seat 2: Hero ($554.75 in chips) 
Seat 3: Small Blind ($364.50 in chips) 
Small Blind: posts small blind $2.50
Big Blind: posts big blind $5
*** HOLE CARDS ***
Dealt to Hero [Js 9c]
Hero: raises $7.50 to $12.50
Small Blind: folds 
Big Blind: calls $7.50
*** FLOP *** [Jd 6h 8d]
Big Blind: checks 
Hero: checks 
*** TURN *** [Jd 6h 8d] [Qc]
Big Blind: bets $9
Hero: calls $9
*** RIVER *** [Jd 6h 8d Qc] [4s]
Big Blind: bets $32.63
Hero: calls $32.63
*** SHOW DOWN ***
Small Blind: shows [4h Kd] (a hand...)
Big Blind: shows [Qd Ts] (a hand...)
Hero: shows [Js 9c] (a hand...)
Big Blind collected $108.76 from pot
*** SUMMARY ***
Total pot $110.76 | Rake $2.00
Board [Jd 6h 8d Qc 4s]
Seat 1: Big Blind showed [Qd Ts] and won ($108.76)
Seat 2: Hero showed [Js 9c] and lost with...
Seat 3: Small Blind folded



PokerStars Hand #3952807396:  Hold'em No Limit ($2.50/$5) - 2020/05/29 16:33:17 ET
Table 'Zone Poker ID 1588' 9-max Seat #3 is the button
Seat 1: Small Blind ($1412.50 in chips) 
Seat 2: Hero ($453.25 in chips) 
Seat 3: Dealer ($483.00 in chips) 
Small Blind: posts small blind $2.50
Hero: posts big blind $5
*** HOLE CARDS ***
Dealt to Hero [8d 6s]
Dealer: folds 
Small Blind: raises $7.50 to $12.50
Hero: calls $7.50
*** FLOP *** [Tc 5d 8c]
Small Blind: checks 
Hero: checks 
*** TURN *** [Tc 5d 8c] [Th]
Small Blind: bets $11.88
Hero: calls $11.88
*** RIVER *** [Tc 5d 8c Th] [Kd]
Small Blind: bets $23.38
Hero: calls $23.38
*** SHOW DOWN ***
Small Blind: shows [9s 2h] (a hand...)
Dealer: shows [5s Ks] (a hand...)
Hero: shows [8d 6s] (a hand...)
Hero collected $93.52 from pot
*** SUMMARY ***
Total pot $95.52 | Rake $2.00
Board [Tc 5d 8c Th Kd]
Seat 1: Small Blind showed [9s 2h] and lost with...
Seat 2: Hero showed [8d 6s] and won ($93.52)
Seat 3: Dealer folded



PokerStars Hand #3952338338:  Hold'em No Limit ($2.50/$5) - 2020/05/28 19:07:35 ET
Table 'Zone Poker ID 1588' 9-max Seat #2 is the button
Seat 1: Big Blind ($500.96 in chips) 
Seat 2: Hero ($594.50 in chips) 
Seat 3: Small Blind ($414.19 in chips) 
Small Blind: posts small blind $2.50
Big Blind: posts big blind $5
*** HOLE CARDS ***
Dealt to Hero [7c Ad]
Hero: raises $7.50 to $12.50
Small Blind: folds 
Big Blind: calls $7.50
*** FLOP *** [Jd 4d 5h]
Big Blind: checks 
Hero: bets $7.84
Big Blind: calls $7.84
*** TURN *** [Jd 4d 5h] [4h]
Big Blind: checks 
Hero: checks 
*** RIVER *** [Jd 4d 5h 4h] [3c]
Big Blind: bets $80
Hero: folds 
*** SHOW DOWN ***
Small Blind: shows [Kd 5d] (a hand...)
Big Blind: shows [3d 3h] (a hand...)
Hero: shows [7c Ad] (a hand...)
Uncalled bet ($80.00) returned to Big Blind
Big Blind collected $41.18 from pot
*** SUMMARY ***
Total pot $43.18 | Rake $2.00
Board [Jd 4d 5h 4h 3c]
Seat 1: Big Blind collected ($41.18)
Seat 2: Hero folded
Seat 3: Small Blind folded



PokerStars Hand #3952337755:  Hold'em No Limit ($2.50/$5) - 2020/05/28 19:06:21 ET
Table 'Zone Poker ID 1588' 9-max Seat #2 is the button
Seat 1: Hero ($485.00 in chips) 
Seat 2: Dealer ($714.76 in chips) 
Seat 3: Small Blind ($403.19 in chips) 
Small Blind: posts small blind $2.50
Hero: posts big blind $5
*** HOLE CARDS ***
Dealt to Hero [8s Jd]
Dealer: folds 
Small Blind: raises $10.00 to $15
Hero: calls $10
*** FLOP *** [Ah 3d 5d]
Small Blind: checks 
Hero: checks 
*** TURN *** [Ah 3d 5d] [Qc]
Small Blind: checks 
Hero: checks 
*** RIVER *** [Ah 3d 5d Qc] [Ac]
Small Blind: bets $14.25
Hero: folds 
*** SHOW DOWN ***
Small Blind: shows [7d 7h] (a hand...)
Dealer: shows [5h Th] (a hand...)
Hero: shows [8s Jd] (a hand...)
Uncalled bet ($14.25) returned to Small Blind
Small Blind collected $28.50 from pot
*** SUMMARY ***
Total pot $30.00 | Rake $1.50
Board [Ah 3d 5d Qc Ac]
Seat 1: Hero folded
Seat 2: Dealer folded
Seat 3: Small Blind collected ($28.50)



PokerStars Hand #3952215899:  Hold'em No Limit ($2.50/$5) - 2020/05/28 14:21:05 ET
Table 'Zone Poker ID 1588' 9-max Seat #1 is the button
Seat 1: Hero ($1004.98 in chips) 
Seat 2: Small Blind ($482.50 in chips) 
Seat 3: Big Blind ($575.44 in chips) 
Small Blind: posts small blind $2.50
Big Blind: posts big blind $5
*** HOLE CARDS ***
Dealt to Hero [8c 7h]
Hero: raises $7.50 to $12.50
Small Blind: folds 
Big Blind: calls $7.50
*** FLOP *** [Tc 2d 4d]
Big Blind: checks 
Hero: checks 
*** TURN *** [Tc 2d 4d] [7d]
Big Blind: bets $9
Hero: calls $9
*** RIVER *** [Tc 2d 4d 7d] [Jd]
Big Blind: bets $32.63
Hero: folds 
*** SHOW DOWN ***
Small Blind: shows [3c 6c] (a hand...)
Big Blind: shows [As 3h] (a hand...)
Hero: shows [8c 7h] (a hand...)
Uncalled bet ($32.63) returned to Big Blind
Big Blind collected $43.50 from pot
*** SUMMARY ***
Total pot $45.50 | Rake $2.00
Board [Tc 2d 4d 7d Jd]
Seat 1: Hero folded
Seat 2: Small Blind folded
Seat 3: Big Blind collected ($43.50)



PokerStars Hand #3952207006:  Hold'em No Limit ($2.50/$5) - 2020/05/28 13:54:39 ET
Table 'Zone Poker ID 1588' 9-max Seat #3 is the button
Seat 1: Small Blind ($495.00 in chips) 
Seat 2: Hero ($475.00 in chips) 
Seat 3: Dealer ($469.50 in chips) 
Small Blind: posts small blind $2.50
Hero: posts big blind $5
*** HOLE CARDS ***
Dealt to Hero [Td 8c]
Dealer: folds 
Small Blind: raises $7.00 to $12
Hero: calls $7
*** FLOP *** [Tc Kd 3c]
Small Blind: checks 
Hero: checks 
*** TURN *** [Tc Kd 3c] [Qs]
Small Blind: bets $11.40
Hero: calls $11.40
*** RIVER *** [Tc Kd 3c Qs] [2d]
Small Blind: bets $15
Hero: folds 
*** SHOW DOWN ***
Small Blind: shows [9d Qc] (a hand...)
Dealer: shows [Ts 5d] (a hand...)
Hero: shows [Td 8c] (a hand...)
Uncalled bet ($15.00) returned to Small Blind
Small Blind collected $44.80 from pot
*** SUMMARY ***
Total pot $46.80 | Rake $2.00
Board [Tc Kd 3c Qs 2d]
Seat 1: Small Blind collected ($44.80)
Seat 2: Hero folded
Seat 3: Dealer folded



PokerStars Hand #3952206052:  Hold'em No Limit ($2.50/$5) - 2020/05/28 13:51:53 ET
Table 'Zone Poker ID 1588' 9-max Seat #2 is the button
Seat 1: Hero ($620.52 in chips) 
Seat 2: Dealer ($286.14 in chips) 
Seat 3: Small Blind ($308.58 in chips) 
Small Blind: posts small blind $2.50
Hero: posts big blind $5
*** HOLE CARDS ***
Dealt to Hero [Qd As]
Dealer: folds 
Small Blind: raises $10.00 to $15
Hero: raises $30 to $45
Small Blind: calls $30
*** FLOP *** [5c 2s 4s]
Small Blind: checks 
Hero: bets $26.40
Small Blind: raises $26.40 to $52.80
Hero: calls $26.40
*** TURN *** [5c 2s 4s] [3h]
Small Blind: checks 
Hero: checks 
*** RIVER *** [5c 2s 4s 3h] [5h]
Small Blind: bets $96.80
Hero: calls $96.80
*** SHOW DOWN ***
Small Blind: shows [4h 4d] (a hand...)
Dealer: shows [5d Qh] (a hand...)
Hero: shows [Qd As] (a hand...)
Small Blind collected $387.20 from pot
*** SUMMARY ***
Total pot $389.20 | Rake $2.00
Board [5c 2s 4s 3h 5h]
Seat 1: Hero showed [Qd As] and lost with...
Seat 2: Dealer folded
Seat 3: Small Blind showed [4h 4d] and won ($387.20)



PokerStars Hand #3952205632:  Hold'em No Limit ($2.50/$5) - 2020/05/28 13:50:39 ET
Table 'Zone Poker ID 1588' 9-max Seat #2 is the button
Seat 1: Hero ($482.50 in chips) 
Seat 2: Dealer ($88.45 in chips) 
Seat 3: Small Blind ($261.13 in chips) 
Small Blind: posts small blind $2.50
Hero: posts big blind $5
*** HOLE CARDS ***
Dealt to Hero [9s 7h]
Dealer: folds 
Small Blind: raises $10.00 to $15
Hero: calls $10
*** FLOP *** [Kc 9h 6c]
Small Blind: bets $28.50
Hero: calls $28.50
*** TURN *** [Kc 9h 6c] [Ks]
Small Blind: bets $49.42
Hero: calls $49.42
*** RIVER *** [Kc 9h 6c Ks] [3c]
Small Blind: bets $168.21 and is all-in
Hero: calls $168.21
*** SHOW DOWN ***
Small Blind: shows [6d Kd] (a hand...)
Dealer: shows [6s Td] (a hand...)
Hero: shows [9s 7h] (a hand...)
Small Blind collected $520.26 from pot
*** SUMMARY ***
Total pot $522.26 | Rake $2.00
Board [Kc 9h 6c Ks 3c]
Seat 1: Hero showed [9s 7h] and lost with...
Seat 2: Dealer folded
Seat 3: Small Blind showed [6d Kd] and won ($520.26)



PokerStars Hand #3951868879:  Hold'em No Limit ($2.50/$5) - 2020/05/27 21:34:28 ET
Table 'Zone Poker ID 1588' 9-max Seat #2 is the button
Seat 1: Big Blind ($497.50 in chips) 
Seat 2: Hero ($1014.71 in chips) 
Seat 3: Small Blind ($5225.73 in chips) 
Small Blind: posts small blind $2.50
Big Blind: posts big blind $5
*** HOLE CARDS ***
Dealt to Hero [Kd 8h]
Hero: raises $7.50 to $12.50
Small Blind: folds 
Big Blind: calls $7.50
*** FLOP *** [8s Qh 9c]
Big Blind: checks 
Hero: checks 
*** TURN *** [8s Qh 9c] [Jd]
Big Blind: checks 
Hero: checks 
*** RIVER *** [8s Qh 9c Jd] [9s]
Big Blind: bets $13.07
Hero: folds 
*** SHOW DOWN ***
Small Blind: shows [7s 2d] (a hand...)
Big Blind: shows [4h Jh] (a hand...)
Hero: shows [Kd 8h] (a hand...)
Uncalled bet ($13.07) returned to Big Blind
Big Blind collected $26.13 from pot
*** SUMMARY ***
Total pot $27.50 | Rake $1.37
Board [8s Qh 9c Jd 9s]
Seat 1: Big Blind collected ($26.13)
Seat 2: Hero folded
Seat 3: Small Blind folded



PokerStars Hand #3951861225:  Hold'em No Limit ($2.50/$5) - 2020/05/27 21:21:17 ET
Table 'Zone Poker ID 1588' 9-max Seat #5 is the button
Seat 1: Small Blind ($580.51 in chips) 
Seat 2: Big Blind ($339.02 in chips) 
Seat 3: UTG ($703.59 in chips) 
Seat 4: UTG+1 ($513.80 in chips) 
Seat 5: Hero ($486.77 in chips) 
Small Blind: posts small blind $2.50
Big Blind: posts big blind $5
*** HOLE CARDS ***
Dealt to Hero [5c 7c]
UTG: folds 
UTG+1: raises $5 to $10
Hero: calls $10
Small Blind: calls $7.50
Big Blind: folds 
*** FLOP *** [7s Qd Kc]
Small Blind: checks 
UTG+1: checks 
Hero: checks 
*** TURN *** [7s Qd Kc] [9d]
Small Blind: checks 
UTG+1: checks 
Hero: checks 
*** RIVER *** [7s Qd Kc 9d] [Qc]
Small Blind: checks 
UTG+1: bets $24.94
Hero: folds 
Small Blind: folds 
*** SHOW DOWN ***
Small Blind: shows [2h 2s] (a hand...)
Big Blind: shows [Ks 8c] (a hand...)
Hero: shows [5c 7c] (a hand...)
UTG: shows [8s Js] (a hand...)
UTG+1: shows [6h Qh] (a hand...)
Uncalled bet ($24.94) returned to UTG+1
UTG+1 collected $33.25 from pot
*** SUMMARY ***
Total pot $35.00 | Rake $1.75
Board [7s Qd Kc 9d Qc]
Seat 1: Small Blind folded
Seat 2: Big Blind folded
Seat 3: UTG folded
Seat 4: UTG+1 collected ($33.25)
Seat 5: Hero folded



PokerStars Hand #3951850691:  Hold'em No Limit ($2.50/$5) - 2020/05/27 21:03:17 ET
Table 'Zone Poker ID 1588' 9-max Seat #4 is the button
Seat 1: UTG ($487.27 in chips) 
Seat 2: UTG+1 ($543.88 in chips) 
Seat 3: UTG+2 ($505.70 in chips) 
Seat 4: Hero ($511.75 in chips) 
Seat 5: Small Blind ($254.90 in chips) 
Seat 6: Big Blind ($613.66 in chips) 
Small Blind: posts small blind $2.50
Big Blind: posts big blind $5
*** HOLE CARDS ***
Dealt to Hero [Ah Kh]
UTG: folds 
UTG+1: raises $7.50 to $12.50
UTG+2: folds 
Hero: raises $27.50 to $40
Small Blind: folds 
Big Blind: folds 
UTG+1: raises $60.00 to $100
Hero: calls $60
*** FLOP *** [6d 2s 4s]
UTG+1: checks 
Hero: checks 
*** TURN *** [6d 2s 4s] [Kd]
UTG+1: bets $101.75
Hero: calls $101.75
*** RIVER *** [6d 2s 4s Kd] [6c]
UTG+1: bets $100
Hero: calls $100
*** SHOW DOWN ***
Small Blind: shows [7c 6h] (a hand...)
Big Blind: shows [3s Js] (a hand...)
Hero: shows [Ah Kh] (a hand...)
UTG+2: shows [8h Jc] (a hand...)
UTG: shows [3d Tc] (a hand...)
UTG+1: shows [Qs Ks] (a hand...)
Hero collected $607 from pot
*** SUMMARY ***
Total pot $611.00 | Rake $4.00
Board [6d 2s 4s Kd 6c]
Seat 1: UTG folded
Seat 2: UTG+1 showed [Qs Ks] and lost with...
Seat 3: UTG+2 folded
Seat 4: Hero showed [Ah Kh] and won ($607)
Seat 5: Small Blind folded
Seat 6: Big Blind folded



PokerStars Hand #3951847215:  Hold'em No Limit ($2.50/$5) - 2020/05/27 20:57:11 ET
Table 'Zone Poker ID 1588' 9-max Seat #2 is the button
Seat 1: UTG+2 ($596.60 in chips) 
Seat 2: Dealer ($500.00 in chips) 
Seat 3: Small Blind ($491.00 in chips) 
Seat 4: Hero ($500.00 in chips) 
Seat 5: UTG ($125.45 in chips) 
Seat 6: UTG+1 ($528.20 in chips) 
Small Blind: posts small blind $2.50
Hero: posts big blind $5
*** HOLE CARDS ***
Dealt to Hero [6h Ah]
UTG: folds 
UTG+1: folds 
UTG+2: folds 
Dealer: raises $7.50 to $12.50
Small Blind: folds 
Hero: calls $7.50
*** FLOP *** [6s As 5s]
Hero: checks 
Dealer: checks 
*** TURN *** [6s As 5s] [3h]
Hero: bets $19.60
Dealer: raises $55.33 to $74.93
Hero: calls $55.33
*** RIVER *** [6s As 5s 3h] [3d]
Hero: checks 
Dealer: bets $95.66
Hero: calls $95.66
*** SHOW DOWN ***
Small Blind: shows [Ac 2d] (a hand...)
Hero: shows [6h Ah] (a hand...)
Dealer: shows [Qs 3s] (a hand...)
UTG+2: shows [6d 8h] (a hand...)
UTG: shows [5d Ad] (a hand...)
UTG+1: shows [Jd 8d] (a hand...)
Dealer collected $364.68 from pot
*** SUMMARY ***
Total pot $368.68 | Rake $4.00
Board [6s As 5s 3h 3d]
Seat 1: UTG+2 folded
Seat 2: Dealer showed [Qs 3s] and won ($364.68)
Seat 3: Small Blind folded
Seat 4: Hero showed [6h Ah] and lost with...
Seat 5: UTG folded
Seat 6: UTG+1 folded



PokerStars Hand #3951728461:  Hold'em No Limit ($2.50/$5) - 2020/05/27 16:54:33 ET
Table 'Zone Poker ID 1588' 9-max Seat #5 is the button
Seat 1: Small Blind ($247.50 in chips) 
Seat 2: Big Blind ($500.00 in chips) 
Seat 3: UTG ($673.28 in chips) 
Seat 4: Hero ($499.00 in chips) 
Seat 5: Dealer ($497.50 in chips) 
Small Blind: posts small blind $2.50
Big Blind: posts big blind $5
*** HOLE CARDS ***
Dealt to Hero [8c Jc]
UTG: folds 
Hero: raises $7.50 to $12.50
Dealer: calls $12.50
Small Blind: folds 
Big Blind: calls $7.50
*** FLOP *** [9d 5s 4d]
Big Blind: checks 
Hero: checks 
Dealer: checks 
*** TURN *** [9d 5s 4d] [Js]
Big Blind: checks 
Hero: checks 
Dealer: bets $23.50
Big Blind: calls $23.50
Hero: calls $23.50
*** RIVER *** [9d 5s 4d Js] [Ks]
Big Blind: checks 
Hero: checks 
Dealer: bets $90.63
Big Blind: folds 
Hero: folds 
*** SHOW DOWN ***
Small Blind: shows [7d 3d] (a hand...)
Big Blind: shows [Jd Qs] (a hand...)
Hero: shows [8c Jc] (a hand...)
Dealer: shows [As 2s] (a hand...)
UTG: shows [4c 8h] (a hand...)
Uncalled bet ($90.63) returned to Dealer
Dealer collected $107.50 from pot
*** SUMMARY ***
Total pot $110.50 | Rake $3.00
Board [9d 5s 4d Js Ks]
Seat 1: Small Blind folded
Seat 2: Big Blind folded
Seat 3: UTG folded
Seat 4: Hero folded
Seat 5: Dealer collected ($107.50)



PokerStars Hand #3951678202:  Hold'em No Limit ($2.50/$5) - 2020/05/27 14:56:46 ET
Table 'Zone Poker ID 1588' 9-max Seat #5 is the button
Seat 1: Hero ($500.00 in chips) 
Seat 2: UTG ($518.68 in chips) 
Seat 3: UTG+1 ($500.00 in chips) 
Seat 4: UTG+2 ($642.42 in chips) 
Seat 5: Dealer ($500.00 in chips) 
Seat 6: Small Blind ($609.18 in chips) 
Small Blind: posts small blind $2.50
Hero: posts big blind $5
*** HOLE CARDS ***
Dealt to Hero [Jh Kc]
UTG: folds 
UTG+1: folds 
UTG+2: folds 
Dealer: raises $7.50 to $12.50
Small Blind: folds 
Hero: calls $7.50
*** FLOP *** [4d 9d 4c]
Hero: checks 
Dealer: bets $8.62
Hero: calls $8.62
*** TURN *** [4d 9d 4c] [Ks]
Hero: checks 
Dealer: bets $29.76
Hero: calls $29.76
*** RIVER *** [4d 9d 4c Ks] [Jd]
Hero: checks 
Dealer: bets $189.49
Hero: calls $189.49
*** SHOW DOWN ***
Small Blind: shows [8s 7h] (a hand...)
Hero: shows [Jh Kc] (a hand...)
Dealer: shows [5d Ad] (a hand...)
UTG+2: shows [6h Js] (a hand...)
UTG: shows [2s 9h] (a hand...)
UTG+1: shows [Jc 3d] (a hand...)
Dealer collected $479.24 from pot
*** SUMMARY ***
Total pot $483.24 | Rake $4.00
Board [4d 9d 4c Ks Jd]
Seat 1: Hero showed [Jh Kc] and lost with...
Seat 2: UTG folded
Seat 3: UTG+1 folded
Seat 4: UTG+2 folded
Seat 5: Dealer showed [5d Ad] and won ($479.24)
Seat 6: Small Blind folded



PokerStars Hand #3951676976:  Hold'em No Limit ($2.50/$5) - 2020/05/27 14:53:43 ET
Table 'Zone Poker ID 1588' 9-max Seat #6 is the button
Seat 1: Small Blind ($570.00 in chips) 
Seat 2: Big Blind ($500.00 in chips) 
Seat 3: Hero ($632.63 in chips) 
Seat 4: UTG+1 ($495.00 in chips) 
Seat 5: UTG+2 ($884.54 in chips) 
Seat 6: Dealer ($546.00 in chips) 
Small Blind: posts small blind $2.50
Big Blind: posts big blind $5
*** HOLE CARDS ***
Dealt to Hero [Tc Th]
Hero: raises $7.50 to $12.50
UTG+1: folds 
UTG+2: folds 
Dealer: calls $12.50
Small Blind: folds 
Big Blind: calls $7.50
*** FLOP *** [Kh 2h 8c]
Big Blind: checks 
Hero: checks 
Dealer: bets $20
Big Blind: folds 
Hero: calls $20
*** TURN *** [Kh 2h 8c] [9c]
Hero: checks 
Dealer: checks 
*** RIVER *** [Kh 2h 8c 9c] [3h]
Hero: checks 
Dealer: bets $38
Hero: calls $38
*** SHOW DOWN ***
Small Blind: shows [5s Qd] (a hand...)
Big Blind: shows [6d 5d] (a hand...)
Hero: shows [Tc Th] (a hand...)
UTG+2: shows [6s 4h] (a hand...)
Dealer: shows [3d 2d] (a hand...)
UTG+1: shows [3c Qh] (a hand...)
Dealer collected $152 from pot
*** SUMMARY ***
Total pot $156.00 | Rake $4.00
Board [Kh 2h 8c 9c 3h]
Seat 1: Small Blind folded
Seat 2: Big Blind folded
Seat 3: Hero showed [Tc Th] and lost with...
Seat 4: UTG+1 folded
Seat 5: UTG+2 folded
Seat 6: Dealer showed [3d 2d] and won ($152)



PokerStars Hand #3951674259:  Hold'em No Limit ($2.50/$5) - 2020/05/27 14:46:58 ET
Table 'Zone Poker ID 1588' 9-max Seat #5 is the button
Seat 1: Hero ($612.22 in chips) 
Seat 2: UTG ($1795.90 in chips) 
Seat 3: UTG+1 ($652.58 in chips) 
Seat 4: UTG+2 ($582.81 in chips) 
Seat 5: Dealer ($574.61 in chips) 
Seat 6: Small Blind ($500.00 in chips) 
Small Blind: posts small blind $2.50
Hero: posts big blind $5
*** HOLE CARDS ***
Dealt to Hero [Kh Ac]
UTG: raises $10 to $15
UTG+1: folds 
UTG+2: folds 
Dealer: folds 
Small Blind: folds 
Hero: calls $10
*** FLOP *** [8d 7d 3c]
Hero: checks 
UTG: bets $15.44
Hero: calls $15.44
*** TURN *** [8d 7d 3c] [Kc]
Hero: checks 
UTG: bets $45.17
Hero: calls $45.17
*** RIVER *** [8d 7d 3c Kc] [2c]
Hero: checks 
UTG: bets $149.72
Hero: calls $149.72
*** SHOW DOWN ***
Small Blind: shows [5s Tc] (a hand...)
Hero: shows [Kh Ac] (a hand...)
Dealer: shows [Ah 9c] (a hand...)
UTG+2: shows [2h 3d] (a hand...)
UTG: shows [7s 7h] (a hand...)
UTG+1: shows [6c Jc] (a hand...)
UTG collected $449.16 from pot
*** SUMMARY ***
Total pot $453.16 | Rake $4.00
Board [8d 7d 3c Kc 2c]
Seat 1: Hero showed [Kh Ac] and lost with...
Seat 2: UTG showed [7s 7h] and won ($449.16)
Seat 3: UTG+1 folded
Seat 4: UTG+2 folded
Seat 5: Dealer folded
Seat 6: Small Blind folded



PokerStars Hand #3951673333:  Hold'em No Limit ($2.50/$5) - 2020/05/27 14:44:36 ET
Table 'Zone Poker ID 1588' 9-max Seat #1 is the button
Seat 1: Hero ($536.00 in chips) 
Seat 2: Small Blind ($504.25 in chips) 
Seat 3: Big Blind ($628.13 in chips) 
Seat 4: UTG ($471.57 in chips) 
Seat 5: UTG+1 ($750.50 in chips) 
Seat 6: UTG+2 ($500.00 in chips) 
Small Blind: posts small blind $2.50
Big Blind: posts big blind $5
*** HOLE CARDS ***
Dealt to Hero [9d 9h]
UTG: calls $5
UTG+1: folds 
UTG+2: folds 
Hero: raises $15 to $20
Small Blind: folds 
Big Blind: folds 
UTG: calls $15
*** FLOP *** [Ah Ad 3h]
UTG: checks 
Hero: bets $15
UTG: calls $15
*** TURN *** [Ah Ad 3h] [6s]
UTG: checks 
Hero: checks 
*** RIVER *** [Ah Ad 3h 6s] [7h]
UTG: bets $55.22
Hero: calls $55.22
*** SHOW DOWN ***
Small Blind: shows [4s 6c] (a hand...)
Big Blind: shows [Jh 6h] (a hand...)
Hero: shows [9d 9h] (a hand...)
UTG+2: shows [6d Kd] (a hand...)
UTG: shows [2s 2d] (a hand...)
UTG+1: shows [3d 2h] (a hand...)
Hero collected $183.94 from pot
*** SUMMARY ***
Total pot $187.94 | Rake $4.00
Board [Ah Ad 3h 6s 7h]
Seat 1: Hero showed [9d 9h] and won ($183.94)
Seat 2: Small Blind folded
Seat 3: Big Blind folded
Seat 4: UTG showed [2s 2d] and lost with...
Seat 5: UTG+1 folded
Seat 6: UTG+2 folded



PokerStars Hand #3951672019:  Hold'em No Limit ($2.50/$5) - 2020/05/27 14:41:14 ET
Table 'Zone Poker ID 1588' 9-max Seat #1 is the button
Seat 1: Hero ($487.50 in chips) 
Seat 2: Small Blind ($996.61 in chips) 
Seat 3: Big Blind ($1392.24 in chips) 
Seat 4: UTG ($461.57 in chips) 
Seat 5: UTG+1 ($562.34 in chips) 
Seat 6: UTG+2 ($1377.17 in chips) 
Small Blind: posts small blind $2.50
Big Blind: posts big blind $5
*** HOLE CARDS ***
Dealt to Hero [6d 6h]
UTG: folds 
UTG+1: folds 
UTG+2: raises $7.50 to $12.50
Hero: raises $27.50 to $40
Small Blind: folds 
Big Blind: calls $35
UTG+2: folds 
*** FLOP *** [7c Kc Qh]
Big Blind: checks 
Hero: checks 
*** TURN *** [7c Kc Qh] [7h]
Big Blind: bets $5
Hero: calls $5
*** RIVER *** [7c Kc Qh 7h] [2h]
Big Blind: bets $5
Hero: calls $5
*** SHOW DOWN ***
Small Blind: shows [Jc 4h] (a hand...)
Big Blind: shows [2d 5d] (a hand...)
Hero: shows [6d 6h] (a hand...)
UTG+2: shows [Qd Kh] (a hand...)
UTG: shows [Td As] (a hand...)
UTG+1: shows [9s 5h] (a hand...)
Hero collected $111 from pot
*** SUMMARY ***
Total pot $115.00 | Rake $4.00
Board [7c Kc Qh 7h 2h]
Seat 1: Hero showed [6d 6h] and won ($111)
Seat 2: Small Blind folded
Seat 3: Big Blind showed [2d 5d] and lost with...
Seat 4: UTG folded
Seat 5: UTG+1 folded
Seat 6: UTG+2 folded



PokerStars Hand #3951671344:  Hold'em No Limit ($2.50/$5) - 2020/05/27 14:39:31 ET
Table 'Zone Poker ID 1588' 9-max Seat #5 is the button
Seat 1: Big Blind ($1366.29 in chips) 
Seat 2: UTG ($490.47 in chips) 
Seat 3: UTG+1 ($494.53 in chips) 
Seat 4: UTG+2 ($1128.77 in chips) 
Seat 5: Hero ($826.93 in chips) 
Seat 6: Small Blind ($500.00 in chips) 
Small Blind: posts small blind $2.50
Big Blind: posts big blind $5
*** HOLE CARDS ***
Dealt to Hero [Qh As]
UTG: folds 
UTG+1: folds 
UTG+2: folds 
Hero: raises $7.50 to $12.50
Small Blind: raises $37.50 to $50
Big Blind: folds 
Hero: calls $37.50
*** FLOP *** [3h 3d Qc]
Small Blind: bets $33.33
Hero: calls $33.33
*** TURN *** [3h 3d Qc] [Ah]
Small Blind: bets $55.88
Hero: calls $55.88
*** RIVER *** [3h 3d Qc Ah] [Ks]
Small Blind: bets $360.79 and is all-in
Hero: calls $360.79
*** SHOW DOWN ***
Small Blind: shows [Jc 9c] (a hand...)
Big Blind: shows [Tc 3c] (a hand...)
Hero: shows [Qh As] (a hand...)
UTG+2: shows [8c 6c] (a hand...)
UTG: shows [5s 8s] (a hand...)
UTG+1: shows [Jh 6s] (a hand...)
Hero collected $1001 from pot
*** SUMMARY ***
Total pot $1005.00 | Rake $4.00
Board [3h 3d Qc Ah Ks]
Seat 1: Big Blind folded
Seat 2: UTG folded
Seat 3: UTG+1 folded
Seat 4: UTG+2 folded
Seat 5: Hero showed [Qh As] and won ($1001)
Seat 6: Small Blind showed [Jc 9c] and lost with...



PokerStars Hand #3951653884:  Hold'em No Limit ($2.50/$5) - 2020/05/27 13:53:12 ET
Table 'Zone Poker ID 1588' 9-max Seat #6 is the button
Seat 1: Small Blind ($722.40 in chips) 
Seat 2: Big Blind ($500.00 in chips) 
Seat 3: Hero ($637.77 in chips) 
Seat 4: UTG+1 ($489.06 in chips) 
Seat 5: UTG+2 ($762.57 in chips) 
Seat 6: Dealer ($500.00 in chips) 
Small Blind: posts small blind $2.50
Big Blind: posts big blind $5
*** HOLE CARDS ***
Dealt to Hero [Js Ts]
Hero: raises $7.50 to $12.50
UTG+1: raises $30.00 to $42.50
UTG+2: folds 
Dealer: folds 
Small Blind: folds 
Big Blind: folds 
Hero: calls $30
*** FLOP *** [7d 8c Jc]
Hero: checks 
UTG+1: bets $30.50
Hero: calls $30.50
*** TURN *** [7d 8c Jc] [4d]
Hero: checks 
UTG+1: bets $101.50
Hero: calls $101.50
*** RIVER *** [7d 8c Jc 4d] [Qh]
Hero: checks 
UTG+1: bets $314.56 and is all-in
Hero: folds 
*** SHOW DOWN ***
Small Blind: shows [8d Th] (a hand...)
Big Blind: shows [8s 7c] (a hand...)
Hero: shows [Js Ts] (a hand...)
UTG+2: shows [4s Ac] (a hand...)
Dealer: shows [6s 8h] (a hand...)
UTG+1: shows [Kd Td] (a hand...)
Uncalled bet ($314.56) returned to UTG+1
UTG+1 collected $352.50 from pot
*** SUMMARY ***
Total pot $356.50 | Rake $4.00
Board [7d 8c Jc 4d Qh]
Seat 1: Small Blind folded
Seat 2: Big Blind folded
Seat 3: Hero folded
Seat 4: UTG+1 collected ($352.50)
Seat 5: UTG+2 folded
Seat 6: Dealer folded



PokerStars Hand #3951653688:  Hold'em No Limit ($2.50/$5) - 2020/05/27 13:52:41 ET
Table 'Zone Poker ID 1588' 9-max Seat #1 is the button
Seat 1: Dealer ($515.07 in chips) 
Seat 2: Hero ($568.02 in chips) 
Seat 3: Big Blind ($500.00 in chips) 
Seat 4: UTG ($526.07 in chips) 
Seat 5: UTG+1 ($500.00 in chips) 
Seat 6: UTG+2 ($500.00 in chips) 
Hero: posts small blind $2.50
Big Blind: posts big blind $5
*** HOLE CARDS ***
Dealt to Hero [Ad Ac]
UTG: folds 
UTG+1: raises $7.50 to $12.50
UTG+2: folds 
Dealer: folds 
Hero: raises $42.50 to $55
Big Blind: folds 
UTG+1: calls $42.50
*** FLOP *** [5d Tc 5s]
Hero: bets $33.30
UTG+1: calls $33.30
*** TURN *** [5d Tc 5s] [2c]
Hero: checks 
UTG+1: bets $88.80
Hero: calls $88.80
*** RIVER *** [5d Tc 5s 2c] [Qd]
Hero: checks 
UTG+1: bets $322.90 and is all-in
Hero: calls $322.90
*** SHOW DOWN ***
Big Blind: shows [8s 9h] (a hand...)
Hero: shows [Ad Ac] (a hand...)
Dealer: shows [3d 7c] (a hand...)
UTG+2: shows [Jc Ks] (a hand...)
UTG: shows [Jd 4c] (a hand...)
UTG+1: shows [Th Td] (a hand...)
UTG+1 collected $1001 from pot
*** SUMMARY ***
Total pot $1005.00 | Rake $4.00
Board [5d Tc 5s 2c Qd]
Seat 1: Dealer folded
Seat 2: Hero showed [Ad Ac] and lost with...
Seat 3: Big Blind folded
Seat 4: UTG folded
Seat 5: UTG+1 showed [Th Td] and won ($1001)
Seat 6: UTG+2 folded



PokerStars Hand #3951652126:  Hold'em No Limit ($2.50/$5) - 2020/05/27 13:48:30 ET
Table 'Zone Poker ID 1588' 9-max Seat #6 is the button
Seat 1: Small Blind ($570.45 in chips) 
Seat 2: Big Blind ($901.47 in chips) 
Seat 3: UTG ($500.00 in chips) 
Seat 4: Hero ($870.02 in chips) 
Seat 5: UTG+2 ($585.19 in chips) 
Seat 6: Dealer ($517.50 in chips) 
Small Blind: posts small blind $2.50
Big Blind: posts big blind $5
*** HOLE CARDS ***
Dealt to Hero [As Qs]
UTG: folds 
Hero: raises $7.50 to $12.50
UTG+2: folds 
Dealer: folds 
Small Blind: folds 
Big Blind: raises $47.50 to $60
Hero: calls $47.50
*** FLOP *** [6s Qh 2s]
Big Blind: bets $40
Hero: calls $40
*** TURN *** [6s Qh 2s] [Jd]
Big Blind: bets $158.88
Hero: calls $158.88
*** RIVER *** [6s Qh 2s Jd] [Kd]
Big Blind: bets $642.59 and is all-in
Hero: folds 
*** SHOW DOWN ***
Small Blind: shows [7d Th] (a hand...)
Big Blind: shows [Tc Ac] (a hand...)
Hero: shows [As Qs] (a hand...)
UTG+2: shows [8h 7h] (a hand...)
Dealer: shows [3d 4c] (a hand...)
UTG: shows [6d Ts] (a hand...)
Uncalled bet ($642.59) returned to Big Blind
Big Blind collected $516.26 from pot
*** SUMMARY ***
Total pot $520.26 | Rake $4.00
Board [6s Qh 2s Jd Kd]
Seat 1: Small Blind folded
Seat 2: Big Blind collected ($516.26)
Seat 3: UTG folded
Seat 4: Hero folded
Seat 5: UTG+2 folded
Seat 6: Dealer folded



PokerStars Hand #3951641833:  Hold'em No Limit ($2.50/$5) - 2020/05/27 13:19:20 ET
Table 'Zone Poker ID 1588' 9-max Seat #5 is the button
Seat 1: Big Blind ($500.00 in chips) 
Seat 2: Hero ($643.12 in chips) 
Seat 3: UTG+1 ($545.00 in chips) 
Seat 4: UTG+2 ($578.35 in chips) 
Seat 5: Dealer ($822.99 in chips) 
Seat 6: Small Blind ($890.04 in chips) 
Small Blind: posts small blind $2.50
Big Blind: posts big blind $5
*** HOLE CARDS ***
Dealt to Hero [Tc Td]
Hero: raises $7.50 to $12.50
UTG+1: folds 
UTG+2: folds 
Dealer: folds 
Small Blind: folds 
Big Blind: calls $7.50
*** FLOP *** [5s 4h 5c]
Big Blind: checks 
Hero: bets $7.84
Big Blind: raises $20.91 to $28.75
Hero: calls $20.91
*** TURN *** [5s 4h 5c] [3d]
Big Blind: checks 
Hero: checks 
*** RIVER *** [5s 4h 5c 3d] [Jc]
Big Blind: bets $60.75
Hero: calls $60.75
*** SHOW DOWN ***
Small Blind: shows [7d Th] (a hand...)
Big Blind: shows [Js 9s] (a hand...)
Hero: shows [Tc Td] (a hand...)
Dealer: shows [Qd 8d] (a hand...)
UTG+2: shows [2h 4d] (a hand...)
UTG+1: shows [5d Jh] (a hand...)
Big Blind collected $202.50 from pot
*** SUMMARY ***
Total pot $206.50 | Rake $4.00
Board [5s 4h 5c 3d Jc]
Seat 1: Big Blind showed [Js 9s] and won ($202.50)
Seat 2: Hero showed [Tc Td] and lost with...
Seat 3: UTG+1 folded
Seat 4: UTG+2 folded
Seat 5: Dealer folded
Seat 6: Small Blind folded



PokerStars Hand #3951641743:  Hold'em No Limit ($2.50/$5) - 2020/05/27 13:19:06 ET
Table 'Zone Poker ID 1588' 9-max Seat #3 is the button
Seat 1: UTG+1 ($500.00 in chips) 
Seat 2: UTG+2 ($459.71 in chips) 
Seat 3: Dealer ($609.63 in chips) 
Seat 4: Hero ($912.77 in chips) 
Seat 5: Big Blind ($956.63 in chips) 
Seat 6: UTG ($1476.35 in chips) 
Hero: posts small blind $2.50
Big Blind: posts big blind $5
*** HOLE CARDS ***
Dealt to Hero [Ah 8s]
UTG: folds 
UTG+1: folds 
UTG+2: calls $5
Dealer: folds 
Hero: calls $2.50
Big Blind: checks 
*** FLOP *** [Kh 6c 4h]
Hero: checks 
Big Blind: checks 
UTG+2: checks 
*** TURN *** [Kh 6c 4h] [Jc]
Hero: checks 
Big Blind: checks 
UTG+2: checks 
*** RIVER *** [Kh 6c 4h Jc] [9d]
Hero: checks 
Big Blind: bets $10
UTG+2: folds 
Hero: folds 
*** SHOW DOWN ***
Big Blind: shows [Tc 8d] (a hand...)
Hero: shows [Ah 8s] (a hand...)
Dealer: shows [4d Ts] (a hand...)
UTG+2: shows [6h 5h] (a hand...)
UTG: shows [5s Kd] (a hand...)
UTG+1: shows [6d 2h] (a hand...)
Uncalled bet ($10) returned to Big Blind
Big Blind collected $14.25 from pot
*** SUMMARY ***
Total pot $15.00 | Rake $0.75
Board [Kh 6c 4h Jc 9d]
Seat 1: UTG+1 folded
Seat 2: UTG+2 folded
Seat 3: Dealer folded
Seat 4: Hero folded
Seat 5: Big Blind collected ($14.25)
Seat 6: UTG folded



PokerStars Hand #3951641167:  Hold'em No Limit ($2.50/$5) - 2020/05/27 13:17:20 ET
Table 'Zone Poker ID 1588' 9-max Seat #6 is the button
Seat 1: Small Blind ($528.75 in chips) 
Seat 2: Big Blind ($399.07 in chips) 
Seat 3: UTG ($318.83 in chips) 
Seat 4: UTG+1 ($535.06 in chips) 
Seat 5: UTG+2 ($330.51 in chips) 
Seat 6: Hero ($687.72 in chips) 
Small Blind: posts small blind $2.50
Big Blind: posts big blind $5
*** HOLE CARDS ***
Dealt to Hero [Ks 4s]
UTG: folds 
UTG+1: folds 
UTG+2: folds 
Hero: raises $7.50 to $12.50
Small Blind: folds 
Big Blind: calls $7.50
*** FLOP *** [Qh Kh Th]
Big Blind: checks 
Hero: checks 
*** TURN *** [Qh Kh Th] [7s]
Big Blind: bets $19.60
Hero: calls $19.60
*** RIVER *** [Qh Kh Th 7s] [Ad]
Big Blind: bets $47.53
Hero: folds 
*** SHOW DOWN ***
Small Blind: shows [Qd 3c] (a hand...)
Big Blind: shows [Jd 9h] (a hand...)
Hero: shows [Ks 4s] (a hand...)
UTG+2: shows [4c 6s] (a hand...)
UTG: shows [4h Td] (a hand...)
UTG+1: shows [Qs 6h] (a hand...)
Uncalled bet ($47.53) returned to Big Blind
Big Blind collected $63.37 from pot
*** SUMMARY ***
Total pot $66.70 | Rake $3.33
Board [Qh Kh Th 7s Ad]
Seat 1: Small Blind folded
Seat 2: Big Blind collected ($63.37)
Seat 3: UTG folded
Seat 4: UTG+1 folded
Seat 5: UTG+2 folded
Seat 6: Hero folded



PokerStars Hand #3951639273:  Hold'em No Limit ($2.50/$5) - 2020/05/27 13:11:42 ET
Table 'Zone Poker ID 1588' 9-max Seat #2 is the button
Seat 1: Hero ($902.56 in chips) 
Seat 2: Dealer ($1601.51 in chips) 
Seat 3: Small Blind ($1036.03 in chips) 
Seat 4: Big Blind ($582.81 in chips) 
Seat 5: UTG ($492.50 in chips) 
Seat 6: UTG+1 ($518.77 in chips) 
Small Blind: posts small blind $2.50
Big Blind: posts big blind $5
*** HOLE CARDS ***
Dealt to Hero [6d 4d]
UTG: folds 
UTG+1: folds 
Hero: raises $7.50 to $12.50
Dealer: folds 
Small Blind: folds 
Big Blind: calls $7.50
*** FLOP *** [Tc 9h Kc]
Big Blind: checks 
Hero: checks 
*** TURN *** [Tc 9h Kc] [Ks]
Big Blind: checks 
Hero: checks 
*** RIVER *** [Tc 9h Kc Ks] [6h]
Big Blind: bets $74.60
Hero: folds 
*** SHOW DOWN ***
Small Blind: shows [Th 6c] (a hand...)
Big Blind: shows [Js 8s] (a hand...)
Hero: shows [6d 4d] (a hand...)
Dealer: shows [Qh 8c] (a hand...)
UTG: shows [4s Kh] (a hand...)
UTG+1: shows [Jd 7h] (a hand...)
Uncalled bet ($74.60) returned to Big Blind
Big Blind collected $26.13 from pot
*** SUMMARY ***
Total pot $27.50 | Rake $1.37
Board [Tc 9h Kc Ks 6h]
Seat 1: Hero folded
Seat 2: Dealer folded
Seat 3: Small Blind folded
Seat 4: Big Blind collected ($26.13)
Seat 5: UTG folded
Seat 6: UTG+1 folded



PokerStars Hand #3951637346:  Hold'em No Limit ($2.50/$5) - 2020/05/27 13:05:51 ET
Table 'Zone Poker ID 1588' 9-max Seat #3 is the button
Seat 1: UTG+1 ($729.98 in chips) 
Seat 2: UTG+2 ($1872.30 in chips) 
Seat 3: Dealer ($500.00 in chips) 
Seat 4: Small Blind ($624.79 in chips) 
Seat 5: Hero ($485.58 in chips) 
Seat 6: UTG ($473.86 in chips) 
Small Blind: posts small blind $2.50
Hero: posts big blind $5
*** HOLE CARDS ***
Dealt to Hero [7d 8d]
UTG: calls $5
UTG+1: folds 
UTG+2: raises $15 to $20
Dealer: folds 
Small Blind: calls $17.50
Hero: calls $15
UTG: calls $15
*** FLOP *** [2d Td Th]
Small Blind: checks 
Hero: checks 
UTG: checks 
UTG+2: checks 
*** TURN *** [2d Td Th] [3d]
Small Blind: checks 
Hero: bets $45
UTG: folds 
UTG+2: folds 
Small Blind: calls $45
*** RIVER *** [2d Td Th 3d] [Qs]
Small Blind: checks 
Hero: bets $132.20
Small Blind: raises $427.59 to $559.79 and is all-in
Hero: folds 
*** SHOW DOWN ***
Small Blind: shows [Qc Tc] (a hand...)
Hero: shows [7d 8d] (a hand...)
Dealer: shows [5s 6d] (a hand...)
UTG+2: shows [Jh Ac] (a hand...)
UTG: shows [Js Qh] (a hand...)
UTG+1: shows [5c 6h] (a hand...)
Uncalled bet ($427.59) returned to Small Blind
Small Blind collected $430.40 from pot
*** SUMMARY ***
Total pot $434.40 | Rake $4.00
Board [2d Td Th 3d Qs]
Seat 1: UTG+1 folded
Seat 2: UTG+2 folded
Seat 3: Dealer folded
Seat 4: Small Blind collected ($430.40)
Seat 5: Hero folded
Seat 6: UTG folded



PokerStars Hand #3951628580:  Hold'em No Limit ($2.50/$5) - 2020/05/27 12:38:55 ET
Table 'Zone Poker ID 1588' 9-max Seat #3 is the button
Seat 1: UTG+1 ($503.02 in chips) 
Seat 2: UTG+2 ($571.31 in chips) 
Seat 3: Hero ($513.00 in chips) 
Seat 4: Small Blind ($470.00 in chips) 
Seat 5: Big Blind ($694.18 in chips) 
Seat 6: UTG ($582.06 in chips) 
Small Blind: posts small blind $2.50
Big Blind: posts big blind $5
*** HOLE CARDS ***
Dealt to Hero [6c 7c]
UTG: folds 
UTG+1: folds 
UTG+2: folds 
Hero: raises $7.50 to $12.50
Small Blind: folds 
Big Blind: raises $32.50 to $45
Hero: calls $32.50
*** FLOP *** [3d 5h 5d]
Big Blind: bets $30
Hero: calls $30
*** TURN *** [3d 5h 5d] [6d]
Big Blind: checks 
Hero: checks 
*** RIVER *** [3d 5h 5d 6d] [Kc]
Big Blind: bets $74.25
Hero: folds 
*** SHOW DOWN ***
Small Blind: shows [Kd 2h] (a hand...)
Big Blind: shows [Qc Kh] (a hand...)
Hero: shows [6c 7c] (a hand...)
UTG+2: shows [8s Ks] (a hand...)
UTG: shows [8d 5c] (a hand...)
UTG+1: shows [3s Qd] (a hand...)
Uncalled bet ($74.25) returned to Big Blind
Big Blind collected $148.50 from pot
*** SUMMARY ***
Total pot $152.50 | Rake $4.00
Board [3d 5h 5d 6d Kc]
Seat 1: UTG+1 folded
Seat 2: UTG+2 folded
Seat 3: Hero folded
Seat 4: Small Blind folded
Seat 5: Big Blind collected ($148.50)
Seat 6: UTG folded



PokerStars Hand #3951627514:  Hold'em No Limit ($2.50/$5) - 2020/05/27 12:35:32 ET
Table 'Zone Poker ID 1588' 9-max Seat #2 is the button
Seat 1: UTG+2 ($472.52 in chips) 
Seat 2: Hero ($515.88 in chips) 
Seat 3: Small Blind ($601.38 in chips) 
Seat 4: Big Blind ($647.97 in chips) 
Seat 5: UTG ($485.00 in chips) 
Seat 6: UTG+1 ($616.35 in chips) 
Small Blind: posts small blind $2.50
Big Blind: posts big blind $5
*** HOLE CARDS ***
Dealt to Hero [Ad Jd]
UTG: folds 
UTG+1: folds 
UTG+2: folds 
Hero: raises $7.50 to $12.50
Small Blind: folds 
Big Blind: raises $42.50 to $55
Hero: calls $42.50
*** FLOP *** [2h Qh 6d]
Big Blind: bets $30.50
Hero: calls $30.50
*** TURN *** [2h Qh 6d] [4h]
Big Blind: checks 
Hero: checks 
*** RIVER *** [2h Qh 6d 4h] [Kd]
Big Blind: bets $57.50
Hero: folds 
*** SHOW DOWN ***
Small Blind: shows [Kc 6s] (a hand...)
Big Blind: shows [Ah Ks] (a hand...)
Hero: shows [Ad Jd] (a hand...)
UTG+2: shows [4c 7c] (a hand...)
UTG: shows [Tc 3s] (a hand...)
UTG+1: shows [7d 3h] (a hand...)
Uncalled bet ($57.50) returned to Big Blind
Big Blind collected $169.50 from pot
*** SUMMARY ***
Total pot $173.50 | Rake $4.00
Board [2h Qh 6d 4h Kd]
Seat 1: UTG+2 folded
Seat 2: Hero folded
Seat 3: Small Blind folded
Seat 4: Big Blind collected ($169.50)
Seat 5: UTG folded
Seat 6: UTG+1 folded



PokerStars Hand #3951616561:  Hold'em No Limit ($2.50/$5) - 2020/05/27 12:01:51 ET
Table 'Zone Poker ID 1588' 9-max Seat #3 is the button
Seat 1: UTG ($544.59 in chips) 
Seat 2: UTG+1 ($488.63 in chips) 
Seat 3: Dealer ($429.25 in chips) 
Seat 4: Hero ($975.80 in chips) 
Seat 5: Big Blind ($678.00 in chips) 
Hero: posts small blind $2.50
Big Blind: posts big blind $5
*** HOLE CARDS ***
Dealt to Hero [As Jd]
UTG: folds 
UTG+1: folds 
Dealer: folds 
Hero: raises $10.00 to $15
Big Blind: calls $10
*** FLOP *** [3h 4d 5d]
Hero: checks 
Big Blind: checks 
*** TURN *** [3h 4d 5d] [7h]
Hero: checks 
Big Blind: checks 
*** RIVER *** [3h 4d 5d 7h] [6d]
Hero: checks 
Big Blind: bets $36.38
Hero: folds 
*** SHOW DOWN ***
Big Blind: shows [9s Jc] (a hand...)
Hero: shows [As Jd] (a hand...)
Dealer: shows [3c 8c] (a hand...)
UTG: shows [3d Qd] (a hand...)
UTG+1: shows [7d 9c] (a hand...)
Uncalled bet ($36.38) returned to Big Blind
Big Blind collected $28.50 from pot
*** SUMMARY ***
Total pot $30.00 | Rake $1.50
Board [3h 4d 5d 7h 6d]
Seat 1: UTG folded
Seat 2: UTG+1 folded
Seat 3: Dealer folded
Seat 4: Hero folded
Seat 5: Big Blind collected ($28.50)



PokerStars Hand #3951613078:  Hold'em No Limit ($2.50/$5) - 2020/05/27 11:50:47 ET
Table 'Zone Poker ID 1588' 9-max Seat #2 is the button
Seat 1: Hero ($620.48 in chips) 
Seat 2: Dealer ($779.83 in chips) 
Seat 3: Small Blind ($1499.57 in chips) 
Seat 4: Big Blind ($703.70 in chips) 
Seat 5: UTG ($462.46 in chips) 
Small Blind: posts small blind $2.50
Big Blind: posts big blind $5
*** HOLE CARDS ***
Dealt to Hero [4d Kd]
UTG: folds 
Hero: raises $7.50 to $12.50
Dealer: folds 
Small Blind: folds 
Big Blind: calls $7.50
*** FLOP *** [2s Ah Jc]
Big Blind: checks 
Hero: bets $7.84
Big Blind: calls $7.84
*** TURN *** [2s Ah Jc] [Kc]
Big Blind: checks 
Hero: checks 
*** RIVER *** [2s Ah Jc Kc] [Td]
Big Blind: bets $35
Hero: folds 
*** SHOW DOWN ***
Small Blind: shows [Tc 4h] (a hand...)
Big Blind: shows [Ac Qh] (a hand...)
Hero: shows [4d Kd] (a hand...)
Dealer: shows [Kh 3d] (a hand...)
UTG: shows [7d 9h] (a hand...)
Uncalled bet ($35.00) returned to Big Blind
Big Blind collected $41.03 from pot
*** SUMMARY ***
Total pot $43.18 | Rake $2.15
Board [2s Ah Jc Kc Td]
Seat 1: Hero folded
Seat 2: Dealer folded
Seat 3: Small Blind folded
Seat 4: Big Blind collected ($41.03)
Seat 5: UTG folded



PokerStars Hand #3951611740:  Hold'em No Limit ($2.50/$5) - 2020/05/27 11:46:21 ET
Table 'Zone Poker ID 1588' 9-max Seat #5 is the button
Seat 1: Small Blind ($444.50 in chips) 
Seat 2: Hero ($776.21 in chips) 
Seat 3: UTG ($556.88 in chips) 
Seat 4: UTG+1 ($479.43 in chips) 
Seat 5: Dealer ($517.50 in chips) 
Small Blind: posts small blind $2.50
Hero: posts big blind $5
*** HOLE CARDS ***
Dealt to Hero [Ac 2c]
UTG: folds 
UTG+1: folds 
Dealer: raises $10 to $15
Small Blind: folds 
Hero: raises $52.50 to $67.50
Dealer: calls $52.50
*** FLOP *** [5d 2d 4s]
Hero: checks 
Dealer: checks 
*** TURN *** [5d 2d 4s] [Tc]
Hero: checks 
Dealer: checks 
*** RIVER *** [5d 2d 4s Tc] [3h]
Hero: bets $40.35
Dealer: raises $409.65 to $450 and is all-in
Hero: folds 
*** SHOW DOWN ***
Small Blind: shows [4d Qd] (a hand...)
Hero: shows [Ac 2c] (a hand...)
Dealer: shows [6h Ah] (a hand...)
UTG: shows [4c Jd] (a hand...)
UTG+1: shows [3d 5s] (a hand...)
Uncalled bet ($409.65) returned to Dealer
Dealer collected $215.20 from pot
*** SUMMARY ***
Total pot $218.20 | Rake $3.00
Board [5d 2d 4s Tc 3h]
Seat 1: Small Blind folded
Seat 2: Hero folded
Seat 3: UTG folded
Seat 4: UTG+1 folded
Seat 5: Dealer collected ($215.20)



PokerStars Hand #3951611168:  Hold'em No Limit ($2.50/$5) - 2020/05/27 11:44:28 ET
Table 'Zone Poker ID 1588' 9-max Seat #1 is the button
Seat 1: Dealer ($447.00 in chips) 
Seat 2: Small Blind ($507.50 in chips) 
Seat 3: Big Blind ($492.50 in chips) 
Seat 4: Hero ($1180.36 in chips) 
Seat 5: UTG+1 ($494.07 in chips) 
Seat 6: UTG+2 ($615.59 in chips) 
Small Blind: posts small blind $2.50
Big Blind: posts big blind $5
*** HOLE CARDS ***
Dealt to Hero [Ad Td]
Hero: raises $7.50 to $12.50
UTG+1: folds 
UTG+2: folds 
Dealer: folds 
Small Blind: folds 
Big Blind: calls $7.50
*** FLOP *** [8s 9c 5s]
Big Blind: checks 
Hero: checks 
*** TURN *** [8s 9c 5s] [2s]
Big Blind: checks 
Hero: checks 
*** RIVER *** [8s 9c 5s 2s] [As]
Big Blind: bets $13.07
Hero: folds 
*** SHOW DOWN ***
Small Blind: shows [Ks 7d] (a hand...)
Big Blind: shows [Tc Qs] (a hand...)
Hero: shows [Ad Td] (a hand...)
Dealer: shows [Ts Js] (a hand...)
UTG+2: shows [4h Qh] (a hand...)
UTG+1: shows [Kd 3d] (a hand...)
Uncalled bet ($13.07) returned to Big Blind
Big Blind collected $26.13 from pot
*** SUMMARY ***
Total pot $27.50 | Rake $1.37
Board [8s 9c 5s 2s As]
Seat 1: Dealer folded
Seat 2: Small Blind folded
Seat 3: Big Blind collected ($26.13)
Seat 4: Hero folded
Seat 5: UTG+1 folded
Seat 6: UTG+2 folded



PokerStars Hand #3951608447:  Hold'em No Limit ($2.50/$5) - 2020/05/27 11:35:37 ET
Table 'Zone Poker ID 1588' 9-max Seat #1 is the button
Seat 1: Dealer ($616.05 in chips) 
Seat 2: Small Blind ($840.49 in chips) 
Seat 3: Hero ($500.00 in chips) 
Small Blind: posts small blind $2.50
Hero: posts big blind $5
*** HOLE CARDS ***
Dealt to Hero [Kh Kd]
Dealer: folds 
Small Blind: raises $10.00 to $15
Hero: raises $30 to $45
Small Blind: calls $30
*** FLOP *** [Th 2d Td]
Small Blind: checks 
Hero: bets $26.40
Small Blind: calls $26.40
*** TURN *** [Th 2d Td] [4c]
Small Blind: checks 
Hero: checks 
*** RIVER *** [Th 2d Td 4c] [Kc]
Small Blind: bets $769.09 and is all-in
Hero: calls $428.60 and is all-in
*** SHOW DOWN ***
Small Blind: shows [Ts 2s] (a hand...)
Dealer: shows [8d 7s] (a hand...)
Hero: shows [Kh Kd] (a hand...)
Uncalled bet ($340.49) returned to Small Blind
Hero collected $998 from pot
*** SUMMARY ***
Total pot $1000.00 | Rake $2.00
Board [Th 2d Td 4c Kc]
Seat 1: Dealer folded
Seat 2: Small Blind showed [Ts 2s] and lost with...
Seat 3: Hero showed [Kh Kd] and won ($998)



PokerStars Hand #3951427600:  Hold'em No Limit ($2.50/$5) - 2020/05/27 00:53:53 ET
Table 'Zone Poker ID 1588' 9-max Seat #3 is the button
Seat 1: Big Blind ($731.93 in chips) 
Seat 2: UTG ($563.42 in chips) 
Seat 3: Dealer ($456.13 in chips) 
Seat 4: Hero ($974.08 in chips) 
Hero: posts small blind $2.50
Big Blind: posts big blind $5
*** HOLE CARDS ***
Dealt to Hero [Jc As]
UTG: raises $12.50 to $17.50
Dealer: folds 
Hero: raises $47.50 to $65
Big Blind: folds 
UTG: calls $47.50
*** FLOP *** [Jd 4s 9d]
Hero: bets $92.40
UTG: calls $92.40
*** TURN *** [Jd 4s 9d] [6c]
Hero: bets $165.42
UTG: calls $165.42
*** RIVER *** [Jd 4s 9d 6c] [4c]
Hero: checks 
UTG: bets $240.60 and is all-in
Hero: calls $240.60
*** SHOW DOWN ***
UTG: shows [Qd Ad] (a hand...)
Dealer: shows [Js 9s] (a hand...)
Big Blind: shows [2s 3d] (a hand...)
Hero: shows [Jc As] (a hand...)
Hero collected $1128.84 from pot
*** SUMMARY ***
Total pot $1131.84 | Rake $3.00
Board [Jd 4s 9d 6c 4c]
Seat 1: Big Blind folded
Seat 2: UTG showed [Qd Ad] and lost with...
Seat 3: Dealer folded
Seat 4: Hero showed [Jc As] and won ($1128.84)



PokerStars Hand #3951426529:  Hold'em No Limit ($2.50/$5) - 2020/05/27 00:51:54 ET
Table 'Zone Poker ID 1588' 9-max Seat #2 is the button
Seat 1: Big Blind ($494.28 in chips) 
Seat 2: Hero ($1192.24 in chips) 
Seat 3: Small Blind ($460.00 in chips) 
Small Blind: posts small blind $2.50
Big Blind: posts big blind $5
*** HOLE CARDS ***
Dealt to Hero [9h 9c]
Hero: raises $7.50 to $12.50
Small Blind: folds 
Big Blind: raises $37.50 to $50
Hero: calls $37.50
*** FLOP *** [4s 2c 5h]
Big Blind: bets $30
Hero: calls $30
*** TURN *** [4s 2c 5h] [2d]
Big Blind: bets $54
Hero: calls $54
*** RIVER *** [4s 2c 5h 2d] [7c]
Big Blind: bets $360.28 and is all-in
Hero: calls $360.28
*** SHOW DOWN ***
Small Blind: shows [Js 2s] (a hand...)
Big Blind: shows [Td Ts] (a hand...)
Hero: shows [9h 9c] (a hand...)
Big Blind collected $989.06 from pot
*** SUMMARY ***
Total pot $991.06 | Rake $2.00
Board [4s 2c 5h 2d 7c]
Seat 1: Big Blind showed [Td Ts] and won ($989.06)
Seat 2: Hero showed [9h 9c] and lost with...
Seat 3: Small Blind folded



PokerStars Hand #3951424035:  Hold'em No Limit ($2.50/$5) - 2020/05/27 00:47:29 ET
Table 'Zone Poker ID 1588' 9-max Seat #1 is the button
Seat 1: Hero ($1124.14 in chips) 
Seat 2: Small Blind ($458.06 in chips) 
Seat 3: Big Blind ($531.38 in chips) 
Small Blind: posts small blind $2.50
Big Blind: posts big blind $5
*** HOLE CARDS ***
Dealt to Hero [Ad 5s]
Hero: raises $7.50 to $12.50
Small Blind: folds 
Big Blind: calls $7.50
*** FLOP *** [6h 9d 4c]
Big Blind: checks 
Hero: checks 
*** TURN *** [6h 9d 4c] [Ac]
Big Blind: checks 
Hero: checks 
*** RIVER *** [6h 9d 4c Ac] [Ks]
Big Blind: bets $9.60
Hero: calls $9.60
*** SHOW DOWN ***
Small Blind: shows [4h Th] (a hand...)
Big Blind: shows [7h 8s] (a hand...)
Hero: shows [Ad 5s] (a hand...)
Hero collected $44.70 from pot
*** SUMMARY ***
Total pot $46.70 | Rake $2.00
Board [6h 9d 4c Ac Ks]
Seat 1: Hero showed [Ad 5s] and won ($44.70)
Seat 2: Small Blind folded
Seat 3: Big Blind showed [7h 8s] and lost with...



PokerStars Hand #3951423289:  Hold'em No Limit ($2.50/$5) - 2020/05/27 00:46:10 ET
Table 'Zone Poker ID 1588' 9-max Seat #3 is the button
Seat 1: Small Blind ($909.05 in chips) 
Seat 2: Big Blind ($289.34 in chips) 
Seat 3: Hero ($1161.83 in chips) 
Small Blind: posts small blind $2.50
Big Blind: posts big blind $5
*** HOLE CARDS ***
Dealt to Hero [5d 4d]
Hero: raises $7.50 to $12.50
Small Blind: folds 
Big Blind: calls $7.50
*** FLOP *** [Kc 8d 2d]
Big Blind: checks 
Hero: bets $7.84
Big Blind: calls $7.84
*** TURN *** [Kc 8d 2d] [4h]
Big Blind: checks 
Hero: bets $12.35
Big Blind: calls $12.35
*** RIVER *** [Kc 8d 2d 4h] [7h]
Big Blind: bets $49.41
Hero: folds 
*** SHOW DOWN ***
Small Blind: shows [9c 6d] (a hand...)
Big Blind: shows [Kd 9h] (a hand...)
Hero: shows [5d 4d] (a hand...)
Uncalled bet ($49.41) returned to Big Blind
Big Blind collected $65.88 from pot
*** SUMMARY ***
Total pot $67.88 | Rake $2.00
Board [Kc 8d 2d 4h 7h]
Seat 1: Small Blind folded
Seat 2: Big Blind collected ($65.88)
Seat 3: Hero folded



PokerStars Hand #3951422820:  Hold'em No Limit ($2.50/$5) - 2020/05/27 00:45:21 ET
Table 'Zone Poker ID 1588' 9-max Seat #2 is the button
Seat 1: Hero ($1225.72 in chips) 
Seat 2: Dealer ($862.16 in chips) 
Seat 3: Small Blind ($1283.57 in chips) 
Small Blind: posts small blind $2.50
Hero: posts big blind $5
*** HOLE CARDS ***
Dealt to Hero [5s Js]
Dealer: raises $7.50 to $12.50
Small Blind: folds 
Hero: calls $7.50
*** FLOP *** [As 7d Ac]
Hero: checks 
Dealer: checks 
*** TURN *** [As 7d Ac] [Jd]
Hero: checks 
Dealer: bets $13.07
Hero: calls $13.07
*** RIVER *** [As 7d Ac Jd] [8h]
Hero: checks 
Dealer: bets $25.82
Hero: calls $25.82
*** SHOW DOWN ***
Small Blind: shows [2c 4c] (a hand...)
Dealer: shows [Ad 4h] (a hand...)
Hero: shows [5s Js] (a hand...)
Dealer collected $103.28 from pot
*** SUMMARY ***
Total pot $105.28 | Rake $2.00
Board [As 7d Ac Jd 8h]
Seat 1: Hero showed [5s Js] and lost with...
Seat 2: Dealer showed [Ad 4h] and won ($103.28)
Seat 3: Small Blind folded



PokerStars Hand #3951417376:  Hold'em No Limit ($2.50/$5) - 2020/05/27 00:35:45 ET
Table 'Zone Poker ID 1588' 9-max Seat #5 is the button
Seat 1: Small Blind ($498.70 in chips) 
Seat 2: Big Blind ($629.80 in chips) 
Seat 3: UTG ($569.43 in chips) 
Seat 4: UTG+1 ($500.00 in chips) 
Seat 5: Hero ($495.00 in chips) 
Small Blind: posts small blind $2.50
Big Blind: posts big blind $5
*** HOLE CARDS ***
Dealt to Hero [Th As]
UTG: folds 
UTG+1: folds 
Hero: raises $7.50 to $12.50
Small Blind: folds 
Big Blind: calls $7.50
*** FLOP *** [2d 2c 3d]
Big Blind: checks 
Hero: bets $7.84
Big Blind: calls $7.84
*** TURN *** [2d 2c 3d] [4h]
Big Blind: checks 
Hero: checks 
*** RIVER *** [2d 2c 3d 4h] [4c]
Big Blind: bets $10.52
Hero: calls $10.52
*** SHOW DOWN ***
Small Blind: shows [Js 7s] (a hand...)
Big Blind: shows [Ac Ts] (a hand...)
Hero: shows [Th As] (a hand...)
UTG: shows [8s 3c] (a hand...)
UTG+1: shows [7d 9s] (a hand...)
Big Blind collected $30.61 from pot
Hero collected $30.61 from pot
*** SUMMARY ***
Total pot $64.22 | Rake $3.00
Board [2d 2c 3d 4h 4c]
Seat 1: Small Blind folded
Seat 2: Big Blind showed [Ac Ts] and won ($30.61)
Seat 3: UTG folded
Seat 4: UTG+1 folded
Seat 5: Hero showed [Th As] and won ($30.61)



PokerStars Hand #3951415060:  Hold'em No Limit ($2.50/$5) - 2020/05/27 00:31:46 ET
Table 'Zone Poker ID 1588' 9-max Seat #3 is the button
Seat 1: UTG ($540.88 in chips) 
Seat 2: UTG+1 ($541.95 in chips) 
Seat 3: Dealer ($577.54 in chips) 
Seat 4: Small Blind ($460.00 in chips) 
Seat 5: Hero ($1029.71 in chips) 
Small Blind: posts small blind $2.50
Hero: posts big blind $5
*** HOLE CARDS ***
Dealt to Hero [Qh 8h]
UTG: folds 
UTG+1: raises $7.50 to $12.50
Dealer: folds 
Small Blind: folds 
Hero: calls $7.50
*** FLOP *** [5c Kd Ad]
Hero: checks 
UTG+1: checks 
*** TURN *** [5c Kd Ad] [Ah]
Hero: checks 
UTG+1: bets $13.07
Hero: calls $13.07
*** RIVER *** [5c Kd Ad Ah] [Qc]
Hero: checks 
UTG+1: bets $25.48
Hero: calls $25.48
*** SHOW DOWN ***
Small Blind: shows [Ts 5d] (a hand...)
Hero: shows [Qh 8h] (a hand...)
Dealer: shows [8s 4c] (a hand...)
UTG: shows [5h Tc] (a hand...)
UTG+1: shows [Jd Ac] (a hand...)
UTG+1 collected $101.60 from pot
*** SUMMARY ***
Total pot $104.60 | Rake $3.00
Board [5c Kd Ad Ah Qc]
Seat 1: UTG folded
Seat 2: UTG+1 showed [Jd Ac] and won ($101.60)
Seat 3: Dealer folded
Seat 4: Small Blind folded
Seat 5: Hero showed [Qh 8h] and lost with...



PokerStars Hand #3951414774:  Hold'em No Limit ($2.50/$5) - 2020/05/27 00:31:17 ET
Table 'Zone Poker ID 1588' 9-max Seat #1 is the button
Seat 1: Dealer ($500.00 in chips) 
Seat 2: Small Blind ($730.98 in chips) 
Seat 3: Big Blind ($722.98 in chips) 
Seat 4: UTG ($598.77 in chips) 
Seat 5: Hero ($513.50 in chips) 
Small Blind: posts small blind $2.50
Big Blind: posts big blind $5
*** HOLE CARDS ***
Dealt to Hero [Th Jh]
UTG: folds 
Hero: raises $7.50 to $12.50
Dealer: folds 
Small Blind: folds 
Big Blind: calls $7.50
*** FLOP *** [5d Jc 7s]
Big Blind: checks 
Hero: checks 
*** TURN *** [5d Jc 7s] [4h]
Big Blind: bets $18.07
Hero: calls $18.07
*** RIVER *** [5d Jc 7s 4h] [9s]
Big Blind: bets $45.48
Hero: calls $45.48
*** SHOW DOWN ***
Small Blind: shows [9h 2s] (a hand...)
Big Blind: shows [4c 4s] (a hand...)
Hero: shows [Th Jh] (a hand...)
Dealer: shows [Kd 3s] (a hand...)
UTG: shows [8c As] (a hand...)
Big Blind collected $151.60 from pot
*** SUMMARY ***
Total pot $154.60 | Rake $3.00
Board [5d Jc 7s 4h 9s]
Seat 1: Dealer folded
Seat 2: Small Blind folded
Seat 3: Big Blind showed [4c 4s] and won ($151.60)
Seat 4: UTG folded
Seat 5: Hero showed [Th Jh] and lost with...



PokerStars Hand #3951407092:  Hold'em No Limit ($2.50/$5) - 2020/05/27 00:17:52 ET
Table 'Zone Poker ID 1588' 9-max Seat #2 is the button
Seat 1: UTG+2 ($503.88 in chips) 
Seat 2: Hero ($500.00 in chips) 
Seat 3: Small Blind ($1690.09 in chips) 
Seat 4: Big Blind ($644.13 in chips) 
Seat 5: UTG ($500.00 in chips) 
Seat 6: UTG+1 ($571.00 in chips) 
Small Blind: posts small blind $2.50
Big Blind: posts big blind $5
*** HOLE CARDS ***
Dealt to Hero [Js 3s]
UTG: folds 
UTG+1: folds 
UTG+2: folds 
Hero: raises $7.50 to $12.50
Small Blind: calls $10
Big Blind: folds 
*** FLOP *** [Qd Qs Jc]
Small Blind: checks 
Hero: bets $8.55
Small Blind: raises $8.55 to $17.10
Hero: calls $8.55
*** TURN *** [Qd Qs Jc] [Ts]
Small Blind: bets $10
Hero: calls $10
*** RIVER *** [Qd Qs Jc Ts] [3c]
Small Blind: bets $10
Hero: calls $10
*** SHOW DOWN ***
Small Blind: shows [Ac Jd] (a hand...)
Big Blind: shows [5h 7d] (a hand...)
Hero: shows [Js 3s] (a hand...)
UTG+2: shows [Qh 8c] (a hand...)
UTG: shows [6d Kh] (a hand...)
UTG+1: shows [Kd 8s] (a hand...)
Small Blind collected $100.20 from pot
*** SUMMARY ***
Total pot $104.20 | Rake $4.00
Board [Qd Qs Jc Ts 3c]
Seat 1: UTG+2 folded
Seat 2: Hero showed [Js 3s] and lost with...
Seat 3: Small Blind showed [Ac Jd] and won ($100.20)
Seat 4: Big Blind folded
Seat 5: UTG folded
Seat 6: UTG+1 folded



PokerStars Hand #3951406318:  Hold'em No Limit ($2.50/$5) - 2020/05/27 00:16:30 ET
Table 'Zone Poker ID 1588' 9-max Seat #2 is the button
Seat 1: UTG+2 ($500.00 in chips) 
Seat 2: Dealer ($588.00 in chips) 
Seat 3: Small Blind ($317.13 in chips) 
Seat 4: Hero ($493.39 in chips) 
Seat 5: UTG ($482.58 in chips) 
Seat 6: UTG+1 ($500.00 in chips) 
Small Blind: posts small blind $2.50
Hero: posts big blind $5
*** HOLE CARDS ***
Dealt to Hero [Jc Jh]
UTG: raises $12.50 to $17.50
UTG+1: folds 
UTG+2: folds 
Dealer: folds 
Small Blind: folds 
Hero: raises $47.50 to $65
UTG: calls $47.50
*** FLOP *** [7d Kd 3c]
Hero: bets $38.55
UTG: calls $38.55
*** TURN *** [7d Kd 3c] [4c]
Hero: checks 
UTG: bets $122.80
Hero: calls $122.80
*** RIVER *** [7d Kd 3c 4c] [6s]
Hero: checks 
UTG: bets $256.23 and is all-in
Hero: folds 
*** SHOW DOWN ***
Small Blind: shows [Ac 8s] (a hand...)
Hero: shows [Jc Jh] (a hand...)
Dealer: shows [3s 2d] (a hand...)
UTG+2: shows [9d Jd] (a hand...)
UTG: shows [Ad 6d] (a hand...)
UTG+1: shows [5h 9c] (a hand...)
Uncalled bet ($256.23) returned to UTG
UTG collected $451.20 from pot
*** SUMMARY ***
Total pot $455.20 | Rake $4.00
Board [7d Kd 3c 4c 6s]
Seat 1: UTG+2 folded
Seat 2: Dealer folded
Seat 3: Small Blind folded
Seat 4: Hero folded
Seat 5: UTG collected ($451.20)
Seat 6: UTG+1 folded



PokerStars Hand #3951403675:  Hold'em No Limit ($2.50/$5) - 2020/05/27 00:12:03 ET
Table 'Zone Poker ID 1588' 9-max Seat #6 is the button
Seat 1: Small Blind ($505.00 in chips) 
Seat 2: Big Blind ($530.36 in chips) 
Seat 3: UTG ($332.56 in chips) 
Seat 4: Hero ($1094.80 in chips) 
Seat 5: UTG+2 ($1179.49 in chips) 
Seat 6: Dealer ($300.32 in chips) 
Small Blind: posts small blind $2.50
Big Blind: posts big blind $5
*** HOLE CARDS ***
Dealt to Hero [3s As]
UTG: folds 
Hero: raises $7.50 to $12.50
UTG+2: folds 
Dealer: calls $12.50
Small Blind: calls $10
Big Blind: calls $7.50
*** FLOP *** [2h 6c Ks]
Small Blind: checks 
Big Blind: checks 
Hero: bets $15
Dealer: calls $15
Small Blind: folds 
Big Blind: folds 
*** TURN *** [2h 6c Ks] [3h]
Hero: checks 
Dealer: checks 
*** RIVER *** [2h 6c Ks 3h] [Kd]
Hero: checks 
Dealer: bets $38
Hero: folds 
*** SHOW DOWN ***
Small Blind: shows [7c 7d] (a hand...)
Big Blind: shows [8d Ad] (a hand...)
Hero: shows [3s As] (a hand...)
UTG+2: shows [8c Th] (a hand...)
Dealer: shows [6d 9d] (a hand...)
UTG: shows [4s Qd] (a hand...)
Uncalled bet ($38.00) returned to Dealer
Dealer collected $76 from pot
*** SUMMARY ***
Total pot $80.00 | Rake $4.00
Board [2h 6c Ks 3h Kd]
Seat 1: Small Blind folded
Seat 2: Big Blind folded
Seat 3: UTG folded
Seat 4: Hero folded
Seat 5: UTG+2 folded
Seat 6: Dealer collected ($76)



PokerStars Hand #3951399081:  Hold'em No Limit ($2.50/$5) - 2020/05/27 00:04:16 ET
Table 'Zone Poker ID 1588' 9-max Seat #5 is the button
Seat 1: Big Blind ($664.48 in chips) 
Seat 2: UTG ($500.00 in chips) 
Seat 3: UTG+1 ($492.50 in chips) 
Seat 4: UTG+2 ($431.57 in chips) 
Seat 5: Hero ($917.23 in chips) 
Seat 6: Small Blind ($646.11 in chips) 
Small Blind: posts small blind $2.50
Big Blind: posts big blind $5
*** HOLE CARDS ***
Dealt to Hero [Ad 4h]
UTG: folds 
UTG+1: folds 
UTG+2: folds 
Hero: raises $7.50 to $12.50
Small Blind: folds 
Big Blind: calls $7.50
*** FLOP *** [5h 3d 3s]
Big Blind: checks 
Hero: bets $7.84
Big Blind: raises $20.91 to $28.75
Hero: calls $20.91
*** TURN *** [5h 3d 3s] [Jh]
Big Blind: bets $60.75
Hero: calls $60.75
*** RIVER *** [5h 3d 3s Jh] [6h]
Big Blind: bets $202.50
Hero: folds 
*** SHOW DOWN ***
Small Blind: shows [Kh 8s] (a hand...)
Big Blind: shows [7h 6c] (a hand...)
Hero: shows [Ad 4h] (a hand...)
UTG+2: shows [8h Jc] (a hand...)
UTG: shows [Kd 9s] (a hand...)
UTG+1: shows [2s Ks] (a hand...)
Uncalled bet ($202.50) returned to Big Blind
Big Blind collected $202.50 from pot
*** SUMMARY ***
Total pot $206.50 | Rake $4.00
Board [5h 3d 3s Jh 6h]
Seat 1: Big Blind collected ($202.50)
Seat 2: UTG folded
Seat 3: UTG+1 folded
Seat 4: UTG+2 folded
Seat 5: Hero folded
Seat 6: Small Blind folded



PokerStars Hand #3951393586:  Hold'em No Limit ($2.50/$5) - 2020/05/26 23:55:20 ET
Table 'Zone Poker ID 1588' 9-max Seat #1 is the button
Seat 1: Hero ($529.45 in chips) 
Seat 2: Small Blind ($495.00 in chips) 
Seat 3: Big Blind ($690.42 in chips) 
Seat 4: UTG ($515.85 in chips) 
Seat 5: UTG+1 ($500.00 in chips) 
Seat 6: UTG+2 ($1063.50 in chips) 
Small Blind: posts small blind $2.50
Big Blind: posts big blind $5
*** HOLE CARDS ***
Dealt to Hero [5h 3h]
UTG: folds 
UTG+1: folds 
UTG+2: folds 
Hero: raises $7.50 to $12.50
Small Blind: folds 
Big Blind: calls $7.50
*** FLOP *** [9d Kc 7c]
Big Blind: checks 
Hero: checks 
*** TURN *** [9d Kc 7c] [Ad]
Big Blind: checks 
Hero: checks 
*** RIVER *** [9d Kc 7c Ad] [4c]
Big Blind: bets $7.31
Hero: folds 
*** SHOW DOWN ***
Small Blind: shows [8h 6d] (a hand...)
Big Blind: shows [Td Ks] (a hand...)
Hero: shows [5h 3h] (a hand...)
UTG+2: shows [7d 6s] (a hand...)
UTG: shows [Jh 4s] (a hand...)
UTG+1: shows [2s Qh] (a hand...)
Uncalled bet ($7.31) returned to Big Blind
Big Blind collected $26.13 from pot
*** SUMMARY ***
Total pot $27.50 | Rake $1.37
Board [9d Kc 7c Ad 4c]
Seat 1: Hero folded
Seat 2: Small Blind folded
Seat 3: Big Blind collected ($26.13)
Seat 4: UTG folded
Seat 5: UTG+1 folded
Seat 6: UTG+2 folded



PokerStars Hand #3951388976:  Hold'em No Limit ($2.50/$5) - 2020/05/26 23:47:37 ET
Table 'Zone Poker ID 1588' 9-max Seat #3 is the button
Seat 1: UTG ($500.00 in chips) 
Seat 2: UTG+1 ($759.12 in chips) 
Seat 3: Hero ($1215.39 in chips) 
Seat 4: Small Blind ($548.70 in chips) 
Seat 5: Big Blind ($591.50 in chips) 
Small Blind: posts small blind $2.50
Big Blind: posts big blind $5
*** HOLE CARDS ***
Dealt to Hero [Kd Ac]
UTG: folds 
UTG+1: folds 
Hero: raises $7.50 to $12.50
Small Blind: folds 
Big Blind: calls $7.50
*** FLOP *** [Qh 2d 5c]
Big Blind: checks 
Hero: bets $7.84
Big Blind: calls $7.84
*** TURN *** [Qh 2d 5c] [Kh]
Big Blind: checks 
Hero: bets $61.54
Big Blind: raises $97.06 to $158.60
Hero: calls $97.06
*** RIVER *** [Qh 2d 5c Kh] [8h]
Big Blind: bets $208.69
Hero: folds 
*** SHOW DOWN ***
Small Blind: shows [9c 3h] (a hand...)
Big Blind: shows [Jd Td] (a hand...)
Hero: shows [Kd Ac] (a hand...)
UTG: shows [4d 2h] (a hand...)
UTG+1: shows [Tc 6d] (a hand...)
Uncalled bet ($208.69) returned to Big Blind
Big Blind collected $357.38 from pot
*** SUMMARY ***
Total pot $360.38 | Rake $3.00
Board [Qh 2d 5c Kh 8h]
Seat 1: UTG folded
Seat 2: UTG+1 folded
Seat 3: Hero folded
Seat 4: Small Blind folded
Seat 5: Big Blind collected ($357.38)



PokerStars Hand #3951388136:  Hold'em No Limit ($2.50/$5) - 2020/05/26 23:46:14 ET
Table 'Zone Poker ID 1588' 9-max Seat #4 is the button
Seat 1: Hero ($500.00 in chips) 
Seat 2: UTG ($1098.58 in chips) 
Seat 3: UTG+1 ($684.62 in chips) 
Seat 4: Dealer ($399.55 in chips) 
Seat 5: Small Blind ($384.54 in chips) 
Small Blind: posts small blind $2.50
Hero: posts big blind $5
*** HOLE CARDS ***
Dealt to Hero [Ac Qs]
UTG: raises $7.50 to $12.50
UTG+1: calls $12.50
Dealer: folds 
Small Blind: folds 
Hero: raises $52.50 to $65
UTG: folds 
UTG+1: calls $52.50
*** FLOP *** [5d 8d 3h]
Hero: checks 
UTG+1: checks 
*** TURN *** [5d 8d 3h] [Jc]
Hero: checks 
UTG+1: checks 
*** RIVER *** [5d 8d 3h Jc] [5c]
Hero: checks 
UTG+1: bets $106.50
Hero: folds 
*** SHOW DOWN ***
Small Blind: shows [8c Ts] (a hand...)
Hero: shows [Ac Qs] (a hand...)
Dealer: shows [6c Td] (a hand...)
UTG: shows [2h 2c] (a hand...)
UTG+1: shows [6d Qd] (a hand...)
Uncalled bet ($106.50) returned to UTG+1
UTG+1 collected $142 from pot
*** SUMMARY ***
Total pot $145.00 | Rake $3.00
Board [5d 8d 3h Jc 5c]
Seat 1: Hero folded
Seat 2: UTG folded
Seat 3: UTG+1 collected ($142)
Seat 4: Dealer folded
Seat 5: Small Blind folded



PokerStars Hand #3951387413:  Hold'em No Limit ($2.50/$5) - 2020/05/26 23:45:04 ET
Table 'Zone Poker ID 1588' 9-max Seat #2 is the button
Seat 1: UTG+1 ($468.25 in chips) 
Seat 2: Hero ($523.26 in chips) 
Seat 3: Small Blind ($1010.58 in chips) 
Seat 4: Big Blind ($1674.46 in chips) 
Seat 5: UTG ($512.50 in chips) 
Small Blind: posts small blind $2.50
Big Blind: posts big blind $5
*** HOLE CARDS ***
Dealt to Hero [5h 7h]
UTG: folds 
UTG+1: folds 
Hero: raises $7.50 to $12.50
Small Blind: raises $40.00 to $52.50
Big Blind: folds 
Hero: calls $40
*** FLOP *** [Ks Qd 5s]
Small Blind: bets $33.50
Hero: calls $33.50
*** TURN *** [Ks Qd 5s] [9d]
Small Blind: checks 
Hero: checks 
*** RIVER *** [Ks Qd 5s 9d] [3c]
Small Blind: bets $105
Hero: folds 
*** SHOW DOWN ***
Small Blind: shows [Jc Kc] (a hand...)
Big Blind: shows [4h 6c] (a hand...)
Hero: shows [5h 7h] (a hand...)
UTG: shows [3s 8s] (a hand...)
UTG+1: shows [7c 2c] (a hand...)
Uncalled bet ($105.00) returned to Small Blind
Small Blind collected $174 from pot
*** SUMMARY ***
Total pot $177.00 | Rake $3.00
Board [Ks Qd 5s 9d 3c]
Seat 1: UTG+1 folded
Seat 2: Hero folded
Seat 3: Small Blind collected ($174)
Seat 4: Big Blind folded
Seat 5: UTG folded



PokerStars Hand #3951365599:  Hold'em No Limit ($2.50/$5) - 2020/05/26 23:09:33 ET
Table 'Zone Poker ID 1588' 9-max Seat #1 is the button
Seat 1: Hero ($864.59 in chips) 
Seat 2: Small Blind ($621.80 in chips) 
Seat 3: Big Blind ($1295.20 in chips) 
Seat 4: UTG ($853.46 in chips) 
Seat 5: UTG+1 ($493.24 in chips) 
Small Blind: posts small blind $2.50
Big Blind: posts big blind $5
*** HOLE CARDS ***
Dealt to Hero [Td Jd]
UTG: folds 
UTG+1: calls $5
Hero: raises $15 to $20
Small Blind: calls $17.50
Big Blind: folds 
UTG+1: calls $15
*** FLOP *** [Kh 8c Tc]
Small Blind: checks 
UTG+1: checks 
Hero: checks 
*** TURN *** [Kh 8c Tc] [Ts]
Small Blind: checks 
UTG+1: checks 
Hero: bets $42.54
Small Blind: calls $42.54
UTG+1: calls $42.54
*** RIVER *** [Kh 8c Tc Ts] [9h]
Small Blind: checks 
UTG+1: bets $94.81
Hero: calls $94.81
Small Blind: folds 
*** SHOW DOWN ***
Small Blind: shows [Qs Kc] (a hand...)
Big Blind: shows [Qc 4s] (a hand...)
Hero: shows [Td Jd] (a hand...)
UTG: shows [6d Js] (a hand...)
UTG+1: shows [Th Kd] (a hand...)
UTG+1 collected $379.24 from pot
*** SUMMARY ***
Total pot $382.24 | Rake $3.00
Board [Kh 8c Tc Ts 9h]
Seat 1: Hero showed [Td Jd] and lost with...
Seat 2: Small Blind folded
Seat 3: Big Blind folded
Seat 4: UTG folded
Seat 5: UTG+1 showed [Th Kd] and won ($379.24)



PokerStars Hand #3951364183:  Hold'em No Limit ($2.50/$5) - 2020/05/26 23:07:13 ET
Table 'Zone Poker ID 1588' 9-max Seat #3 is the button
Seat 1: Hero ($513.50 in chips) 
Seat 2: UTG+1 ($316.22 in chips) 
Seat 3: Dealer ($646.12 in chips) 
Seat 4: Small Blind ($560.08 in chips) 
Seat 5: Big Blind ($708.80 in chips) 
Small Blind: posts small blind $2.50
Big Blind: posts big blind $5
*** HOLE CARDS ***
Dealt to Hero [7h 8h]
Hero: raises $7.50 to $12.50
UTG+1: folds 
Dealer: calls $12.50
Small Blind: folds 
Big Blind: folds 
*** FLOP *** [5d 6s 6h]
Hero: checks 
Dealer: checks 
*** TURN *** [5d 6s 6h] [4c]
Hero: bets $23.16
Dealer: raises $33.16 to $56.32
Hero: calls $33.16
*** RIVER *** [5d 6s 6h 4c] [3h]
Hero: checks 
Dealer: bets $142.14
Hero: calls $142.14
*** SHOW DOWN ***
Small Blind: shows [Js 3c] (a hand...)
Big Blind: shows [9s 5s] (a hand...)
Hero: shows [7h 8h] (a hand...)
Dealer: shows [Tc As] (a hand...)
UTG+1: shows [Ts 9h] (a hand...)
Hero collected $426.42 from pot
*** SUMMARY ***
Total pot $429.42 | Rake $3.00
Board [5d 6s 6h 4c 3h]
Seat 1: Hero showed [7h 8h] and won ($426.42)
Seat 2: UTG+1 folded
Seat 3: Dealer showed [Tc As] and lost with...
Seat 4: Small Blind folded
Seat 5: Big Blind folded



PokerStars Hand #3951361567:  Hold'em No Limit ($2.50/$5) - 2020/05/26 23:02:57 ET
Table 'Zone Poker ID 1588' 9-max Seat #2 is the button
Seat 1: UTG+1 ($485.00 in chips) 
Seat 2: Hero ($521.83 in chips) 
Seat 3: Small Blind ($535.08 in chips) 
Seat 4: Big Blind ($553.86 in chips) 
Seat 5: UTG ($500.00 in chips) 
Small Blind: posts small blind $2.50
Big Blind: posts big blind $5
*** HOLE CARDS ***
Dealt to Hero [6h Qh]
UTG: calls $5
UTG+1: folds 
Hero: raises $15 to $20
Small Blind: folds 
Big Blind: calls $15
UTG: calls $15
*** FLOP *** [6c 3c 9h]
Big Blind: checks 
UTG: bets $20
Hero: raises $49.75 to $69.75
Big Blind: folds 
UTG: calls $49.75
*** TURN *** [6c 3c 9h] [7h]
UTG: bets $60.61
Hero: calls $60.61
*** RIVER *** [6c 3c 9h 7h] [As]
UTG: bets $82.90
Hero: calls $82.90
*** SHOW DOWN ***
Small Blind: shows [9s 4c] (a hand...)
Big Blind: shows [4h Ah] (a hand...)
Hero: shows [6h Qh] (a hand...)
UTG: shows [Ks Jh] (a hand...)
UTG+1: shows [3s Ts] (a hand...)
Hero collected $486.02 from pot
*** SUMMARY ***
Total pot $489.02 | Rake $3.00
Board [6c 3c 9h 7h As]
Seat 1: UTG+1 folded
Seat 2: Hero showed [6h Qh] and won ($486.02)
Seat 3: Small Blind folded
Seat 4: Big Blind folded
Seat 5: UTG showed [Ks Jh] and lost with...



PokerStars Hand #3951355683:  Hold'em No Limit ($2.50/$5) - 2020/05/26 22:53:22 ET
Table 'Zone Poker ID 1588' 9-max Seat #4 is the button
Seat 1: Big Blind ($404.78 in chips) 
Seat 2: UTG ($380.58 in chips) 
Seat 3: UTG+1 ($497.50 in chips) 
Seat 4: Dealer ($643.00 in chips) 
Seat 5: Hero ($637.43 in chips) 
Hero: posts small blind $2.50
Big Blind: posts big blind $5
*** HOLE CARDS ***
Dealt to Hero [5h 9h]
UTG: folds 
UTG+1: folds 
Dealer: folds 
Hero: raises $10.00 to $15
Big Blind: calls $10
*** FLOP *** [5d 3h Ts]
Hero: bets $8.55
Big Blind: calls $8.55
*** TURN *** [5d 3h Ts] [6h]
Hero: checks 
Big Blind: checks 
*** RIVER *** [5d 3h Ts 6h] [Kc]
Hero: checks 
Big Blind: bets $15
Hero: calls $15
*** SHOW DOWN ***
Big Blind: shows [Qh Td] (a hand...)
Hero: shows [5h 9h] (a hand...)
Dealer: shows [9s 7h] (a hand...)
UTG: shows [2s 8s] (a hand...)
UTG+1: shows [2h 4h] (a hand...)
Big Blind collected $74.10 from pot
*** SUMMARY ***
Total pot $77.10 | Rake $3.00
Board [5d 3h Ts 6h Kc]
Seat 1: Big Blind showed [Qh Td] and won ($74.10)
Seat 2: UTG folded
Seat 3: UTG+1 folded
Seat 4: Dealer folded
Seat 5: Hero showed [5h 9h] and lost with...



PokerStars Hand #3951191613:  Hold'em No Limit ($2.50/$5) - 2020/05/26 17:52:07 ET
Table 'Zone Poker ID 1588' 9-max Seat #2 is the button
Seat 1: Hero ($725.62 in chips) 
Seat 2: Dealer ($317.25 in chips) 
Seat 3: Small Blind ($502.50 in chips) 
Small Blind: posts small blind $2.50
Hero: posts big blind $5
*** HOLE CARDS ***
Dealt to Hero [3h 3d]
Dealer: raises $10 to $15
Small Blind: folds 
Hero: calls $10
*** FLOP *** [4h 6s Tc]
Hero: checks 
Dealer: bets $15.44
Hero: calls $15.44
*** TURN *** [4h 6s Tc] [5s]
Hero: checks 
Dealer: bets $30.69
Hero: calls $30.69
*** RIVER *** [4h 6s Tc 5s] [4d]
Hero: checks 
Dealer: bets $92.07
Hero: folds 
*** SHOW DOWN ***
Small Blind: shows [8d 2s] (a hand...)
Dealer: shows [Kc 4c] (a hand...)
Hero: shows [3h 3d] (a hand...)
Uncalled bet ($92.07) returned to Dealer
Dealer collected $122.76 from pot
*** SUMMARY ***
Total pot $124.76 | Rake $2.00
Board [4h 6s Tc 5s 4d]
Seat 1: Hero folded
Seat 2: Dealer collected ($122.76)
Seat 3: Small Blind folded



PokerStars Hand #3951190651:  Hold'em No Limit ($2.50/$5) - 2020/05/26 17:50:05 ET
Table 'Zone Poker ID 1588' 9-max Seat #2 is the button
Seat 1: Hero ($461.54 in chips) 
Seat 2: Dealer ($553.68 in chips) 
Seat 3: Small Blind ($1000.04 in chips) 
Small Blind: posts small blind $2.50
Hero: posts big blind $5
*** HOLE CARDS ***
Dealt to Hero [5c Kh]
Dealer: folds 
Small Blind: raises $7.50 to $12.50
Hero: calls $7.50
*** FLOP *** [2d Jd As]
Small Blind: checks 
Hero: checks 
*** TURN *** [2d Jd As] [6h]
Small Blind: bets $11.88
Hero: calls $11.88
*** RIVER *** [2d Jd As 6h] [6c]
Small Blind: bets $23.38
Hero: calls $23.38
*** SHOW DOWN ***
Small Blind: shows [8h 9h] (a hand...)
Dealer: shows [3s 6s] (a hand...)
Hero: shows [5c Kh] (a hand...)
Hero collected $93.52 from pot
*** SUMMARY ***
Total pot $95.52 | Rake $2.00
Board [2d Jd As 6h 6c]
Seat 1: Hero showed [5c Kh] and won ($93.52)
Seat 2: Dealer folded
Seat 3: Small Blind showed [8h 9h] and lost with...



PokerStars Hand #3951189246:  Hold'em No Limit ($2.50/$5) - 2020/05/26 17:47:06 ET
Table 'Zone Poker ID 1588' 9-max Seat #3 is the button
Seat 1: Small Blind ($500.00 in chips) 
Seat 2: Big Blind ($985.60 in chips) 
Seat 3: Hero ($703.55 in chips) 
Small Blind: posts small blind $2.50
Big Blind: posts big blind $5
*** HOLE CARDS ***
Dealt to Hero [Ts Kh]
Hero: raises $7.50 to $12.50
Small Blind: folds 
Big Blind: calls $7.50
*** FLOP *** [Kc 8c 5c]
Big Blind: checks 
Hero: checks 
*** TURN *** [Kc 8c 5c] [Jc]
Big Blind: bets $8.07
Hero: calls $8.07
*** RIVER *** [Kc 8c 5c Jc] [2c]
Big Blind: bets $20.82
Hero: calls $20.82
*** SHOW DOWN ***
Small Blind: shows [3c 6c] (a hand...)
Big Blind: shows [Jd 6d] (a hand...)
Hero: shows [Ts Kh] (a hand...)
Big Blind collected $41.64 from pot
Hero collected $41.64 from pot
*** SUMMARY ***
Total pot $85.28 | Rake $2.00
Board [Kc 8c 5c Jc 2c]
Seat 1: Small Blind folded
Seat 2: Big Blind showed [Jd 6d] and won ($41.64)
Seat 3: Hero showed [Ts Kh] and won ($41.64)



PokerStars Hand #3951188251:  Hold'em No Limit ($2.50/$5) - 2020/05/26 17:44:58 ET
Table 'Zone Poker ID 1588' 9-max Seat #3 is the button
Seat 1: Small Blind ($1414.30 in chips) 
Seat 2: Hero ($474.29 in chips) 
Seat 3: Dealer ($1045.03 in chips) 
Small Blind: posts small blind $2.50
Hero: posts big blind $5
*** HOLE CARDS ***
Dealt to Hero [2s Ac]
Dealer: folds 
Small Blind: raises $7.50 to $12.50
Hero: calls $7.50
*** FLOP *** [Ks Kh 4s]
Small Blind: checks 
Hero: checks 
*** TURN *** [Ks Kh 4s] [Kd]
Small Blind: bets $11.88
Hero: calls $11.88
*** RIVER *** [Ks Kh 4s Kd] [Js]
Small Blind: bets $23.38
Hero: folds 
*** SHOW DOWN ***
Small Blind: shows [2d 6s] (a hand...)
Dealer: shows [Qs 6c] (a hand...)
Hero: shows [2s Ac] (a hand...)
Uncalled bet ($23.38) returned to Small Blind
Small Blind collected $46.76 from pot
*** SUMMARY ***
Total pot $48.76 | Rake $2.00
Board [Ks Kh 4s Kd Js]
Seat 1: Small Blind collected ($46.76)
Seat 2: Hero folded
Seat 3: Dealer folded



PokerStars Hand #3951142456:  Hold'em No Limit ($2.50/$5) - 2020/05/26 16:00:21 ET
Table 'Zone Poker ID 1588' 9-max Seat #2 is the button
Seat 1: Big Blind ($212.74 in chips) 
Seat 2: Hero ($737.82 in chips) 
Seat 3: Small Blind ($1174.84 in chips) 
Small Blind: posts small blind $2.50
Big Blind: posts big blind $5
*** HOLE CARDS ***
Dealt to Hero [9d Ad]
Hero: raises $7.50 to $12.50
Small Blind: folds 
Big Blind: raises $27.50 to $40
Hero: calls $27.50
*** FLOP *** [6s 5h Ac]
Big Blind: checks 
Hero: checks 
*** TURN *** [6s 5h Ac] [Js]
Big Blind: bets $40.25
Hero: calls $40.25
*** RIVER *** [6s 5h Ac Js] [2c]
Big Blind: bets $132.49 and is all-in
Hero: calls $132.49
*** SHOW DOWN ***
Small Blind: shows [Kh 8s] (a hand...)
Big Blind: shows [As Ks] (a hand...)
Hero: shows [9d Ad] (a hand...)
Big Blind collected $425.98 from pot
*** SUMMARY ***
Total pot $427.98 | Rake $2.00
Board [6s 5h Ac Js 2c]
Seat 1: Big Blind showed [As Ks] and won ($425.98)
Seat 2: Hero showed [9d Ad] and lost with...
Seat 3: Small Blind folded



PokerStars Hand #3951068422:  Hold'em No Limit ($2.50/$5) - 2020/05/26 12:40:29 ET
Table 'Zone Poker ID 1588' 9-max Seat #1 is the button
Seat 1: Dealer ($904.21 in chips) 
Seat 2: Hero ($500.00 in chips) 
Seat 3: Big Blind ($514.20 in chips) 
Hero: posts small blind $2.50
Big Blind: posts big blind $5
*** HOLE CARDS ***
Dealt to Hero [Jh Qs]
Dealer: folds 
Hero: raises $10.00 to $15
Big Blind: raises $30 to $45
Hero: calls $30
*** FLOP *** [2s 6s 9s]
Hero: checks 
Big Blind: bets $44
Hero: calls $44
*** TURN *** [2s 6s 9s] [Jc]
Hero: checks 
Big Blind: bets $88
Hero: calls $88
*** RIVER *** [2s 6s 9s Jc] [Tc]
Hero: checks 
Big Blind: bets $337.20 and is all-in
Hero: folds 
*** SHOW DOWN ***
Dealer: shows [9d 3h] (a hand...)
Big Blind: shows [Kh As] (a hand...)
Hero: shows [Jh Qs] (a hand...)
Uncalled bet ($337.20) returned to Big Blind
Big Blind collected $352 from pot
*** SUMMARY ***
Total pot $354.00 | Rake $2.00
Board [2s 6s 9s Jc Tc]
Seat 1: Dealer folded
Seat 2: Hero folded
Seat 3: Big Blind collected ($352)



PokerStars Hand #3951064325:  Hold'em No Limit ($2.50/$5) - 2020/05/26 12:26:31 ET
Table 'Zone Poker ID 1588' 9-max Seat #2 is the button
Seat 1: UTG ($522.82 in chips) 
Seat 2: Dealer ($1678.43 in chips) 
Seat 3: Small Blind ($562.03 in chips) 
Seat 4: Hero ($612.45 in chips) 
Small Blind: posts small blind $2.50
Hero: posts big blind $5
*** HOLE CARDS ***
Dealt to Hero [As Td]
UTG: folds 
Dealer: raises $7 to $12
Small Blind: folds 
Hero: calls $7
*** FLOP *** [8h Qd 4s]
Hero: checks 
Dealer: bets $8.31
Hero: calls $8.31
*** TURN *** [8h Qd 4s] [Qc]
Hero: checks 
Dealer: bets $20.49
Hero: calls $20.49
*** RIVER *** [8h Qd 4s Qc] [Jc]
Hero: checks 
Dealer: bets $40.55
Hero: folds 
*** SHOW DOWN ***
Small Blind: shows [Jd 4d] (a hand...)
UTG: shows [2h 4c] (a hand...)
Dealer: shows [7s Qh] (a hand...)
Hero: shows [As Td] (a hand...)
Uncalled bet ($40.55) returned to Dealer
Dealer collected $81.10 from pot
*** SUMMARY ***
Total pot $84.10 | Rake $3.00
Board [8h Qd 4s Qc Jc]
Seat 1: UTG folded
Seat 2: Dealer collected ($81.10)
Seat 3: Small Blind folded
Seat 4: Hero folded



PokerStars Hand #3951062991:  Hold'em No Limit ($2.50/$5) - 2020/05/26 12:21:49 ET
Table 'Zone Poker ID 1588' 9-max Seat #2 is the button
Seat 1: Big Blind ($1407.92 in chips) 
Seat 2: Dealer ($492.50 in chips) 
Seat 3: Hero ($518.38 in chips) 
Hero: posts small blind $2.50
Big Blind: posts big blind $5
*** HOLE CARDS ***
Dealt to Hero [8s Qs]
Dealer: folds 
Hero: raises $10.00 to $15
Big Blind: calls $10
*** FLOP *** [5d Qd 6s]
Hero: bets $8.55
Big Blind: raises $28.55 to $37.10
Hero: calls $28.55
*** TURN *** [5d Qd 6s] [As]
Hero: checks 
Big Blind: bets $76.65
Hero: calls $76.65
*** RIVER *** [5d Qd 6s As] [Kh]
Hero: checks 
Big Blind: bets $181.63
Hero: calls $181.63
*** SHOW DOWN ***
Dealer: shows [7c 3h] (a hand...)
Big Blind: shows [6d 6c] (a hand...)
Hero: shows [8s Qs] (a hand...)
Big Blind collected $618.76 from pot
*** SUMMARY ***
Total pot $620.76 | Rake $2.00
Board [5d Qd 6s As Kh]
Seat 1: Big Blind showed [6d 6c] and won ($618.76)
Seat 2: Dealer folded
Seat 3: Hero showed [8s Qs] and lost with...



PokerStars Hand #3951051915:  Hold'em No Limit ($2.50/$5) - 2020/05/26 11:39:59 ET
Table 'Zone Poker ID 1588' 9-max Seat #5 is the button
Seat 1: Small Blind ($510.00 in chips) 
Seat 2: Big Blind ($791.71 in chips) 
Seat 3: UTG ($675.43 in chips) 
Seat 4: Hero ($665.94 in chips) 
Seat 5: Dealer ($426.09 in chips) 
Small Blind: posts small blind $2.50
Big Blind: posts big blind $5
*** HOLE CARDS ***
Dealt to Hero [8s 7s]
UTG: raises $12.50 to $17.50
Hero: raises $37.50 to $55
Dealer: folds 
Small Blind: folds 
Big Blind: folds 
UTG: calls $37.50
*** FLOP *** [Kc Ac 6c]
UTG: checks 
Hero: checks 
*** TURN *** [Kc Ac 6c] [3d]
UTG: checks 
Hero: checks 
*** RIVER *** [Kc Ac 6c 3d] [3h]
UTG: bets $95.88
Hero: folds 
*** SHOW DOWN ***
Small Blind: shows [2c Kh] (a hand...)
Big Blind: shows [8d Jh] (a hand...)
Hero: shows [8s 7s] (a hand...)
Dealer: shows [7d 6s] (a hand...)
UTG: shows [7h 8h] (a hand...)
Uncalled bet ($95.88) returned to UTG
UTG collected $114.50 from pot
*** SUMMARY ***
Total pot $117.50 | Rake $3.00
Board [Kc Ac 6c 3d 3h]
Seat 1: Small Blind folded
Seat 2: Big Blind folded
Seat 3: UTG collected ($114.50)
Seat 4: Hero folded
Seat 5: Dealer folded



PokerStars Hand #3951051188:  Hold'em No Limit ($2.50/$5) - 2020/05/26 11:37:06 ET
Table 'Zone Poker ID 1588' 9-max Seat #5 is the button
Seat 1: Small Blind ($223.62 in chips) 
Seat 2: Big Blind ($495.00 in chips) 
Seat 3: UTG ($407.08 in chips) 
Seat 4: Hero ($469.65 in chips) 
Seat 5: Dealer ($510.00 in chips) 
Small Blind: posts small blind $2.50
Big Blind: posts big blind $5
*** HOLE CARDS ***
Dealt to Hero [Js Kd]
UTG: folds 
Hero: raises $7.50 to $12.50
Dealer: folds 
Small Blind: calls $10
Big Blind: folds 
*** FLOP *** [3c Ad 9h]
Small Blind: bets $10
Hero: raises $24.25 to $34.25
Small Blind: calls $24.25
*** TURN *** [3c Ad 9h] [Th]
Small Blind: checks 
Hero: checks 
*** RIVER *** [3c Ad 9h Th] [2h]
Small Blind: bets $47.75
Hero: folds 
*** SHOW DOWN ***
Small Blind: shows [Tc Ah] (a hand...)
Big Blind: shows [Qh 9d] (a hand...)
Hero: shows [Js Kd] (a hand...)
Dealer: shows [3h Ac] (a hand...)
UTG: shows [Ts 5h] (a hand...)
Uncalled bet ($47.75) returned to Small Blind
Small Blind collected $95.50 from pot
*** SUMMARY ***
Total pot $98.50 | Rake $3.00
Board [3c Ad 9h Th 2h]
Seat 1: Small Blind collected ($95.50)
Seat 2: Big Blind folded
Seat 3: UTG folded
Seat 4: Hero folded
Seat 5: Dealer folded



PokerStars Hand #3949467268:  Hold'em No Limit ($2.50/$5) - 2020/05/23 17:18:07 ET
Table 'Zone Poker ID 1588' 9-max Seat #1 is the button
Seat 1: Dealer ($1604.20 in chips) 
Seat 2: Small Blind ($1536.28 in chips) 
Seat 3: Hero ($654.28 in chips) 
Seat 4: UTG ($1013.11 in chips) 
Small Blind: posts small blind $2.50
Hero: posts big blind $5
*** HOLE CARDS ***
Dealt to Hero [Qs 8h]
UTG: folds 
Dealer: folds 
Small Blind: raises $10.00 to $15
Hero: calls $10
*** FLOP *** [6c Qc 8c]
Small Blind: bets $9.25
Hero: calls $9.25
*** TURN *** [6c Qc 8c] [2d]
Small Blind: bets $31.14
Hero: calls $31.14
*** RIVER *** [6c Qc 8c 2d] [Ad]
Small Blind: bets $65.65
Hero: calls $65.65
*** SHOW DOWN ***
Small Blind: shows [Qd 6d] (a hand...)
UTG: shows [8s Th] (a hand...)
Dealer: shows [Ah 9c] (a hand...)
Hero: shows [Qs 8h] (a hand...)
Hero collected $239.08 from pot
*** SUMMARY ***
Total pot $242.08 | Rake $3.00
Board [6c Qc 8c 2d Ad]
Seat 1: Dealer folded
Seat 2: Small Blind showed [Qd 6d] and lost with...
Seat 3: Hero showed [Qs 8h] and won ($239.08)
Seat 4: UTG folded



PokerStars Hand #3949466978:  Hold'em No Limit ($2.50/$5) - 2020/05/23 17:17:32 ET
Table 'Zone Poker ID 1588' 9-max Seat #1 is the button
Seat 1: Hero ($1052.63 in chips) 
Seat 2: Small Blind ($545.33 in chips) 
Seat 3: Big Blind ($645.41 in chips) 
Small Blind: posts small blind $2.50
Big Blind: posts big blind $5
*** HOLE CARDS ***
Dealt to Hero [Kh 6h]
Hero: raises $7.50 to $12.50
Small Blind: calls $10
Big Blind: calls $7.50
*** FLOP *** [As Jc Ah]
Small Blind: checks 
Big Blind: checks 
Hero: bets $12.50
Small Blind: calls $12.50
Big Blind: folds 
*** TURN *** [As Jc Ah] [2d]
Small Blind: checks 
Hero: checks 
*** RIVER *** [As Jc Ah 2d] [5h]
Small Blind: bets $30
Hero: folds 
*** SHOW DOWN ***
Small Blind: shows [2c Ac] (a hand...)
Big Blind: shows [Qc 9h] (a hand...)
Hero: shows [Kh 6h] (a hand...)
Uncalled bet ($30.00) returned to Small Blind
Small Blind collected $60.50 from pot
*** SUMMARY ***
Total pot $62.50 | Rake $2.00
Board [As Jc Ah 2d 5h]
Seat 1: Hero folded
Seat 2: Small Blind collected ($60.50)
Seat 3: Big Blind folded



PokerStars Hand #3949466286:  Hold'em No Limit ($2.50/$5) - 2020/05/23 17:16:06 ET
Table 'Zone Poker ID 1588' 9-max Seat #4 is the button
Seat 1: Small Blind ($1553.78 in chips) 
Seat 2: Hero ($1090.04 in chips) 
Seat 3: UTG ($1313.25 in chips) 
Seat 4: Dealer ($620.85 in chips) 
Small Blind: posts small blind $2.50
Hero: posts big blind $5
*** HOLE CARDS ***
Dealt to Hero [Ac 3d]
UTG: folds 
Dealer: raises $7 to $12
Small Blind: folds 
Hero: calls $7
*** FLOP *** [7c 6s Kd]
Hero: checks 
Dealer: bets $8.31
Hero: calls $8.31
*** TURN *** [7c 6s Kd] [Th]
Hero: checks 
Dealer: checks 
*** RIVER *** [7c 6s Kd Th] [4d]
Hero: bets $30.73
Dealer: raises $51.22 to $81.95
Hero: folds 
*** SHOW DOWN ***
Small Blind: shows [Td 5h] (a hand...)
UTG: shows [8h 7d] (a hand...)
Dealer: shows [Ad 2h] (a hand...)
Hero: shows [Ac 3d] (a hand...)
Uncalled bet ($51.22) returned to Dealer
Dealer collected $101.58 from pot
*** SUMMARY ***
Total pot $104.58 | Rake $3.00
Board [7c 6s Kd Th 4d]
Seat 1: Small Blind folded
Seat 2: Hero folded
Seat 3: UTG folded
Seat 4: Dealer collected ($101.58)



PokerStars Hand #3949460300:  Hold'em No Limit ($2.50/$5) - 2020/05/23 17:03:39 ET
Table 'Zone Poker ID 1588' 9-max Seat #3 is the button
Seat 1: Hero ($1317.36 in chips) 
Seat 2: Big Blind ($852.40 in chips) 
Seat 3: Dealer ($573.53 in chips) 
Hero: posts small blind $2.50
Big Blind: posts big blind $5
*** HOLE CARDS ***
Dealt to Hero [Kd Js]
Dealer: raises $7.50 to $12.50
Hero: raises $42.50 to $55
Big Blind: folds 
Dealer: calls $42.50
*** FLOP *** [6c 2d Qs]
Hero: bets $33.90
Dealer: calls $33.90
*** TURN *** [6c 2d Qs] [8h]
Hero: bets $122.45
Dealer: calls $122.45
*** RIVER *** [6c 2d Qs 8h] [Qc]
Hero: checks 
Dealer: bets $362.18 and is all-in
Hero: folds 
*** SHOW DOWN ***
Dealer: shows [Jd Qd] (a hand...)
Big Blind: shows [8s Ad] (a hand...)
Hero: shows [Kd Js] (a hand...)
Uncalled bet ($362.18) returned to Dealer
Dealer collected $425.70 from pot
*** SUMMARY ***
Total pot $427.70 | Rake $2.00
Board [6c 2d Qs 8h Qc]
Seat 1: Hero folded
Seat 2: Big Blind folded
Seat 3: Dealer collected ($425.70)



PokerStars Hand #3949458180:  Hold'em No Limit ($2.50/$5) - 2020/05/23 16:59:15 ET
Table 'Zone Poker ID 1588' 9-max Seat #2 is the button
Seat 1: Big Blind ($792.41 in chips) 
Seat 2: Hero ($1207.63 in chips) 
Seat 3: Small Blind ($1166.91 in chips) 
Small Blind: posts small blind $2.50
Big Blind: posts big blind $5
*** HOLE CARDS ***
Dealt to Hero [Kh 8s]
Hero: raises $7.50 to $12.50
Small Blind: folds 
Big Blind: calls $7.50
*** FLOP *** [4s 2d Qc]
Big Blind: checks 
Hero: bets $7.84
Big Blind: calls $7.84
*** TURN *** [4s 2d Qc] [3c]
Big Blind: checks 
Hero: checks 
*** RIVER *** [4s 2d Qc 3c] [Js]
Big Blind: bets $10.59
Hero: folds 
*** SHOW DOWN ***
Small Blind: shows [As 9d] (a hand...)
Big Blind: shows [Ah 4c] (a hand...)
Hero: shows [Kh 8s] (a hand...)
Uncalled bet ($10.59) returned to Big Blind
Big Blind collected $41.18 from pot
*** SUMMARY ***
Total pot $43.18 | Rake $2.00
Board [4s 2d Qc 3c Js]
Seat 1: Big Blind collected ($41.18)
Seat 2: Hero folded
Seat 3: Small Blind folded



PokerStars Hand #3949457802:  Hold'em No Limit ($2.50/$5) - 2020/05/23 16:58:27 ET
Table 'Zone Poker ID 1588' 9-max Seat #3 is the button
Seat 1: Big Blind ($424.94 in chips) 
Seat 2: Hero ($627.24 in chips) 
Seat 3: Dealer ($1021.96 in chips) 
Seat 4: Small Blind ($1093.26 in chips) 
Small Blind: posts small blind $2.50
Big Blind: posts big blind $5
*** HOLE CARDS ***
Dealt to Hero [Qc Jc]
Hero: raises $7.50 to $12.50
Dealer: folds 
Small Blind: folds 
Big Blind: calls $7.50
*** FLOP *** [Js Ah 9c]
Big Blind: checks 
Hero: bets $7.84
Big Blind: calls $7.84
*** TURN *** [Js Ah 9c] [Th]
Big Blind: checks 
Hero: checks 
*** RIVER *** [Js Ah 9c Th] [4h]
Big Blind: bets $30.77
Hero: folds 
*** SHOW DOWN ***
Small Blind: shows [6d 9d] (a hand...)
Dealer: shows [3c 8s] (a hand...)
Big Blind: shows [Ac 6s] (a hand...)
Hero: shows [Qc Jc] (a hand...)
Uncalled bet ($30.77) returned to Big Blind
Big Blind collected $41.03 from pot
*** SUMMARY ***
Total pot $43.18 | Rake $2.15
Board [Js Ah 9c Th 4h]
Seat 1: Big Blind collected ($41.03)
Seat 2: Hero folded
Seat 3: Dealer folded
Seat 4: Small Blind folded



PokerStars Hand #3949451020:  Hold'em No Limit ($2.50/$5) - 2020/05/23 16:44:16 ET
Table 'Zone Poker ID 1588' 9-max Seat #3 is the button
Seat 1: Small Blind ($1069.42 in chips) 
Seat 2: Hero ($482.50 in chips) 
Seat 3: Dealer ($1072.47 in chips) 
Small Blind: posts small blind $2.50
Hero: posts big blind $5
*** HOLE CARDS ***
Dealt to Hero [Qs Th]
Dealer: raises $6 to $11
Small Blind: folds 
Hero: calls $6
*** FLOP *** [Td Ac 2h]
Hero: checks 
Dealer: bets $7.68
Hero: calls $7.68
*** TURN *** [Td Ac 2h] [7s]
Hero: checks 
Dealer: checks 
*** RIVER *** [Td Ac 2h 7s] [3h]
Hero: checks 
Dealer: bets $18.94
Hero: calls $18.94
*** SHOW DOWN ***
Small Blind: shows [Qd 6h] (a hand...)
Dealer: shows [6c 5h] (a hand...)
Hero: shows [Qs Th] (a hand...)
Hero collected $75.74 from pot
*** SUMMARY ***
Total pot $77.74 | Rake $2.00
Board [Td Ac 2h 7s 3h]
Seat 1: Small Blind folded
Seat 2: Hero showed [Qs Th] and won ($75.74)
Seat 3: Dealer showed [6c 5h] and lost with...



PokerStars Hand #3949450046:  Hold'em No Limit ($2.50/$5) - 2020/05/23 16:42:15 ET
Table 'Zone Poker ID 1588' 9-max Seat #2 is the button
Seat 1: Hero ($594.10 in chips) 
Seat 2: Dealer ($549.63 in chips) 
Seat 3: Small Blind ($420.44 in chips) 
Small Blind: posts small blind $2.50
Hero: posts big blind $5
*** HOLE CARDS ***
Dealt to Hero [8c Kc]
Dealer: raises $5 to $10
Small Blind: folds 
Hero: calls $5
*** FLOP *** [7c Ad 7s]
Hero: checks 
Dealer: bets $7
Hero: calls $7
*** TURN *** [7c Ad 7s] [7h]
Hero: checks 
Dealer: checks 
*** RIVER *** [7c Ad 7s 7h] [Td]
Hero: checks 
Dealer: bets $15
Hero: folds 
*** SHOW DOWN ***
Small Blind: shows [8d Js] (a hand...)
Dealer: shows [Ts 8s] (a hand...)
Hero: shows [8c Kc] (a hand...)
Uncalled bet ($15) returned to Dealer
Dealer collected $34.68 from pot
*** SUMMARY ***
Total pot $36.50 | Rake $1.82
Board [7c Ad 7s 7h Td]
Seat 1: Hero folded
Seat 2: Dealer collected ($34.68)
Seat 3: Small Blind folded



PokerStars Hand #3949346594:  Hold'em No Limit ($2.50/$5) - 2020/05/23 12:38:55 ET
Table 'Zone Poker ID 1588' 9-max Seat #1 is the button
Seat 1: Dealer ($334.78 in chips) 
Seat 2: Small Blind ($1145.16 in chips) 
Seat 3: Hero ($760.90 in chips) 
Seat 4: UTG ($1702.82 in chips) 
Seat 5: UTG+1 ($1242.54 in chips) 
Small Blind: posts small blind $2.50
Hero: posts big blind $5
*** HOLE CARDS ***
Dealt to Hero [8h Ac]
UTG: folds 
UTG+1: raises $7.50 to $12.50
Dealer: folds 
Small Blind: folds 
Hero: calls $7.50
*** FLOP *** [Ad 2h 2c]
Hero: checks 
UTG+1: bets $8.62
Hero: calls $8.62
*** TURN *** [Ad 2h 2c] [7h]
Hero: checks 
UTG+1: checks 
*** RIVER *** [Ad 2h 2c 7h] [Qd]
Hero: checks 
UTG+1: bets $21.26
Hero: calls $21.26
*** SHOW DOWN ***
Small Blind: shows [Qs 5d] (a hand...)
Hero: shows [8h Ac] (a hand...)
Dealer: shows [4s 3h] (a hand...)
UTG: shows [5h Kc] (a hand...)
UTG+1: shows [Jd Tc] (a hand...)
Hero collected $84.26 from pot
*** SUMMARY ***
Total pot $87.26 | Rake $3.00
Board [Ad 2h 2c 7h Qd]
Seat 1: Dealer folded
Seat 2: Small Blind folded
Seat 3: Hero showed [8h Ac] and won ($84.26)
Seat 4: UTG folded
Seat 5: UTG+1 showed [Jd Tc] and lost with...



PokerStars Hand #3949345259:  Hold'em No Limit ($2.50/$5) - 2020/05/23 12:35:01 ET
Table 'Zone Poker ID 1588' 9-max Seat #5 is the button
Seat 1: Small Blind ($1676.93 in chips) 
Seat 2: Big Blind ($284.84 in chips) 
Seat 3: UTG ($510.00 in chips) 
Seat 4: UTG+1 ($478.40 in chips) 
Seat 5: Hero ($939.90 in chips) 
Small Blind: posts small blind $2.50
Big Blind: posts big blind $5
*** HOLE CARDS ***
Dealt to Hero [Qh As]
UTG: folds 
UTG+1: raises $7.50 to $12.50
Hero: raises $27.50 to $40
Small Blind: folds 
Big Blind: folds 
UTG+1: raises $72.50 to $112.50
Hero: calls $72.50
*** FLOP *** [5h 9h 6c]
UTG+1: bets $61.50
Hero: calls $61.50
*** TURN *** [5h 9h 6c] [Kh]
UTG+1: checks 
Hero: checks 
*** RIVER *** [5h 9h 6c Kh] [2s]
UTG+1: bets $117.50
Hero: folds 
*** SHOW DOWN ***
Small Blind: shows [6h Ad] (a hand...)
Big Blind: shows [Tc 2d] (a hand...)
Hero: shows [Qh As] (a hand...)
UTG: shows [Ks 3d] (a hand...)
UTG+1: shows [Ah Kc] (a hand...)
Uncalled bet ($117.50) returned to UTG+1
UTG+1 collected $352.50 from pot
*** SUMMARY ***
Total pot $355.50 | Rake $3.00
Board [5h 9h 6c Kh 2s]
Seat 1: Small Blind folded
Seat 2: Big Blind folded
Seat 3: UTG folded
Seat 4: UTG+1 collected ($352.50)
Seat 5: Hero folded



PokerStars Hand #3949341438:  Hold'em No Limit ($2.50/$5) - 2020/05/23 12:23:51 ET
Table 'Zone Poker ID 1588' 9-max Seat #1 is the button
Seat 1: Dealer ($606.38 in chips) 
Seat 2: Small Blind ($511.37 in chips) 
Seat 3: Hero ($1178.65 in chips) 
Seat 4: UTG ($262.64 in chips) 
Seat 5: UTG+1 ($550.04 in chips) 
Small Blind: posts small blind $2.50
Hero: posts big blind $5
*** HOLE CARDS ***
Dealt to Hero [8h 5h]
UTG: folds 
UTG+1: folds 
Dealer: raises $7.50 to $12.50
Small Blind: folds 
Hero: calls $7.50
*** FLOP *** [Th 5d As]
Hero: checks 
Dealer: checks 
*** TURN *** [Th 5d As] [4h]
Hero: checks 
Dealer: checks 
*** RIVER *** [Th 5d As 4h] [2d]
Hero: checks 
Dealer: bets $13.07
Hero: folds 
*** SHOW DOWN ***
Small Blind: shows [3h 8c] (a hand...)
Hero: shows [8h 5h] (a hand...)
Dealer: shows [3d 3c] (a hand...)
UTG: shows [Ac 8d] (a hand...)
UTG+1: shows [7s Qh] (a hand...)
Uncalled bet ($13.07) returned to Dealer
Dealer collected $26.13 from pot
*** SUMMARY ***
Total pot $27.50 | Rake $1.37
Board [Th 5d As 4h 2d]
Seat 1: Dealer collected ($26.13)
Seat 2: Small Blind folded
Seat 3: Hero folded
Seat 4: UTG folded
Seat 5: UTG+1 folded



PokerStars Hand #3949340774:  Hold'em No Limit ($2.50/$5) - 2020/05/23 12:21:53 ET
Table 'Zone Poker ID 1588' 9-max Seat #5 is the button
Seat 1: Small Blind ($660.99 in chips) 
Seat 2: Hero ($961.84 in chips) 
Seat 3: UTG ($663.11 in chips) 
Seat 4: UTG+1 ($493.38 in chips) 
Seat 5: Dealer ($554.00 in chips) 
Small Blind: posts small blind $2.50
Hero: posts big blind $5
*** HOLE CARDS ***
Dealt to Hero [8c 7h]
UTG: folds 
UTG+1: folds 
Dealer: folds 
Small Blind: raises $10.00 to $15
Hero: calls $10
*** FLOP *** [9d Th Jd]
Small Blind: checks 
Hero: bets $20
Small Blind: raises $34.25 to $54.25
Hero: calls $34.25
*** TURN *** [9d Th Jd] [6s]
Small Blind: bets $101.63
Hero: calls $101.63
*** RIVER *** [9d Th Jd 6s] [Ts]
Small Blind: bets $112.91
Hero: calls $112.91
*** SHOW DOWN ***
Small Blind: shows [7s 8d] (a hand...)
Hero: shows [8c 7h] (a hand...)
Dealer: shows [2c 8h] (a hand...)
UTG: shows [9c 7c] (a hand...)
UTG+1: shows [3h Qc] (a hand...)
Small Blind collected $282.29 from pot
Hero collected $282.29 from pot
*** SUMMARY ***
Total pot $567.58 | Rake $3.00
Board [9d Th Jd 6s Ts]
Seat 1: Small Blind showed [7s 8d] and won ($282.29)
Seat 2: Hero showed [8c 7h] and won ($282.29)
Seat 3: UTG folded
Seat 4: UTG+1 folded
Seat 5: Dealer folded



PokerStars Hand #3949339945:  Hold'em No Limit ($2.50/$5) - 2020/05/23 12:19:24 ET
Table 'Zone Poker ID 1588' 9-max Seat #2 is the button
Seat 1: UTG+1 ($1190.27 in chips) 
Seat 2: Dealer ($522.50 in chips) 
Seat 3: Small Blind ($510.00 in chips) 
Seat 4: Hero ($963.90 in chips) 
Seat 5: UTG ($492.50 in chips) 
Small Blind: posts small blind $2.50
Hero: posts big blind $5
*** HOLE CARDS ***
Dealt to Hero [5d Ah]
UTG: folds 
UTG+1: folds 
Dealer: raises $10 to $15
Small Blind: folds 
Hero: calls $10
*** FLOP *** [6d 2h Ad]
Hero: checks 
Dealer: bets $17
Hero: calls $17
*** TURN *** [6d 2h Ad] [Td]
Hero: checks 
Dealer: checks 
*** RIVER *** [6d 2h Ad Td] [7s]
Hero: checks 
Dealer: bets $38
Hero: folds 
*** SHOW DOWN ***
Small Blind: shows [6s 9h] (a hand...)
Hero: shows [5d Ah] (a hand...)
Dealer: shows [8d Qs] (a hand...)
UTG: shows [5c 7c] (a hand...)
UTG+1: shows [Js 9c] (a hand...)
Uncalled bet ($38) returned to Dealer
Dealer collected $63.50 from pot
*** SUMMARY ***
Total pot $66.50 | Rake $3.00
Board [6d 2h Ad Td 7s]
Seat 1: UTG+1 folded
Seat 2: Dealer collected ($63.50)
Seat 3: Small Blind folded
Seat 4: Hero folded
Seat 5: UTG folded



PokerStars Hand #3949336792:  Hold'em No Limit ($2.50/$5) - 2020/05/23 12:10:07 ET
Table 'Zone Poker ID 1588' 9-max Seat #4 is the button
Seat 1: Big Blind ($843.36 in chips) 
Seat 2: UTG ($466.84 in chips) 
Seat 3: UTG+1 ($596.95 in chips) 
Seat 4: Hero ($1105.31 in chips) 
Seat 5: Small Blind ($515.10 in chips) 
Small Blind: posts small blind $2.50
Big Blind: posts big blind $5
*** HOLE CARDS ***
Dealt to Hero [Th 9h]
UTG: folds 
UTG+1: folds 
Hero: raises $7.50 to $12.50
Small Blind: folds 
Big Blind: calls $7.50
*** FLOP *** [9c 5h 8s]
Big Blind: checks 
Hero: checks 
*** TURN *** [9c 5h 8s] [9d]
Big Blind: bets $13.07
Hero: calls $13.07
*** RIVER *** [9c 5h 8s 9d] [4c]
Big Blind: bets $70.96
Hero: calls $70.96
*** SHOW DOWN ***
Small Blind: shows [8h Kc] (a hand...)
Big Blind: shows [Td 7d] (a hand...)
Hero: shows [Th 9h] (a hand...)
UTG: shows [Qd 6s] (a hand...)
UTG+1: shows [2h Qc] (a hand...)
Hero collected $192.56 from pot
*** SUMMARY ***
Total pot $195.56 | Rake $3.00
Board [9c 5h 8s 9d 4c]
Seat 1: Big Blind showed [Td 7d] and lost with...
Seat 2: UTG folded
Seat 3: UTG+1 folded
Seat 4: Hero showed [Th 9h] and won ($192.56)
Seat 5: Small Blind folded



PokerStars Hand #3949336322:  Hold'em No Limit ($2.50/$5) - 2020/05/23 12:08:43 ET
Table 'Zone Poker ID 1588' 9-max Seat #4 is the button
Seat 1: Big Blind ($512.59 in chips) 
Seat 2: UTG ($1342.16 in chips) 
Seat 3: Hero ($1028.31 in chips) 
Seat 4: Dealer ($495.00 in chips) 
Seat 5: Small Blind ($669.45 in chips) 
Small Blind: posts small blind $2.50
Big Blind: posts big blind $5
*** HOLE CARDS ***
Dealt to Hero [7s 7h]
UTG: folds 
Hero: raises $7.50 to $12.50
Dealer: folds 
Small Blind: calls $10
Big Blind: folds 
*** FLOP *** [5c 9s Jh]
Small Blind: checks 
Hero: checks 
*** TURN *** [5c 9s Jh] [6h]
Small Blind: bets $18
Hero: calls $18
*** RIVER *** [5c 9s Jh 6h] [4s]
Small Blind: bets $42
Hero: calls $42
*** SHOW DOWN ***
Small Blind: shows [Ac 2c] (a hand...)
Big Blind: shows [7c Ts] (a hand...)
Hero: shows [7s 7h] (a hand...)
Dealer: shows [Th Jc] (a hand...)
UTG: shows [Ks 9c] (a hand...)
Hero collected $147 from pot
*** SUMMARY ***
Total pot $150.00 | Rake $3.00
Board [5c 9s Jh 6h 4s]
Seat 1: Big Blind folded
Seat 2: UTG folded
Seat 3: Hero showed [7s 7h] and won ($147)
Seat 4: Dealer folded
Seat 5: Small Blind showed [Ac 2c] and lost with...



PokerStars Hand #3949333350:  Hold'em No Limit ($2.50/$5) - 2020/05/23 11:59:39 ET
Table 'Zone Poker ID 1588' 9-max Seat #5 is the button
Seat 1: Big Blind ($731.25 in chips) 
Seat 2: UTG ($252.63 in chips) 
Seat 3: UTG+1 ($631.45 in chips) 
Seat 4: Hero ($1066.57 in chips) 
Seat 5: Dealer ($527.71 in chips) 
Seat 6: Small Blind ($612.72 in chips) 
Small Blind: posts small blind $2.50
Big Blind: posts big blind $5
*** HOLE CARDS ***
Dealt to Hero [8s 9s]
UTG: folds 
UTG+1: folds 
Hero: raises $7.50 to $12.50
Dealer: raises $27.50 to $40
Small Blind: folds 
Big Blind: folds 
Hero: calls $27.50
*** FLOP *** [7d 2c 2s]
Hero: checks 
Dealer: checks 
*** TURN *** [7d 2c 2s] [Ad]
Hero: checks 
Dealer: checks 
*** RIVER *** [7d 2c 2s Ad] [Qs]
Hero: checks 
Dealer: bets $62.63
Hero: folds 
*** SHOW DOWN ***
Small Blind: shows [Kc 3s] (a hand...)
Big Blind: shows [7s 4d] (a hand...)
Hero: shows [8s 9s] (a hand...)
Dealer: shows [9c Ac] (a hand...)
UTG: shows [Jh 9d] (a hand...)
UTG+1: shows [6d 9h] (a hand...)
Uncalled bet ($62.63) returned to Dealer
Dealer collected $83.50 from pot
*** SUMMARY ***
Total pot $87.50 | Rake $4.00
Board [7d 2c 2s Ad Qs]
Seat 1: Big Blind folded
Seat 2: UTG folded
Seat 3: UTG+1 folded
Seat 4: Hero folded
Seat 5: Dealer collected ($83.50)
Seat 6: Small Blind folded



PokerStars Hand #3949329000:  Hold'em No Limit ($2.50/$5) - 2020/05/23 11:46:16 ET
Table 'Zone Poker ID 1588' 9-max Seat #2 is the button
Seat 1: UTG ($1301.47 in chips) 
Seat 2: Dealer ($696.04 in chips) 
Seat 3: Small Blind ($574.13 in chips) 
Seat 4: Hero ($982.94 in chips) 
Small Blind: posts small blind $2.50
Hero: posts big blind $5
*** HOLE CARDS ***
Dealt to Hero [Js 7h]
UTG: folds 
Dealer: folds 
Small Blind: raises $10.00 to $15
Hero: calls $10
*** FLOP *** [3d Qs Tc]
Small Blind: checks 
Hero: bets $8.55
Small Blind: calls $8.55
*** TURN *** [3d Qs Tc] [Th]
Small Blind: checks 
Hero: checks 
*** RIVER *** [3d Qs Tc Th] [6c]
Small Blind: bets $22.38
Hero: folds 
*** SHOW DOWN ***
Small Blind: shows [8h 8c] (a hand...)
UTG: shows [4c 8d] (a hand...)
Dealer: shows [Ks 4s] (a hand...)
Hero: shows [Js 7h] (a hand...)
Uncalled bet ($22.38) returned to Small Blind
Small Blind collected $44.75 from pot
*** SUMMARY ***
Total pot $47.10 | Rake $2.35
Board [3d Qs Tc Th 6c]
Seat 1: UTG folded
Seat 2: Dealer folded
Seat 3: Small Blind collected ($44.75)
Seat 4: Hero folded



PokerStars Hand #3949325748:  Hold'em No Limit ($2.50/$5) - 2020/05/23 11:36:45 ET
Table 'Zone Poker ID 1588' 9-max Seat #2 is the button
Seat 1: Big Blind ($614.30 in chips) 
Seat 2: Hero ($876.32 in chips) 
Seat 3: Small Blind ($618.78 in chips) 
Small Blind: posts small blind $2.50
Big Blind: posts big blind $5
*** HOLE CARDS ***
Dealt to Hero [3s 4s]
Hero: raises $7.50 to $12.50
Small Blind: calls $10
Big Blind: calls $7.50
*** FLOP *** [Qs 2d 8d]
Small Blind: checks 
Big Blind: checks 
Hero: checks 
*** TURN *** [Qs 2d 8d] [Ts]
Small Blind: bets $22
Big Blind: calls $22
Hero: calls $22
*** RIVER *** [Qs 2d 8d Ts] [Jh]
Small Blind: bets $85
Big Blind: folds 
Hero: folds 
*** SHOW DOWN ***
Small Blind: shows [3c 3h] (a hand...)
Big Blind: shows [7c Qc] (a hand...)
Hero: shows [3s 4s] (a hand...)
Uncalled bet ($85.00) returned to Small Blind
Small Blind collected $101.50 from pot
*** SUMMARY ***
Total pot $103.50 | Rake $2.00
Board [Qs 2d 8d Ts Jh]
Seat 1: Big Blind folded
Seat 2: Hero folded
Seat 3: Small Blind collected ($101.50)



PokerStars Hand #3949103158:  Hold'em No Limit ($2.50/$5) - 2020/05/23 00:42:14 ET
Table 'Zone Poker ID 1588' 9-max Seat #5 is the button
Seat 1: Small Blind ($547.19 in chips) 
Seat 2: Hero ($695.86 in chips) 
Seat 3: UTG ($281.38 in chips) 
Seat 4: UTG+1 ($1169.37 in chips) 
Seat 5: Dealer ($677.38 in chips) 
Small Blind: posts small blind $2.50
Hero: posts big blind $5
*** HOLE CARDS ***
Dealt to Hero [Ks 8d]
UTG: folds 
UTG+1: folds 
Dealer: folds 
Small Blind: raises $10.00 to $15
Hero: calls $10
*** FLOP *** [Ts Th 7c]
Small Blind: bets $9.25
Hero: calls $9.25
*** TURN *** [Ts Th 7c] [Jc]
Small Blind: checks 
Hero: checks 
*** RIVER *** [Ts Th 7c Jc] [5c]
Small Blind: bets $28.04
Hero: folds 
*** SHOW DOWN ***
Small Blind: shows [Tc Jh] (a hand...)
Hero: shows [Ks 8d] (a hand...)
Dealer: shows [2c Jd] (a hand...)
UTG: shows [6s Td] (a hand...)
UTG+1: shows [Ad 2h] (a hand...)
Uncalled bet ($28.04) returned to Small Blind
Small Blind collected $46.08 from pot
*** SUMMARY ***
Total pot $48.50 | Rake $2.42
Board [Ts Th 7c Jc 5c]
Seat 1: Small Blind collected ($46.08)
Seat 2: Hero folded
Seat 3: UTG folded
Seat 4: UTG+1 folded
Seat 5: Dealer folded



PokerStars Hand #3949102714:  Hold'em No Limit ($2.50/$5) - 2020/05/23 00:41:35 ET
Table 'Zone Poker ID 1588' 9-max Seat #4 is the button
Seat 1: Hero ($490.00 in chips) 
Seat 2: UTG ($1190.37 in chips) 
Seat 3: UTG+1 ($682.38 in chips) 
Seat 4: Dealer ($1084.48 in chips) 
Seat 5: Small Blind ($396.41 in chips) 
Small Blind: posts small blind $2.50
Hero: posts big blind $5
*** HOLE CARDS ***
Dealt to Hero [Td 6d]
UTG: folds 
UTG+1: folds 
Dealer: raises $7 to $12
Small Blind: folds 
Hero: calls $7
*** FLOP *** [7d Ts 9h]
Hero: checks 
Dealer: bets $16
Hero: calls $16
*** TURN *** [7d Ts 9h] [Ac]
Hero: checks 
Dealer: checks 
*** RIVER *** [7d Ts 9h Ac] [7s]
Hero: checks 
Dealer: bets $48
Hero: folds 
*** SHOW DOWN ***
Small Blind: shows [Kd 2h] (a hand...)
Hero: shows [Td 6d] (a hand...)
Dealer: shows [7c 8s] (a hand...)
UTG: shows [Tc 3s] (a hand...)
UTG+1: shows [5d Qh] (a hand...)
Uncalled bet ($48) returned to Dealer
Dealer collected $55.58 from pot
*** SUMMARY ***
Total pot $58.50 | Rake $2.92
Board [7d Ts 9h Ac 7s]
Seat 1: Hero folded
Seat 2: UTG folded
Seat 3: UTG+1 folded
Seat 4: Dealer collected ($55.58)
Seat 5: Small Blind folded



PokerStars Hand #3949102410:  Hold'em No Limit ($2.50/$5) - 2020/05/23 00:41:09 ET
Table 'Zone Poker ID 1588' 9-max Seat #3 is the button
Seat 1: UTG+1 ($490.00 in chips) 
Seat 2: Hero ($741.15 in chips) 
Seat 3: Dealer ($225.09 in chips) 
Seat 4: Small Blind ($1202.87 in chips) 
Seat 5: Big Blind ($564.23 in chips) 
Seat 6: UTG ($500.00 in chips) 
Small Blind: posts small blind $2.50
Big Blind: posts big blind $5
*** HOLE CARDS ***
Dealt to Hero [Ad Td]
UTG: folds 
UTG+1: folds 
Hero: raises $7.50 to $12.50
Dealer: calls $12.50
Small Blind: calls $10
Big Blind: folds 
*** FLOP *** [3h 8c Qh]
Small Blind: checks 
Hero: checks 
Dealer: checks 
*** TURN *** [3h 8c Qh] [5h]
Small Blind: checks 
Hero: checks 
Dealer: checks 
*** RIVER *** [3h 8c Qh 5h] [Kh]
Small Blind: checks 
Hero: bets $30.29
Dealer: raises $45.48 to $75.77
Small Blind: folds 
Hero: folds 
*** SHOW DOWN ***
Small Blind: shows [6c As] (a hand...)
Big Blind: shows [3d 9h] (a hand...)
Hero: shows [Ad Td] (a hand...)
Dealer: shows [Jh Ks] (a hand...)
UTG: shows [Qs 6d] (a hand...)
UTG+1: shows [3s Jc] (a hand...)
Uncalled bet ($45.48) returned to Dealer
Dealer collected $99.08 from pot
*** SUMMARY ***
Total pot $103.08 | Rake $4.00
Board [3h 8c Qh 5h Kh]
Seat 1: UTG+1 folded
Seat 2: Hero folded
Seat 3: Dealer collected ($99.08)
Seat 4: Small Blind folded
Seat 5: Big Blind folded
Seat 6: UTG folded



PokerStars Hand #3949101799:  Hold'em No Limit ($2.50/$5) - 2020/05/23 00:40:15 ET
Table 'Zone Poker ID 1588' 9-max Seat #5 is the button
Seat 1: Small Blind ($705.88 in chips) 
Seat 2: Big Blind ($1163.37 in chips) 
Seat 3: Hero ($781.15 in chips) 
Seat 4: UTG+1 ($328.11 in chips) 
Seat 5: Dealer ($701.39 in chips) 
Small Blind: posts small blind $2.50
Big Blind: posts big blind $5
*** HOLE CARDS ***
Dealt to Hero [Ks Qs]
Hero: raises $7.50 to $12.50
UTG+1: folds 
Dealer: folds 
Small Blind: folds 
Big Blind: raises $27.50 to $40
Hero: calls $27.50
*** FLOP *** [8c 6c 9h]
Big Blind: checks 
Hero: checks 
*** TURN *** [8c 6c 9h] [5d]
Big Blind: checks 
Hero: checks 
*** RIVER *** [8c 6c 9h 5d] [Ad]
Big Blind: bets $39.75
Hero: folds 
*** SHOW DOWN ***
Small Blind: shows [7c 8d] (a hand...)
Big Blind: shows [As Qc] (a hand...)
Hero: shows [Ks Qs] (a hand...)
Dealer: shows [7s 9c] (a hand...)
UTG+1: shows [4c Kc] (a hand...)
Uncalled bet ($39.75) returned to Big Blind
Big Blind collected $79.50 from pot
*** SUMMARY ***
Total pot $82.50 | Rake $3.00
Board [8c 6c 9h 5d Ad]
Seat 1: Small Blind folded
Seat 2: Big Blind collected ($79.50)
Seat 3: Hero folded
Seat 4: UTG+1 folded
Seat 5: Dealer folded



PokerStars Hand #3949097750:  Hold'em No Limit ($2.50/$5) - 2020/05/23 00:34:07 ET
Table 'Zone Poker ID 1588' 9-max Seat #1 is the button
Seat 1: Dealer ($502.50 in chips) 
Seat 2: Small Blind ($1859.31 in chips) 
Seat 3: Hero ($1219.63 in chips) 
Seat 4: UTG ($475.85 in chips) 
Small Blind: posts small blind $2.50
Hero: posts big blind $5
*** HOLE CARDS ***
Dealt to Hero [6h 7c]
UTG: folds 
Dealer: raises $5 to $10
Small Blind: folds 
Hero: calls $5
*** FLOP *** [5c 8d As]
Hero: checks 
Dealer: bets $6
Hero: raises $25.04 to $31.04
Dealer: calls $25.04
*** TURN *** [5c 8d As] [6s]
Hero: bets $61.19
Dealer: calls $61.19
*** RIVER *** [5c 8d As 6s] [Td]
Hero: checks 
Dealer: bets $66.98
Hero: folds 
*** SHOW DOWN ***
Small Blind: shows [7h 2h] (a hand...)
UTG: shows [5s 3h] (a hand...)
Dealer: shows [Ad Ah] (a hand...)
Hero: shows [6h 7c] (a hand...)
Uncalled bet ($66.98) returned to Dealer
Dealer collected $203.96 from pot
*** SUMMARY ***
Total pot $206.96 | Rake $3.00
Board [5c 8d As 6s Td]
Seat 1: Dealer collected ($203.96)
Seat 2: Small Blind folded
Seat 3: Hero folded
Seat 4: UTG folded



PokerStars Hand #3949092425:  Hold'em No Limit ($2.50/$5) - 2020/05/23 00:26:08 ET
Table 'Zone Poker ID 1588' 9-max Seat #4 is the button
Seat 1: Hero ($495.00 in chips) 
Seat 2: Big Blind ($500.00 in chips) 
Seat 3: UTG ($1576.99 in chips) 
Seat 4: Dealer ($852.63 in chips) 
Hero: posts small blind $2.50
Big Blind: posts big blind $5
*** HOLE CARDS ***
Dealt to Hero [9h 8h]
UTG: raises $7.50 to $12.50
Dealer: folds 
Hero: raises $42.50 to $55
Big Blind: folds 
UTG: calls $42.50
*** FLOP *** [8c 4h Jc]
Hero: checks 
UTG: checks 
*** TURN *** [8c 4h Jc] [9c]
Hero: checks 
UTG: checks 
*** RIVER *** [8c 4h Jc 9c] [2s]
Hero: bets $92
UTG: raises $168 to $260
Hero: calls $168
*** SHOW DOWN ***
UTG: shows [2c 2d] (a hand...)
Dealer: shows [7s Kh] (a hand...)
Big Blind: shows [Ah 3h] (a hand...)
Hero: shows [9h 8h] (a hand...)
UTG collected $632 from pot
*** SUMMARY ***
Total pot $635.00 | Rake $3.00
Board [8c 4h Jc 9c 2s]
Seat 1: Hero showed [9h 8h] and lost with...
Seat 2: Big Blind folded
Seat 3: UTG showed [2c 2d] and won ($632)
Seat 4: Dealer folded



PokerStars Hand #3949085754:  Hold'em No Limit ($2.50/$5) - 2020/05/23 00:16:13 ET
Table 'Zone Poker ID 1588' 9-max Seat #3 is the button
Seat 1: Small Blind ($515.63 in chips) 
Seat 2: Hero ($512.50 in chips) 
Seat 3: Dealer ($463.28 in chips) 
Small Blind: posts small blind $2.50
Hero: posts big blind $5
*** HOLE CARDS ***
Dealt to Hero [Jh Ac]
Dealer: raises $5 to $10
Small Blind: folds 
Hero: calls $5
*** FLOP *** [7s Ts Jc]
Hero: checks 
Dealer: bets $15
Hero: calls $15
*** TURN *** [7s Ts Jc] [6s]
Hero: checks 
Dealer: bets $35
Hero: calls $35
*** RIVER *** [7s Ts Jc 6s] [Qc]
Hero: checks 
Dealer: bets $92
Hero: folds 
*** SHOW DOWN ***
Small Blind: shows [2c 3c] (a hand...)
Dealer: shows [9s 8s] (a hand...)
Hero: shows [Jh Ac] (a hand...)
Uncalled bet ($92) returned to Dealer
Dealer collected $120.50 from pot
*** SUMMARY ***
Total pot $122.50 | Rake $2.00
Board [7s Ts Jc 6s Qc]
Seat 1: Small Blind folded
Seat 2: Hero folded
Seat 3: Dealer collected ($120.50)



PokerStars Hand #3949078472:  Hold'em No Limit ($2.50/$5) - 2020/05/23 00:05:21 ET
Table 'Zone Poker ID 1588' 9-max Seat #3 is the button
Seat 1: Big Blind ($933.68 in chips) 
Seat 2: UTG ($507.13 in chips) 
Seat 3: Hero ($487.50 in chips) 
Seat 4: Small Blind ($422.60 in chips) 
Small Blind: posts small blind $2.50
Big Blind: posts big blind $5
*** HOLE CARDS ***
Dealt to Hero [Kd 7c]
UTG: folds 
Hero: raises $7.50 to $12.50
Small Blind: folds 
Big Blind: calls $7.50
*** FLOP *** [4c Qd 9s]
Big Blind: checks 
Hero: bets $7.84
Big Blind: calls $7.84
*** TURN *** [4c Qd 9s] [2s]
Big Blind: checks 
Hero: checks 
*** RIVER *** [4c Qd 9s 2s] [8s]
Big Blind: bets $20.52
Hero: folds 
*** SHOW DOWN ***
Small Blind: shows [2c 5h] (a hand...)
UTG: shows [Jd 6h] (a hand...)
Big Blind: shows [7d 4d] (a hand...)
Hero: shows [Kd 7c] (a hand...)
Uncalled bet ($20.52) returned to Big Blind
Big Blind collected $41.03 from pot
*** SUMMARY ***
Total pot $43.18 | Rake $2.15
Board [4c Qd 9s 2s 8s]
Seat 1: Big Blind collected ($41.03)
Seat 2: UTG folded
Seat 3: Hero folded
Seat 4: Small Blind folded



PokerStars Hand #3949077539:  Hold'em No Limit ($2.50/$5) - 2020/05/23 00:04:00 ET
Table 'Zone Poker ID 1588' 9-max Seat #2 is the button
Seat 1: UTG ($490.00 in chips) 
Seat 2: Dealer ($497.50 in chips) 
Seat 3: Hero ($495.00 in chips) 
Seat 4: Big Blind ($303.45 in chips) 
Hero: posts small blind $2.50
Big Blind: posts big blind $5
*** HOLE CARDS ***
Dealt to Hero [Ac Th]
UTG: folds 
Dealer: folds 
Hero: raises $10.00 to $15
Big Blind: calls $10
*** FLOP *** [Td Qd 8s]
Hero: checks 
Big Blind: bets $15
Hero: calls $15
*** TURN *** [Td Qd 8s] [Kd]
Hero: checks 
Big Blind: checks 
*** RIVER *** [Td Qd 8s Kd] [9d]
Hero: bets $42.75
Big Blind: raises $71.25 to $114
Hero: folds 
*** SHOW DOWN ***
UTG: shows [7h 3h] (a hand...)
Dealer: shows [2h Jc] (a hand...)
Big Blind: shows [3c Tc] (a hand...)
Hero: shows [Ac Th] (a hand...)
Uncalled bet ($71.25) returned to Big Blind
Big Blind collected $142.50 from pot
*** SUMMARY ***
Total pot $145.50 | Rake $3.00
Board [Td Qd 8s Kd 9d]
Seat 1: UTG folded
Seat 2: Dealer folded
Seat 3: Hero folded
Seat 4: Big Blind collected ($142.50)



PokerStars Hand #3949076551:  Hold'em No Limit ($2.50/$5) - 2020/05/23 00:02:33 ET
Table 'Zone Poker ID 1588' 9-max Seat #4 is the button
Seat 1: Small Blind ($422.98 in chips) 
Seat 2: Big Blind ($624.28 in chips) 
Seat 3: Hero ($605.44 in chips) 
Seat 4: Dealer ($841.22 in chips) 
Small Blind: posts small blind $2.50
Big Blind: posts big blind $5
*** HOLE CARDS ***
Dealt to Hero [Qh Th]
Hero: raises $7.50 to $12.50
Dealer: calls $12.50
Small Blind: folds 
Big Blind: folds 
*** FLOP *** [4d Kc Kd]
Hero: bets $10
Dealer: calls $10
*** TURN *** [4d Kc Kd] [5s]
Hero: bets $37.41
Dealer: calls $37.41
*** RIVER *** [4d Kc Kd 5s] [5d]
Hero: checks 
Dealer: bets $42.16
Hero: folds 
*** SHOW DOWN ***
Small Blind: shows [Ks 3c] (a hand...)
Dealer: shows [5c Ac] (a hand...)
Big Blind: shows [6d 7h] (a hand...)
Hero: shows [Qh Th] (a hand...)
Uncalled bet ($42.16) returned to Dealer
Dealer collected $124.32 from pot
*** SUMMARY ***
Total pot $127.32 | Rake $3.00
Board [4d Kc Kd 5s 5d]
Seat 1: Small Blind folded
Seat 2: Big Blind folded
Seat 3: Hero folded
Seat 4: Dealer collected ($124.32)



PokerStars Hand #3949075892:  Hold'em No Limit ($2.50/$5) - 2020/05/23 00:01:37 ET
Table 'Zone Poker ID 1588' 9-max Seat #3 is the button
Seat 1: Hero ($600.69 in chips) 
Seat 2: UTG ($525.00 in chips) 
Seat 3: Dealer ($399.63 in chips) 
Seat 4: Small Blind ($836.47 in chips) 
Small Blind: posts small blind $2.50
Hero: posts big blind $5
*** HOLE CARDS ***
Dealt to Hero [Td Js]
UTG: folds 
Dealer: raises $7.50 to $12.50
Small Blind: calls $10
Hero: calls $7.50
*** FLOP *** [Jd 3s 2h]
Small Blind: checks 
Hero: checks 
Dealer: checks 
*** TURN *** [Jd 3s 2h] [Kd]
Small Blind: checks 
Hero: checks 
Dealer: checks 
*** RIVER *** [Jd 3s 2h Kd] [Kc]
Small Blind: bets $12.82
Hero: calls $12.82
Dealer: folds 
*** SHOW DOWN ***
Small Blind: shows [Jh Ts] (a hand...)
UTG: shows [4s 9c] (a hand...)
Dealer: shows [9s 9d] (a hand...)
Hero: shows [Td Js] (a hand...)
Hero collected $30.07 from pot
Small Blind collected $30.07 from pot
*** SUMMARY ***
Total pot $63.14 | Rake $3.00
Board [Jd 3s 2h Kd Kc]
Seat 1: Hero showed [Td Js] and won ($30.07)
Seat 2: UTG folded
Seat 3: Dealer folded
Seat 4: Small Blind showed [Jh Ts] and won ($30.07)



PokerStars Hand #3948750601:  Hold'em No Limit ($2.50/$5) - 2020/05/22 14:09:44 ET
Table 'Zone Poker ID 1588' 9-max Seat #3 is the button
Seat 1: Small Blind ($601.82 in chips) 
Seat 2: Hero ($511.72 in chips) 
Seat 3: Dealer ($231.50 in chips) 
Small Blind: posts small blind $2.50
Hero: posts big blind $5
*** HOLE CARDS ***
Dealt to Hero [Jd Ks]
Dealer: folds 
Small Blind: raises $20.00 to $25
Hero: raises $50 to $75
Small Blind: calls $50
*** FLOP *** [Qc Kh 5s]
Small Blind: checks 
Hero: checks 
*** TURN *** [Qc Kh 5s] [Qs]
Small Blind: bets $148
Hero: calls $148
*** RIVER *** [Qc Kh 5s Qs] [8c]
Small Blind: bets $378.82 and is all-in
Hero: calls $288.72 and is all-in
*** SHOW DOWN ***
Small Blind: shows [Jc Th] (a hand...)
Dealer: shows [2h 7d] (a hand...)
Hero: shows [Jd Ks] (a hand...)
Uncalled bet ($90.10) returned to Small Blind
Hero collected $1021.44 from pot
*** SUMMARY ***
Total pot $1023.44 | Rake $2.00
Board [Qc Kh 5s Qs 8c]
Seat 1: Small Blind showed [Jc Th] and lost with...
Seat 2: Hero showed [Jd Ks] and won ($1021.44)
Seat 3: Dealer folded



PokerStars Hand #3948749465:  Hold'em No Limit ($2.50/$5) - 2020/05/22 14:06:56 ET
Table 'Zone Poker ID 1588' 9-max Seat #1 is the button
Seat 1: Dealer ($457.93 in chips) 
Seat 2: Small Blind ($634.83 in chips) 
Seat 3: Hero ($497.50 in chips) 
Small Blind: posts small blind $2.50
Hero: posts big blind $5
*** HOLE CARDS ***
Dealt to Hero [4h As]
Dealer: calls $5
Small Blind: folds 
Hero: checks 
*** FLOP *** [Js 3d 2d]
Hero: checks 
Dealer: checks 
*** TURN *** [Js 3d 2d] [Jd]
Hero: bets $8.91
Dealer: calls $8.91
*** RIVER *** [Js 3d 2d Jd] [4s]
Hero: checks 
Dealer: bets $33.81
Hero: folds 
*** SHOW DOWN ***
Small Blind: shows [Jc 3h] (a hand...)
Dealer: shows [Tc Qc] (a hand...)
Hero: shows [4h As] (a hand...)
Uncalled bet ($33.81) returned to Dealer
Dealer collected $28.81 from pot
*** SUMMARY ***
Total pot $30.32 | Rake $1.51
Board [Js 3d 2d Jd 4s]
Seat 1: Dealer collected ($28.81)
Seat 2: Small Blind folded
Seat 3: Hero folded



PokerStars Hand #3948748117:  Hold'em No Limit ($2.50/$5) - 2020/05/22 14:03:28 ET
Table 'Zone Poker ID 1588' 9-max Seat #2 is the button
Seat 1: Hero ($487.15 in chips) 
Seat 2: Dealer ($527.13 in chips) 
Seat 3: Small Blind ($904.96 in chips) 
Small Blind: posts small blind $2.50
Hero: posts big blind $5
*** HOLE CARDS ***
Dealt to Hero [5s Js]
Dealer: raises $7.50 to $12.50
Small Blind: folds 
Hero: calls $7.50
*** FLOP *** [As Ah 5c]
Hero: checks 
Dealer: bets $8.62
Hero: calls $8.62
*** TURN *** [As Ah 5c] [4h]
Hero: checks 
Dealer: bets $57.74
Hero: calls $57.74
*** RIVER *** [As Ah 5c 4h] [Kd]
Hero: checks 
Dealer: bets $213.22
Hero: folds 
*** SHOW DOWN ***
Small Blind: shows [2c Qh] (a hand...)
Dealer: shows [8h Jh] (a hand...)
Hero: shows [5s Js] (a hand...)
Uncalled bet ($213.22) returned to Dealer
Dealer collected $158.22 from pot
*** SUMMARY ***
Total pot $160.22 | Rake $2.00
Board [As Ah 5c 4h Kd]
Seat 1: Hero folded
Seat 2: Dealer collected ($158.22)
Seat 3: Small Blind folded



PokerStars Hand #3948746823:  Hold'em No Limit ($2.50/$5) - 2020/05/22 14:00:14 ET
Table 'Zone Poker ID 1588' 9-max Seat #4 is the button
Seat 1: Small Blind ($481.38 in chips) 
Seat 2: Hero ($676.62 in chips) 
Seat 3: UTG ($545.08 in chips) 
Seat 4: Dealer ($930.85 in chips) 
Small Blind: posts small blind $2.50
Hero: posts big blind $5
*** HOLE CARDS ***
Dealt to Hero [Kd 4h]
UTG: folds 
Dealer: folds 
Small Blind: raises $7.50 to $12.50
Hero: calls $7.50
*** FLOP *** [Jh Qs Js]
Small Blind: bets $7.84
Hero: calls $7.84
*** TURN *** [Jh Qs Js] [7s]
Small Blind: checks 
Hero: checks 
*** RIVER *** [Jh Qs Js 7s] [Jc]
Small Blind: bets $19.33
Hero: calls $19.33
*** SHOW DOWN ***
Small Blind: shows [Ts Qh] (a hand...)
UTG: shows [9d 5h] (a hand...)
Dealer: shows [2s 7h] (a hand...)
Hero: shows [Kd 4h] (a hand...)
Small Blind collected $76.34 from pot
*** SUMMARY ***
Total pot $79.34 | Rake $3.00
Board [Jh Qs Js 7s Jc]
Seat 1: Small Blind showed [Ts Qh] and won ($76.34)
Seat 2: Hero showed [Kd 4h] and lost with...
Seat 3: UTG folded
Seat 4: Dealer folded



PokerStars Hand #3948745800:  Hold'em No Limit ($2.50/$5) - 2020/05/22 13:57:42 ET
Table 'Zone Poker ID 1588' 9-max Seat #3 is the button
Seat 1: Big Blind ($431.73 in chips) 
Seat 2: UTG ($652.64 in chips) 
Seat 3: Hero ($787.75 in chips) 
Seat 4: Small Blind ($540.69 in chips) 
Small Blind: posts small blind $2.50
Big Blind: posts big blind $5
*** HOLE CARDS ***
Dealt to Hero [Kd Ts]
UTG: folds 
Hero: raises $7.50 to $12.50
Small Blind: folds 
Big Blind: calls $7.50
*** FLOP *** [Th Qd 4h]
Big Blind: checks 
Hero: checks 
*** TURN *** [Th Qd 4h] [Jc]
Big Blind: checks 
Hero: checks 
*** RIVER *** [Th Qd 4h Jc] [5s]
Big Blind: bets $15
Hero: calls $15
*** SHOW DOWN ***
Small Blind: shows [8s Jh] (a hand...)
UTG: shows [3c 9c] (a hand...)
Big Blind: shows [8c 7c] (a hand...)
Hero: shows [Kd Ts] (a hand...)
Hero collected $54.63 from pot
*** SUMMARY ***
Total pot $57.50 | Rake $2.87
Board [Th Qd 4h Jc 5s]
Seat 1: Big Blind showed [8c 7c] and lost with...
Seat 2: UTG folded
Seat 3: Hero showed [Kd Ts] and won ($54.63)
Seat 4: Small Blind folded



PokerStars Hand #3948743933:  Hold'em No Limit ($2.50/$5) - 2020/05/22 13:53:01 ET
Table 'Zone Poker ID 1588' 9-max Seat #1 is the button
Seat 1: Dealer ($912.65 in chips) 
Seat 2: Small Blind ($473.35 in chips) 
Seat 3: Hero ($519.50 in chips) 
Seat 4: UTG ($608.90 in chips) 
Small Blind: posts small blind $2.50
Hero: posts big blind $5
*** HOLE CARDS ***
Dealt to Hero [Tc Ad]
UTG: folds 
Dealer: raises $6 to $11
Small Blind: folds 
Hero: calls $6
*** FLOP *** [7h 3c 5c]
Hero: checks 
Dealer: bets $7.68
Hero: calls $7.68
*** TURN *** [7h 3c 5c] [Td]
Hero: checks 
Dealer: bets $18.94
Hero: calls $18.94
*** RIVER *** [7h 3c 5c Td] [2s]
Hero: checks 
Dealer: bets $42.37
Hero: calls $42.37
*** SHOW DOWN ***
Small Blind: shows [6h 4c] (a hand...)
UTG: shows [8d 5h] (a hand...)
Dealer: shows [Qh Th] (a hand...)
Hero: shows [Tc Ad] (a hand...)
Hero collected $159.48 from pot
*** SUMMARY ***
Total pot $162.48 | Rake $3.00
Board [7h 3c 5c Td 2s]
Seat 1: Dealer showed [Qh Th] and lost with...
Seat 2: Small Blind folded
Seat 3: Hero showed [Tc Ad] and won ($159.48)
Seat 4: UTG folded



PokerStars Hand #3948743835:  Hold'em No Limit ($2.50/$5) - 2020/05/22 13:52:48 ET
Table 'Zone Poker ID 1588' 9-max Seat #3 is the button
Seat 1: Big Blind ($500.00 in chips) 
Seat 2: UTG ($478.35 in chips) 
Seat 3: Hero ($555.00 in chips) 
Seat 4: Small Blind ($476.84 in chips) 
Small Blind: posts small blind $2.50
Big Blind: posts big blind $5
*** HOLE CARDS ***
Dealt to Hero [Qh Qc]
UTG: folds 
Hero: raises $7.50 to $12.50
Small Blind: folds 
Big Blind: calls $7.50
*** FLOP *** [Ad 4c 8h]
Big Blind: checks 
Hero: checks 
*** TURN *** [Ad 4c 8h] [Ac]
Big Blind: bets $26.13
Hero: calls $26.13
*** RIVER *** [Ad 4c 8h Ac] [3h]
Big Blind: bets $5
Hero: calls $5
*** SHOW DOWN ***
Small Blind: shows [Kh 6d] (a hand...)
UTG: shows [2c 5h] (a hand...)
Big Blind: shows [2d 5c] (a hand...)
Hero: shows [Qh Qc] (a hand...)
Big Blind collected $86.76 from pot
*** SUMMARY ***
Total pot $89.76 | Rake $3.00
Board [Ad 4c 8h Ac 3h]
Seat 1: Big Blind showed [2d 5c] and won ($86.76)
Seat 2: UTG folded
Seat 3: Hero showed [Qh Qc] and lost with...
Seat 4: Small Blind folded



PokerStars Hand #3948742580:  Hold'em No Limit ($2.50/$5) - 2020/05/22 13:49:35 ET
Table 'Zone Poker ID 1588' 9-max Seat #4 is the button
Seat 1: Big Blind ($250.00 in chips) 
Seat 2: UTG ($450.01 in chips) 
Seat 3: UTG+1 ($619.21 in chips) 
Seat 4: Hero ($495.00 in chips) 
Seat 5: Small Blind ($1011.96 in chips) 
Small Blind: posts small blind $2.50
Big Blind: posts big blind $5
*** HOLE CARDS ***
Dealt to Hero [7h 8h]
UTG: folds 
UTG+1: folds 
Hero: raises $7.50 to $12.50
Small Blind: calls $10
Big Blind: folds 
*** FLOP *** [2c Qs 3d]
Small Blind: checks 
Hero: bets $8.55
Small Blind: calls $8.55
*** TURN *** [2c Qs 3d] [Td]
Small Blind: checks 
Hero: checks 
*** RIVER *** [2c Qs 3d Td] [Tc]
Small Blind: bets $22.38
Hero: folds 
*** SHOW DOWN ***
Small Blind: shows [Kd Jc] (a hand...)
Big Blind: shows [Kc 3s] (a hand...)
Hero: shows [7h 8h] (a hand...)
UTG: shows [5d Js] (a hand...)
UTG+1: shows [4h 9c] (a hand...)
Uncalled bet ($22.38) returned to Small Blind
Small Blind collected $44.75 from pot
*** SUMMARY ***
Total pot $47.10 | Rake $2.35
Board [2c Qs 3d Td Tc]
Seat 1: Big Blind folded
Seat 2: UTG folded
Seat 3: UTG+1 folded
Seat 4: Hero folded
Seat 5: Small Blind collected ($44.75)



PokerStars Hand #3948739810:  Hold'em No Limit ($2.50/$5) - 2020/05/22 13:42:27 ET
Table 'Zone Poker ID 1588' 9-max Seat #4 is the button
Seat 1: Hero ($514.16 in chips) 
Seat 2: UTG ($1431.57 in chips) 
Seat 3: UTG+1 ($490.00 in chips) 
Seat 4: Dealer ($562.00 in chips) 
Seat 5: Small Blind ($893.16 in chips) 
Small Blind: posts small blind $2.50
Hero: posts big blind $5
*** HOLE CARDS ***
Dealt to Hero [Kh 7c]
UTG: folds 
UTG+1: folds 
Dealer: folds 
Small Blind: raises $7.50 to $12.50
Hero: calls $7.50
*** FLOP *** [Jd 6h Tc]
Small Blind: checks 
Hero: checks 
*** TURN *** [Jd 6h Tc] [8h]
Small Blind: bets $11.88
Hero: calls $11.88
*** RIVER *** [Jd 6h Tc 8h] [4c]
Small Blind: bets $46.33
Hero: folds 
*** SHOW DOWN ***
Small Blind: shows [Qs Qh] (a hand...)
Hero: shows [Kh 7c] (a hand...)
Dealer: shows [Qc 4h] (a hand...)
UTG: shows [3h Js] (a hand...)
UTG+1: shows [3d As] (a hand...)
Uncalled bet ($46.33) returned to Small Blind
Small Blind collected $46.33 from pot
*** SUMMARY ***
Total pot $48.76 | Rake $2.43
Board [Jd 6h Tc 8h 4c]
Seat 1: Hero folded
Seat 2: UTG folded
Seat 3: UTG+1 folded
Seat 4: Dealer folded
Seat 5: Small Blind collected ($46.33)



PokerStars Hand #3948492308:  Hold'em No Limit ($2.50/$5) - 2020/05/22 00:15:46 ET
Table 'Zone Poker ID 1588' 9-max Seat #1 is the button
Seat 1: Dealer ($487.00 in chips) 
Seat 2: Small Blind ($323.39 in chips) 
Seat 3: Big Blind ($1106.40 in chips) 
Seat 4: Hero ($956.90 in chips) 
Small Blind: posts small blind $2.50
Big Blind: posts big blind $5
*** HOLE CARDS ***
Dealt to Hero [Ts Kc]
Hero: raises $7.50 to $12.50
Dealer: folds 
Small Blind: folds 
Big Blind: calls $7.50
*** FLOP *** [5d Ah 5s]
Big Blind: checks 
Hero: bets $7.84
Big Blind: calls $7.84
*** TURN *** [5d Ah 5s] [Qd]
Big Blind: bets $20.52
Hero: calls $20.52
*** RIVER *** [5d Ah 5s Qd] [7s]
Big Blind: bets $60.92
Hero: folds 
*** SHOW DOWN ***
Small Blind: shows [3s 6h] (a hand...)
Dealer: shows [4d Jd] (a hand...)
Big Blind: shows [As 5h] (a hand...)
Hero: shows [Ts Kc] (a hand...)
Uncalled bet ($60.92) returned to Big Blind
Big Blind collected $81.22 from pot
*** SUMMARY ***
Total pot $84.22 | Rake $3.00
Board [5d Ah 5s Qd 7s]
Seat 1: Dealer folded
Seat 2: Small Blind folded
Seat 3: Big Blind collected ($81.22)
Seat 4: Hero folded



PokerStars Hand #3948488717:  Hold'em No Limit ($2.50/$5) - 2020/05/22 00:09:56 ET
Table 'Zone Poker ID 1588' 9-max Seat #1 is the button
Seat 1: Dealer ($611.66 in chips) 
Seat 2: Small Blind ($168.72 in chips) 
Seat 3: Hero ($701.50 in chips) 
Small Blind: posts small blind $2.50
Hero: posts big blind $5
*** HOLE CARDS ***
Dealt to Hero [8c 5c]
Dealer: folds 
Small Blind: raises $5.00 to $10
Hero: calls $5
*** FLOP *** [7c Qs 2c]
Small Blind: bets $20
Hero: calls $20
*** TURN *** [7c Qs 2c] [7h]
Small Blind: bets $20
Hero: calls $20
*** RIVER *** [7c Qs 2c 7h] [Qh]
Small Blind: bets $118.72 and is all-in
Hero: folds 
*** SHOW DOWN ***
Small Blind: shows [Qc 4c] (a hand...)
Dealer: shows [2s 8d] (a hand...)
Hero: shows [8c 5c] (a hand...)
Uncalled bet ($118.72) returned to Small Blind
Small Blind collected $98 from pot
*** SUMMARY ***
Total pot $100.00 | Rake $2.00
Board [7c Qs 2c 7h Qh]
Seat 1: Dealer folded
Seat 2: Small Blind collected ($98)
Seat 3: Hero folded



PokerStars Hand #3948481589:  Hold'em No Limit ($2.50/$5) - 2020/05/21 23:58:29 ET
Table 'Zone Poker ID 1588' 9-max Seat #1 is the button
Seat 1: Dealer ($378.10 in chips) 
Seat 2: Small Blind ($487.50 in chips) 
Seat 3: Hero ($456.09 in chips) 
Small Blind: posts small blind $2.50
Hero: posts big blind $5
*** HOLE CARDS ***
Dealt to Hero [Qs Tc]
Dealer: raises $7.50 to $12.50
Small Blind: folds 
Hero: calls $7.50
*** FLOP *** [4s 8d Jc]
Hero: checks 
Dealer: checks 
*** TURN *** [4s 8d Jc] [Ac]
Hero: checks 
Dealer: checks 
*** RIVER *** [4s 8d Jc Ac] [Ad]
Hero: checks 
Dealer: bets $13.07
Hero: folds 
*** SHOW DOWN ***
Small Blind: shows [5h Jd] (a hand...)
Dealer: shows [8h 9h] (a hand...)
Hero: shows [Qs Tc] (a hand...)
Uncalled bet ($13.07) returned to Dealer
Dealer collected $26.13 from pot
*** SUMMARY ***
Total pot $27.50 | Rake $1.37
Board [4s 8d Jc Ac Ad]
Seat 1: Dealer collected ($26.13)
Seat 2: Small Blind folded
Seat 3: Hero folded



PokerStars Hand #3948479717:  Hold'em No Limit ($2.50/$5) - 2020/05/21 23:55:30 ET
Table 'Zone Poker ID 1588' 9-max Seat #3 is the button
Seat 1: Small Blind ($494.00 in chips) 
Seat 2: Hero ($392.71 in chips) 
Seat 3: Dealer ($725.20 in chips) 
Small Blind: posts small blind $2.50
Hero: posts big blind $5
*** HOLE CARDS ***
Dealt to Hero [Ac Jd]
Dealer: raises $7.50 to $12.50
Small Blind: folds 
Hero: calls $7.50
*** FLOP *** [2s Qs 6d]
Hero: checks 
Dealer: bets $14.60
Hero: calls $14.60
*** TURN *** [2s Qs 6d] [Tc]
Hero: checks 
Dealer: checks 
*** RIVER *** [2s Qs 6d Tc] [Th]
Hero: checks 
Dealer: bets $41.03
Hero: calls $41.03
*** SHOW DOWN ***
Small Blind: shows [5c 4h] (a hand...)
Dealer: shows [Kh 7h] (a hand...)
Hero: shows [Ac Jd] (a hand...)
Hero collected $136.76 from pot
*** SUMMARY ***
Total pot $138.76 | Rake $2.00
Board [2s Qs 6d Tc Th]
Seat 1: Small Blind folded
Seat 2: Hero showed [Ac Jd] and won ($136.76)
Seat 3: Dealer showed [Kh 7h] and lost with...



PokerStars Hand #3948479005:  Hold'em No Limit ($2.50/$5) - 2020/05/21 23:54:22 ET
Table 'Zone Poker ID 1588' 9-max Seat #3 is the button
Seat 1: Hero ($520.00 in chips) 
Seat 2: Big Blind ($505.00 in chips) 
Seat 3: Dealer ($623.21 in chips) 
Hero: posts small blind $2.50
Big Blind: posts big blind $5
*** HOLE CARDS ***
Dealt to Hero [Js Ad]
Dealer: raises $7.50 to $12.50
Hero: raises $42.50 to $55
Big Blind: folds 
Dealer: calls $42.50
*** FLOP *** [Ts 3h 2c]
Hero: bets $33.90
Dealer: calls $33.90
*** TURN *** [Ts 3h 2c] [7s]
Hero: bets $110
Dealer: calls $110
*** RIVER *** [Ts 3h 2c 7s] [6s]
Hero: checks 
Dealer: bets $424.31 and is all-in
Hero: folds 
*** SHOW DOWN ***
Dealer: shows [Td Th] (a hand...)
Big Blind: shows [Ac 5c] (a hand...)
Hero: shows [Js Ad] (a hand...)
Uncalled bet ($424.31) returned to Dealer
Dealer collected $400.80 from pot
*** SUMMARY ***
Total pot $402.80 | Rake $2.00
Board [Ts 3h 2c 7s 6s]
Seat 1: Hero folded
Seat 2: Big Blind folded
Seat 3: Dealer collected ($400.80)



PokerStars Hand #3948477509:  Hold'em No Limit ($2.50/$5) - 2020/05/21 23:51:57 ET
Table 'Zone Poker ID 1588' 9-max Seat #3 is the button
Seat 1: Hero ($502.50 in chips) 
Seat 2: Big Blind ($529.65 in chips) 
Seat 3: Dealer ($374.45 in chips) 
Hero: posts small blind $2.50
Big Blind: posts big blind $5
*** HOLE CARDS ***
Dealt to Hero [Ac Tc]
Dealer: folds 
Hero: raises $10.00 to $15
Big Blind: calls $10
*** FLOP *** [3s Ah Kd]
Hero: bets $8.55
Big Blind: calls $8.55
*** TURN *** [3s Ah Kd] [Jd]
Hero: bets $33.83
Big Blind: calls $33.83
*** RIVER *** [3s Ah Kd Jd] [7d]
Hero: checks 
Big Blind: bets $82.31
Hero: folds 
*** SHOW DOWN ***
Dealer: shows [Js 6d] (a hand...)
Big Blind: shows [Qd 3d] (a hand...)
Hero: shows [Ac Tc] (a hand...)
Uncalled bet ($82.31) returned to Big Blind
Big Blind collected $112.76 from pot
*** SUMMARY ***
Total pot $114.76 | Rake $2.00
Board [3s Ah Kd Jd 7d]
Seat 1: Hero folded
Seat 2: Big Blind collected ($112.76)
Seat 3: Dealer folded



PokerStars Hand #3948342315:  Hold'em No Limit ($2.50/$5) - 2020/05/21 20:22:17 ET
Table 'Zone Poker ID 1588' 9-max Seat #5 is the button
Seat 1: Small Blind ($730.84 in chips) 
Seat 2: Big Blind ($641.60 in chips) 
Seat 3: Hero ($1107.78 in chips) 
Seat 4: UTG+1 ($502.50 in chips) 
Seat 5: Dealer ($450.00 in chips) 
Small Blind: posts small blind $2.50
Big Blind: posts big blind $5
*** HOLE CARDS ***
Dealt to Hero [8c 6c]
Hero: raises $7.50 to $12.50
UTG+1: folds 
Dealer: folds 
Small Blind: folds 
Big Blind: calls $7.50
*** FLOP *** [Js 9h Ad]
Big Blind: checks 
Hero: bets $7.84
Big Blind: calls $7.84
*** TURN *** [Js 9h Ad] [Qd]
Big Blind: checks 
Hero: checks 
*** RIVER *** [Js 9h Ad Qd] [2d]
Big Blind: bets $81.03
Hero: folds 
*** SHOW DOWN ***
Small Blind: shows [3d 3s] (a hand...)
Big Blind: shows [2h Ah] (a hand...)
Hero: shows [8c 6c] (a hand...)
Dealer: shows [Jh Qc] (a hand...)
UTG+1: shows [8h Jc] (a hand...)
Uncalled bet ($81.03) returned to Big Blind
Big Blind collected $41.03 from pot
*** SUMMARY ***
Total pot $43.18 | Rake $2.15
Board [Js 9h Ad Qd 2d]
Seat 1: Small Blind folded
Seat 2: Big Blind collected ($41.03)
Seat 3: Hero folded
Seat 4: UTG+1 folded
Seat 5: Dealer folded



PokerStars Hand #3948335651:  Hold'em No Limit ($2.50/$5) - 2020/05/21 20:10:11 ET
Table 'Zone Poker ID 1588' 9-max Seat #4 is the button
Seat 1: Big Blind ($760.76 in chips) 
Seat 2: UTG ($500.00 in chips) 
Seat 3: Hero ($696.06 in chips) 
Seat 4: Dealer ($423.55 in chips) 
Seat 5: Small Blind ($806.08 in chips) 
Small Blind: posts small blind $2.50
Big Blind: posts big blind $5
*** HOLE CARDS ***
Dealt to Hero [3h 3d]
UTG: folds 
Hero: raises $7.50 to $12.50
Dealer: folds 
Small Blind: folds 
Big Blind: raises $47.50 to $60
Hero: calls $47.50
*** FLOP *** [8c 2d 5c]
Big Blind: bets $64.75
Hero: calls $64.75
*** TURN *** [8c 2d 5c] [8h]
Big Blind: checks 
Hero: checks 
*** RIVER *** [8c 2d 5c 8h] [5s]
Big Blind: bets $168
Hero: folds 
*** SHOW DOWN ***
Small Blind: shows [8d As] (a hand...)
Big Blind: shows [Ad 5d] (a hand...)
Hero: shows [3h 3d] (a hand...)
Dealer: shows [Jd Qs] (a hand...)
UTG: shows [3c 9d] (a hand...)
Uncalled bet ($168.00) returned to Big Blind
Big Blind collected $249 from pot
*** SUMMARY ***
Total pot $252.00 | Rake $3.00
Board [8c 2d 5c 8h 5s]
Seat 1: Big Blind collected ($249)
Seat 2: UTG folded
Seat 3: Hero folded
Seat 4: Dealer folded
Seat 5: Small Blind folded



PokerStars Hand #3948334759:  Hold'em No Limit ($2.50/$5) - 2020/05/21 20:08:36 ET
Table 'Zone Poker ID 1588' 9-max Seat #1 is the button
Seat 1: Dealer ($500.00 in chips) 
Seat 2: Small Blind ($512.50 in chips) 
Seat 3: Big Blind ($518.63 in chips) 
Seat 4: UTG ($273.81 in chips) 
Seat 5: Hero ($986.51 in chips) 
Small Blind: posts small blind $2.50
Big Blind: posts big blind $5
*** HOLE CARDS ***
Dealt to Hero [Qc Jc]
UTG: folds 
Hero: raises $7.50 to $12.50
Dealer: folds 
Small Blind: folds 
Big Blind: raises $37.50 to $50
Hero: calls $37.50
*** FLOP *** [2s 3c 7d]
Big Blind: checks 
Hero: checks 
*** TURN *** [2s 3c 7d] [Qd]
Big Blind: bets $66.33
Hero: calls $66.33
*** RIVER *** [2s 3c 7d Qd] [3d]
Big Blind: bets $174.12
Hero: calls $174.12
*** SHOW DOWN ***
Small Blind: shows [6d Jh] (a hand...)
Big Blind: shows [Qh As] (a hand...)
Hero: shows [Qc Jc] (a hand...)
Dealer: shows [5d 7s] (a hand...)
UTG: shows [Qs Tc] (a hand...)
Big Blind collected $580.40 from pot
*** SUMMARY ***
Total pot $583.40 | Rake $3.00
Board [2s 3c 7d Qd 3d]
Seat 1: Dealer folded
Seat 2: Small Blind folded
Seat 3: Big Blind showed [Qh As] and won ($580.40)
Seat 4: UTG folded
Seat 5: Hero showed [Qc Jc] and lost with...



PokerStars Hand #3948331906:  Hold'em No Limit ($2.50/$5) - 2020/05/21 20:03:24 ET
Table 'Zone Poker ID 1588' 9-max Seat #5 is the button
Seat 1: Small Blind ($640.50 in chips) 
Seat 2: Big Blind ($260.00 in chips) 
Seat 3: UTG ($500.00 in chips) 
Seat 4: Hero ($1042.27 in chips) 
Seat 5: Dealer ($588.31 in chips) 
Small Blind: posts small blind $2.50
Big Blind: posts big blind $5
*** HOLE CARDS ***
Dealt to Hero [8d Qd]
UTG: folds 
Hero: raises $7.50 to $12.50
Dealer: folds 
Small Blind: folds 
Big Blind: calls $7.50
*** FLOP *** [6d As Ah]
Big Blind: checks 
Hero: bets $7.84
Big Blind: calls $7.84
*** TURN *** [6d As Ah] [3c]
Big Blind: checks 
Hero: checks 
*** RIVER *** [6d As Ah 3c] [Jc]
Big Blind: bets $20.52
Hero: folds 
*** SHOW DOWN ***
Small Blind: shows [8s 7c] (a hand...)
Big Blind: shows [Ad Tc] (a hand...)
Hero: shows [8d Qd] (a hand...)
Dealer: shows [3d 8c] (a hand...)
UTG: shows [9h Jd] (a hand...)
Uncalled bet ($20.52) returned to Big Blind
Big Blind collected $41.03 from pot
*** SUMMARY ***
Total pot $43.18 | Rake $2.15
Board [6d As Ah 3c Jc]
Seat 1: Small Blind folded
Seat 2: Big Blind collected ($41.03)
Seat 3: UTG folded
Seat 4: Hero folded
Seat 5: Dealer folded



PokerStars Hand #3948331440:  Hold'em No Limit ($2.50/$5) - 2020/05/21 20:02:34 ET
Table 'Zone Poker ID 1588' 9-max Seat #2 is the button
Seat 1: UTG+1 ($500.00 in chips) 
Seat 2: Dealer ($472.50 in chips) 
Seat 3: Small Blind ($450.50 in chips) 
Seat 4: Big Blind ($777.05 in chips) 
Seat 5: Hero ($501.75 in chips) 
Small Blind: posts small blind $2.50
Big Blind: posts big blind $5
*** HOLE CARDS ***
Dealt to Hero [Ad Kd]
Hero: raises $7.50 to $12.50
UTG+1: folds 
Dealer: folds 
Small Blind: folds 
Big Blind: calls $7.50
*** FLOP *** [3d 2h 4c]
Big Blind: checks 
Hero: checks 
*** TURN *** [3d 2h 4c] [Tc]
Big Blind: bets $20
Hero: calls $20
*** RIVER *** [3d 2h 4c Tc] [4d]
Big Blind: bets $40
Hero: calls $40
*** SHOW DOWN ***
Small Blind: shows [Jh Qc] (a hand...)
Big Blind: shows [9d 9s] (a hand...)
Hero: shows [Ad Kd] (a hand...)
Dealer: shows [Qh 2d] (a hand...)
UTG+1: shows [Kc Th] (a hand...)
Big Blind collected $144.50 from pot
*** SUMMARY ***
Total pot $147.50 | Rake $3.00
Board [3d 2h 4c Tc 4d]
Seat 1: UTG+1 folded
Seat 2: Dealer folded
Seat 3: Small Blind folded
Seat 4: Big Blind showed [9d 9s] and won ($144.50)
Seat 5: Hero showed [Ad Kd] and lost with...



PokerStars Hand #3948319066:  Hold'em No Limit ($2.50/$5) - 2020/05/21 19:39:38 ET
Table 'Zone Poker ID 1588' 9-max Seat #5 is the button
Seat 1: Hero ($517.38 in chips) 
Seat 2: UTG ($186.00 in chips) 
Seat 3: UTG+1 ($598.94 in chips) 
Seat 4: UTG+2 ($512.50 in chips) 
Seat 5: Dealer ($465.00 in chips) 
Seat 6: Small Blind ($500.00 in chips) 
Small Blind: posts small blind $2.50
Hero: posts big blind $5
*** HOLE CARDS ***
Dealt to Hero [8c Ah]
UTG: folds 
UTG+1: folds 
UTG+2: raises $7.50 to $12.50
Dealer: folds 
Small Blind: folds 
Hero: calls $7.50
*** FLOP *** [Ad 2s Js]
Hero: checks 
UTG+2: bets $9
Hero: calls $9
*** TURN *** [Ad 2s Js] [4h]
Hero: checks 
UTG+2: bets $32.04
Hero: calls $32.04
*** RIVER *** [Ad 2s Js 4h] [Qd]
Hero: checks 
UTG+2: bets $97.40
Hero: calls $97.40
*** SHOW DOWN ***
Small Blind: shows [3s Qh] (a hand...)
Hero: shows [8c Ah] (a hand...)
Dealer: shows [7s 4s] (a hand...)
UTG+2: shows [Th Kd] (a hand...)
UTG: shows [7c 2h] (a hand...)
UTG+1: shows [6d Jh] (a hand...)
UTG+2 collected $300.38 from pot
*** SUMMARY ***
Total pot $304.38 | Rake $4.00
Board [Ad 2s Js 4h Qd]
Seat 1: Hero showed [8c Ah] and lost with...
Seat 2: UTG folded
Seat 3: UTG+1 folded
Seat 4: UTG+2 showed [Th Kd] and won ($300.38)
Seat 5: Dealer folded
Seat 6: Small Blind folded



PokerStars Hand #3948313564:  Hold'em No Limit ($2.50/$5) - 2020/05/21 19:29:16 ET
Table 'Zone Poker ID 1588' 9-max Seat #5 is the button
Seat 1: Hero ($500.00 in chips) 
Seat 2: Big Blind ($296.52 in chips) 
Seat 3: UTG ($500.00 in chips) 
Seat 4: UTG+1 ($466.75 in chips) 
Seat 5: Dealer ($574.25 in chips) 
Hero: posts small blind $2.50
Big Blind: posts big blind $5
*** HOLE CARDS ***
Dealt to Hero [3c Qd]
UTG: folds 
UTG+1: folds 
Dealer: folds 
Hero: raises $10.00 to $15
Big Blind: calls $10
*** FLOP *** [8h 4h 8d]
Hero: bets $8.55
Big Blind: calls $8.55
*** TURN *** [8h 4h 8d] [Td]
Hero: checks 
Big Blind: checks 
*** RIVER *** [8h 4h 8d Td] [2s]
Hero: checks 
Big Blind: bets $33.56
Hero: folds 
*** SHOW DOWN ***
Big Blind: shows [9h 7h] (a hand...)
Hero: shows [3c Qd] (a hand...)
Dealer: shows [6h Qc] (a hand...)
UTG: shows [2d 3h] (a hand...)
UTG+1: shows [6c 9c] (a hand...)
Uncalled bet ($33.56) returned to Big Blind
Big Blind collected $44.75 from pot
*** SUMMARY ***
Total pot $47.10 | Rake $2.35
Board [8h 4h 8d Td 2s]
Seat 1: Hero folded
Seat 2: Big Blind collected ($44.75)
Seat 3: UTG folded
Seat 4: UTG+1 folded
Seat 5: Dealer folded



PokerStars Hand #3948213552:  Hold'em No Limit ($2.50/$5) - 2020/05/21 16:12:29 ET
Table 'Zone Poker ID 1588' 9-max Seat #2 is the button
Seat 1: Hero ($1554.44 in chips) 
Seat 2: Dealer ($512.00 in chips) 
Seat 3: Small Blind ($592.41 in chips) 
Small Blind: posts small blind $2.50
Hero: posts big blind $5
*** HOLE CARDS ***
Dealt to Hero [9h 8h]
Dealer: raises $10 to $15
Small Blind: calls $12.50
Hero: calls $10
*** FLOP *** [5d 5s 9s]
Small Blind: checks 
Hero: checks 
Dealer: bets $21.50
Small Blind: folds 
Hero: calls $21.50
*** TURN *** [5d 5s 9s] [8d]
Hero: checks 
Dealer: checks 
*** RIVER *** [5d 5s 9s 8d] [Ac]
Hero: checks 
Dealer: bets $43
Hero: calls $43
*** SHOW DOWN ***
Small Blind: shows [3h 3c] (a hand...)
Dealer: shows [8s As] (a hand...)
Hero: shows [9h 8h] (a hand...)
Dealer collected $172 from pot
*** SUMMARY ***
Total pot $174.00 | Rake $2.00
Board [5d 5s 9s 8d Ac]
Seat 1: Hero showed [9h 8h] and lost with...
Seat 2: Dealer showed [8s As] and won ($172)
Seat 3: Small Blind folded



PokerStars Hand #3948208109:  Hold'em No Limit ($2.50/$5) - 2020/05/21 16:01:09 ET
Table 'Zone Poker ID 1588' 9-max Seat #2 is the button
Seat 1: Big Blind ($698.13 in chips) 
Seat 2: Hero ($1148.16 in chips) 
Seat 3: Small Blind ($310.50 in chips) 
Small Blind: posts small blind $2.50
Big Blind: posts big blind $5
*** HOLE CARDS ***
Dealt to Hero [Ah Jd]
Hero: raises $7.50 to $12.50
Small Blind: calls $10
Big Blind: calls $7.50
*** FLOP *** [6d Jc Qc]
Small Blind: checks 
Big Blind: checks 
Hero: bets $12.50
Small Blind: calls $12.50
Big Blind: calls $12.50
*** TURN *** [6d Jc Qc] [6s]
Small Blind: checks 
Big Blind: checks 
Hero: checks 
*** RIVER *** [6d Jc Qc 6s] [2d]
Small Blind: bets $54.75
Big Blind: folds 
Hero: calls $54.75
*** SHOW DOWN ***
Small Blind: shows [Th 9h] (a hand...)
Big Blind: shows [Js 2s] (a hand...)
Hero: shows [Ah Jd] (a hand...)
Hero collected $182.50 from pot
*** SUMMARY ***
Total pot $184.50 | Rake $2.00
Board [6d Jc Qc 6s 2d]
Seat 1: Big Blind folded
Seat 2: Hero showed [Ah Jd] and won ($182.50)
Seat 3: Small Blind showed [Th 9h] and lost with...



PokerStars Hand #3948206978:  Hold'em No Limit ($2.50/$5) - 2020/05/21 15:58:44 ET
Table 'Zone Poker ID 1588' 9-max Seat #2 is the button
Seat 1: Hero ($653.00 in chips) 
Seat 2: Dealer ($778.12 in chips) 
Seat 3: Small Blind ($626.76 in chips) 
Small Blind: posts small blind $2.50
Hero: posts big blind $5
*** HOLE CARDS ***
Dealt to Hero [Td Kc]
Dealer: raises $7.50 to $12.50
Small Blind: folds 
Hero: calls $7.50
*** FLOP *** [Ah 4s Kd]
Hero: checks 
Dealer: bets $8.07
Hero: calls $8.07
*** TURN *** [Ah 4s Kd] [2d]
Hero: checks 
Dealer: checks 
*** RIVER *** [Ah 4s Kd 2d] [7h]
Hero: checks 
Dealer: bets $31.23
Hero: folds 
*** SHOW DOWN ***
Small Blind: shows [Kh 7c] (a hand...)
Dealer: shows [Ac 8h] (a hand...)
Hero: shows [Td Kc] (a hand...)
Uncalled bet ($31.23) returned to Dealer
Dealer collected $41.64 from pot
*** SUMMARY ***
Total pot $43.64 | Rake $2.00
Board [Ah 4s Kd 2d 7h]
Seat 1: Hero folded
Seat 2: Dealer collected ($41.64)
Seat 3: Small Blind folded



PokerStars Hand #3948204931:  Hold'em No Limit ($2.50/$5) - 2020/05/21 15:54:11 ET
Table 'Zone Poker ID 1588' 9-max Seat #2 is the button
Seat 1: Big Blind ($1885.04 in chips) 
Seat 2: Hero ($495.00 in chips) 
Seat 3: Small Blind ($500.00 in chips) 
Small Blind: posts small blind $2.50
Big Blind: posts big blind $5
*** HOLE CARDS ***
Dealt to Hero [Js 7s]
Hero: raises $7.50 to $12.50
Small Blind: folds 
Big Blind: calls $7.50
*** FLOP *** [7d Qh Th]
Big Blind: checks 
Hero: checks 
*** TURN *** [7d Qh Th] [9d]
Big Blind: bets $13.07
Hero: calls $13.07
*** RIVER *** [7d Qh Th 9d] [Ah]
Big Blind: bets $51.64
Hero: folds 
*** SHOW DOWN ***
Small Blind: shows [5d 4d] (a hand...)
Big Blind: shows [8c Ks] (a hand...)
Hero: shows [Js 7s] (a hand...)
Uncalled bet ($51.64) returned to Big Blind
Big Blind collected $51.64 from pot
*** SUMMARY ***
Total pot $53.64 | Rake $2.00
Board [7d Qh Th 9d Ah]
Seat 1: Big Blind collected ($51.64)
Seat 2: Hero folded
Seat 3: Small Blind folded



PokerStars Hand #3948204031:  Hold'em No Limit ($2.50/$5) - 2020/05/21 15:52:12 ET
Table 'Zone Poker ID 1588' 9-max Seat #2 is the button
Seat 1: Hero ($483.95 in chips) 
Seat 2: Dealer ($554.13 in chips) 
Seat 3: Small Blind ($778.52 in chips) 
Small Blind: posts small blind $2.50
Hero: posts big blind $5
*** HOLE CARDS ***
Dealt to Hero [9h Ac]
Dealer: folds 
Small Blind: calls $2.50
Hero: raises $15 to $20
Small Blind: calls $15
*** FLOP *** [Kh 7h 6h]
Small Blind: checks 
Hero: checks 
*** TURN *** [Kh 7h 6h] [9d]
Small Blind: bets $15
Hero: calls $15
*** RIVER *** [Kh 7h 6h 9d] [4s]
Small Blind: bets $20
Hero: calls $20
*** SHOW DOWN ***
Small Blind: shows [Qh 9c] (a hand...)
Dealer: shows [7s Tc] (a hand...)
Hero: shows [9h Ac] (a hand...)
Hero collected $108 from pot
*** SUMMARY ***
Total pot $110.00 | Rake $2.00
Board [Kh 7h 6h 9d 4s]
Seat 1: Hero showed [9h Ac] and won ($108)
Seat 2: Dealer folded
Seat 3: Small Blind showed [Qh 9c] and lost with...



PokerStars Hand #3948203278:  Hold'em No Limit ($2.50/$5) - 2020/05/21 15:50:31 ET
Table 'Zone Poker ID 1588' 9-max Seat #2 is the button
Seat 1: Big Blind ($636.12 in chips) 
Seat 2: Dealer ($574.00 in chips) 
Seat 3: Hero ($505.00 in chips) 
Hero: posts small blind $2.50
Big Blind: posts big blind $5
*** HOLE CARDS ***
Dealt to Hero [7s Ts]
Dealer: folds 
Hero: raises $10.00 to $15
Big Blind: calls $10
*** FLOP *** [Jd 3c Qs]
Hero: bets $8.55
Big Blind: calls $8.55
*** TURN *** [Jd 3c Qs] [7h]
Hero: checks 
Big Blind: checks 
*** RIVER *** [Jd 3c Qs 7h] [9s]
Hero: checks 
Big Blind: bets $10
Hero: folds 
*** SHOW DOWN ***
Dealer: shows [4s 5d] (a hand...)
Big Blind: shows [Js 5s] (a hand...)
Hero: shows [7s Ts] (a hand...)
Uncalled bet ($10.00) returned to Big Blind
Big Blind collected $45.10 from pot
*** SUMMARY ***
Total pot $47.10 | Rake $2.00
Board [Jd 3c Qs 7h 9s]
Seat 1: Big Blind collected ($45.10)
Seat 2: Dealer folded
Seat 3: Hero folded



PokerStars Hand #3948151537:  Hold'em No Limit ($2.50/$5) - 2020/05/21 13:42:58 ET
Table 'Zone Poker ID 1588' 9-max Seat #2 is the button
Seat 1: Big Blind ($1882.61 in chips) 
Seat 2: Hero ($547.58 in chips) 
Seat 3: Small Blind ($473.82 in chips) 
Small Blind: posts small blind $2.50
Big Blind: posts big blind $5
*** HOLE CARDS ***
Dealt to Hero [Qs Ah]
Hero: raises $7.50 to $12.50
Small Blind: folds 
Big Blind: calls $7.50
*** FLOP *** [9d 6s Tc]
Big Blind: checks 
Hero: checks 
*** TURN *** [9d 6s Tc] [Ad]
Big Blind: bets $51.13
Hero: calls $51.13
*** RIVER *** [9d 6s Tc Ad] [5d]
Big Blind: bets $127.76
Hero: folds 
*** SHOW DOWN ***
Small Blind: shows [5h 3c] (a hand...)
Big Blind: shows [8s 7c] (a hand...)
Hero: shows [Qs Ah] (a hand...)
Uncalled bet ($127.76) returned to Big Blind
Big Blind collected $127.76 from pot
*** SUMMARY ***
Total pot $129.76 | Rake $2.00
Board [9d 6s Tc Ad 5d]
Seat 1: Big Blind collected ($127.76)
Seat 2: Hero folded
Seat 3: Small Blind folded



PokerStars Hand #3948151520:  Hold'em No Limit ($2.50/$5) - 2020/05/21 13:42:54 ET
Table 'Zone Poker ID 1588' 9-max Seat #1 is the button
Seat 1: Dealer ($495.00 in chips) 
Seat 2: Small Blind ($598.25 in chips) 
Seat 3: Hero ($500.00 in chips) 
Small Blind: posts small blind $2.50
Hero: posts big blind $5
*** HOLE CARDS ***
Dealt to Hero [Jh Ac]
Dealer: raises $5 to $10
Small Blind: folds 
Hero: calls $5
*** FLOP *** [5c 9c 4s]
Hero: checks 
Dealer: checks 
*** TURN *** [5c 9c 4s] [Qd]
Hero: checks 
Dealer: checks 
*** RIVER *** [5c 9c 4s Qd] [Qc]
Hero: checks 
Dealer: bets $16.04
Hero: calls $16.04
*** SHOW DOWN ***
Small Blind: shows [6s 7d] (a hand...)
Dealer: shows [8s 8d] (a hand...)
Hero: shows [Jh Ac] (a hand...)
Dealer collected $52.58 from pot
*** SUMMARY ***
Total pot $54.58 | Rake $2.00
Board [5c 9c 4s Qd Qc]
Seat 1: Dealer showed [8s 8d] and won ($52.58)
Seat 2: Small Blind folded
Seat 3: Hero showed [Jh Ac] and lost with...



PokerStars Hand #3948129177:  Hold'em No Limit ($2.50/$5) - 2020/05/21 12:39:25 ET
Table 'Zone Poker ID 1588' 9-max Seat #2 is the button
Seat 1: Big Blind ($714.31 in chips) 
Seat 2: Hero ($734.84 in chips) 
Seat 3: Small Blind ($1727.70 in chips) 
Small Blind: posts small blind $2.50
Big Blind: posts big blind $5
*** HOLE CARDS ***
Dealt to Hero [4c 4d]
Hero: raises $7.50 to $12.50
Small Blind: raises $50.00 to $62.50
Big Blind: folds 
Hero: calls $50
*** FLOP *** [3d Ad Kd]
Small Blind: bets $31.10
Hero: calls $31.10
*** TURN *** [3d Ad Kd] [Qd]
Small Blind: checks 
Hero: checks 
*** RIVER *** [3d Ad Kd Qd] [9d]
Small Blind: bets $190.20
Hero: calls $190.20
*** SHOW DOWN ***
Small Blind: shows [Jc 9c] (a hand...)
Big Blind: shows [Jh 8s] (a hand...)
Hero: shows [4c 4d] (a hand...)
Hero collected $570.60 from pot
*** SUMMARY ***
Total pot $572.60 | Rake $2.00
Board [3d Ad Kd Qd 9d]
Seat 1: Big Blind folded
Seat 2: Hero showed [4c 4d] and won ($570.60)
Seat 3: Small Blind showed [Jc 9c] and lost with...



PokerStars Hand #3948129149:  Hold'em No Limit ($2.50/$5) - 2020/05/21 12:39:18 ET
Table 'Zone Poker ID 1588' 9-max Seat #3 is the button
Seat 1: Small Blind ($982.60 in chips) 
Seat 2: Hero ($560.50 in chips) 
Seat 3: Dealer ($714.31 in chips) 
Small Blind: posts small blind $2.50
Hero: posts big blind $5
*** HOLE CARDS ***
Dealt to Hero [5s 5h]
Dealer: folds 
Small Blind: raises $7.50 to $12.50
Hero: calls $7.50
*** FLOP *** [3s Jh Qh]
Small Blind: checks 
Hero: checks 
*** TURN *** [3s Jh Qh] [Kh]
Small Blind: bets $11.88
Hero: calls $11.88
*** RIVER *** [3s Jh Qh Kh] [4c]
Small Blind: bets $23.38
Hero: folds 
*** SHOW DOWN ***
Small Blind: shows [7c Th] (a hand...)
Dealer: shows [Kc 3d] (a hand...)
Hero: shows [5s 5h] (a hand...)
Uncalled bet ($23.38) returned to Small Blind
Small Blind collected $46.76 from pot
*** SUMMARY ***
Total pot $48.76 | Rake $2.00
Board [3s Jh Qh Kh 4c]
Seat 1: Small Blind collected ($46.76)
Seat 2: Hero folded
Seat 3: Dealer folded



PokerStars Hand #3948126992:  Hold'em No Limit ($2.50/$5) - 2020/05/21 12:32:41 ET
Table 'Zone Poker ID 1588' 9-max Seat #3 is the button
Seat 1: Small Blind ($456.03 in chips) 
Seat 2: Hero ($604.50 in chips) 
Seat 3: Dealer ($604.50 in chips) 
Small Blind: posts small blind $2.50
Hero: posts big blind $5
*** HOLE CARDS ***
Dealt to Hero [5s 8s]
Dealer: raises $7.50 to $12.50
Small Blind: folds 
Hero: calls $7.50
*** FLOP *** [2h 5c 5h]
Hero: checks 
Dealer: bets $8.07
Hero: raises $21.14 to $29.21
Dealer: calls $21.14
*** TURN *** [2h 5c 5h] [Qh]
Hero: checks 
Dealer: bets $36.96
Hero: calls $36.96
*** RIVER *** [2h 5c 5h Qh] [2c]
Hero: checks 
Dealer: bets $118.38
Hero: calls $118.38
*** SHOW DOWN ***
Small Blind: shows [3s 9d] (a hand...)
Dealer: shows [5d Qd] (a hand...)
Hero: shows [5s 8s] (a hand...)
Dealer collected $394.60 from pot
*** SUMMARY ***
Total pot $396.60 | Rake $2.00
Board [2h 5c 5h Qh 2c]
Seat 1: Small Blind folded
Seat 2: Hero showed [5s 8s] and lost with...
Seat 3: Dealer showed [5d Qd] and won ($394.60)



PokerStars Hand #3948126356:  Hold'em No Limit ($2.50/$5) - 2020/05/21 12:30:43 ET
Table 'Zone Poker ID 1588' 9-max Seat #3 is the button
Seat 1: Hero ($623.01 in chips) 
Seat 2: UTG ($444.63 in chips) 
Seat 3: Dealer ($1008.39 in chips) 
Seat 4: Small Blind ($589.50 in chips) 
Small Blind: posts small blind $2.50
Hero: posts big blind $5
*** HOLE CARDS ***
Dealt to Hero [Jd As]
UTG: folds 
Dealer: folds 
Small Blind: raises $10.00 to $15
Hero: calls $10
*** FLOP *** [9d Ks Qh]
Small Blind: bets $10
Hero: calls $10
*** TURN *** [9d Ks Qh] [7d]
Small Blind: checks 
Hero: checks 
*** RIVER *** [9d Ks Qh 7d] [2c]
Small Blind: bets $35.63
Hero: folds 
*** SHOW DOWN ***
Small Blind: shows [Ac Qd] (a hand...)
UTG: shows [5h 6d] (a hand...)
Dealer: shows [9s 5d] (a hand...)
Hero: shows [Jd As] (a hand...)
Uncalled bet ($35.63) returned to Small Blind
Small Blind collected $47.50 from pot
*** SUMMARY ***
Total pot $50.00 | Rake $2.50
Board [9d Ks Qh 7d 2c]
Seat 1: Hero folded
Seat 2: UTG folded
Seat 3: Dealer folded
Seat 4: Small Blind collected ($47.50)



PokerStars Hand #3948125638:  Hold'em No Limit ($2.50/$5) - 2020/05/21 12:28:34 ET
Table 'Zone Poker ID 1588' 9-max Seat #3 is the button
Seat 1: Small Blind ($508.01 in chips) 
Seat 2: Hero ($599.00 in chips) 
Seat 3: Dealer ($858.00 in chips) 
Small Blind: posts small blind $2.50
Hero: posts big blind $5
*** HOLE CARDS ***
Dealt to Hero [Th Jc]
Dealer: folds 
Small Blind: raises $7.50 to $12.50
Hero: calls $7.50
*** FLOP *** [4h Kh Ad]
Small Blind: checks 
Hero: checks 
*** TURN *** [4h Kh Ad] [As]
Small Blind: bets $11.88
Hero: calls $11.88
*** RIVER *** [4h Kh Ad As] [3s]
Small Blind: bets $46.76
Hero: folds 
*** SHOW DOWN ***
Small Blind: shows [Qd Ts] (a hand...)
Dealer: shows [7h 6s] (a hand...)
Hero: shows [Th Jc] (a hand...)
Uncalled bet ($46.76) returned to Small Blind
Small Blind collected $46.76 from pot
*** SUMMARY ***
Total pot $48.76 | Rake $2.00
Board [4h Kh Ad As 3s]
Seat 1: Small Blind collected ($46.76)
Seat 2: Hero folded
Seat 3: Dealer folded



PokerStars Hand #3948125171:  Hold'em No Limit ($2.50/$5) - 2020/05/21 12:27:14 ET
Table 'Zone Poker ID 1588' 9-max Seat #3 is the button
Seat 1: Small Blind ($1753.65 in chips) 
Seat 2: Big Blind ($471.00 in chips) 
Seat 3: Hero ($612.47 in chips) 
Small Blind: posts small blind $2.50
Big Blind: posts big blind $5
*** HOLE CARDS ***
Dealt to Hero [6c 5c]
Hero: raises $7.50 to $12.50
Small Blind: folds 
Big Blind: calls $7.50
*** FLOP *** [5s 9h 7s]
Big Blind: checks 
Hero: checks 
*** TURN *** [5s 9h 7s] [7d]
Big Blind: checks 
Hero: bets $7.84
Big Blind: calls $7.84
*** RIVER *** [5s 9h 7s 7d] [Td]
Big Blind: bets $30.89
Hero: folds 
*** SHOW DOWN ***
Small Blind: shows [Jc 7h] (a hand...)
Big Blind: shows [9c Ts] (a hand...)
Hero: shows [6c 5c] (a hand...)
Uncalled bet ($30.89) returned to Big Blind
Big Blind collected $41.18 from pot
*** SUMMARY ***
Total pot $43.18 | Rake $2.00
Board [5s 9h 7s 7d Td]
Seat 1: Small Blind folded
Seat 2: Big Blind collected ($41.18)
Seat 3: Hero folded



PokerStars Hand #3948124033:  Hold'em No Limit ($2.50/$5) - 2020/05/21 12:23:45 ET
Table 'Zone Poker ID 1588' 9-max Seat #1 is the button
Seat 1: Dealer ($1077.66 in chips) 
Seat 2: Hero ($496.93 in chips) 
Seat 3: Big Blind ($569.93 in chips) 
Hero: posts small blind $2.50
Big Blind: posts big blind $5
*** HOLE CARDS ***
Dealt to Hero [Jc Jd]
Dealer: folds 
Hero: raises $10.00 to $15
Big Blind: calls $10
*** FLOP *** [6h 9d 7d]
Hero: checks 
Big Blind: bets $20
Hero: calls $20
*** TURN *** [6h 9d 7d] [4c]
Hero: checks 
Big Blind: bets $68
Hero: calls $68
*** RIVER *** [6h 9d 7d 4c] [Qs]
Hero: checks 
Big Blind: bets $250
Hero: calls $250
*** SHOW DOWN ***
Dealer: shows [9s 5s] (a hand...)
Big Blind: shows [8s 5h] (a hand...)
Hero: shows [Jc Jd] (a hand...)
Big Blind collected $704 from pot
*** SUMMARY ***
Total pot $706.00 | Rake $2.00
Board [6h 9d 7d 4c Qs]
Seat 1: Dealer folded
Seat 2: Hero showed [Jc Jd] and lost with...
Seat 3: Big Blind showed [8s 5h] and won ($704)



PokerStars Hand #3947922792:  Hold'em No Limit ($2.50/$5) - 2020/05/21 00:40:08 ET
Table 'Zone Poker ID 1588' 9-max Seat #6 is the button
Seat 1: Small Blind ($425.75 in chips) 
Seat 2: Big Blind ($835.66 in chips) 
Seat 3: UTG ($651.38 in chips) 
Seat 4: UTG+1 ($553.11 in chips) 
Seat 5: Hero ($528.33 in chips) 
Seat 6: Dealer ($506.19 in chips) 
Small Blind: posts small blind $2.50
Big Blind: posts big blind $5
*** HOLE CARDS ***
Dealt to Hero [As Kd]
UTG: raises $10 to $15
UTG+1: folds 
Hero: raises $35 to $50
Dealer: folds 
Small Blind: folds 
Big Blind: folds 
UTG: calls $35
*** FLOP *** [4s 9h 6c]
UTG: checks 
Hero: checks 
*** TURN *** [4s 9h 6c] [Jd]
UTG: checks 
Hero: checks 
*** RIVER *** [4s 9h 6c Jd] [5d]
UTG: bets $71.75
Hero: calls $71.75
*** SHOW DOWN ***
Small Blind: shows [3c 9d] (a hand...)
Big Blind: shows [Tc Qs] (a hand...)
Hero: shows [As Kd] (a hand...)
Dealer: shows [8s 3d] (a hand...)
UTG: shows [Jh Js] (a hand...)
UTG+1: shows [5s 7d] (a hand...)
UTG collected $247 from pot
*** SUMMARY ***
Total pot $251.00 | Rake $4.00
Board [4s 9h 6c Jd 5d]
Seat 1: Small Blind folded
Seat 2: Big Blind folded
Seat 3: UTG showed [Jh Js] and won ($247)
Seat 4: UTG+1 folded
Seat 5: Hero showed [As Kd] and lost with...
Seat 6: Dealer folded



PokerStars Hand #3947912713:  Hold'em No Limit ($2.50/$5) - 2020/05/21 00:23:22 ET
Table 'Zone Poker ID 1588' 9-max Seat #6 is the button
Seat 1: Hero ($1690.34 in chips) 
Seat 2: Big Blind ($308.68 in chips) 
Seat 3: UTG ($297.45 in chips) 
Seat 4: UTG+1 ($2254.48 in chips) 
Seat 5: UTG+2 ($467.00 in chips) 
Seat 6: Dealer ($610.56 in chips) 
Hero: posts small blind $2.50
Big Blind: posts big blind $5
*** HOLE CARDS ***
Dealt to Hero [Tc Jc]
UTG: folds 
UTG+1: raises $10 to $15
UTG+2: folds 
Dealer: folds 
Hero: raises $60.00 to $75
Big Blind: folds 
UTG+1: calls $60
*** FLOP *** [5c Ks 8h]
Hero: bets $82.50
UTG+1: calls $82.50
*** TURN *** [5c Ks 8h] [7h]
Hero: bets $237
UTG+1: calls $237
*** RIVER *** [5c Ks 8h 7h] [9d]
Hero: bets $592.50
UTG+1: raises $1267.48 to $1859.98 and is all-in
Hero: calls $703.34 and is all-in
*** SHOW DOWN ***
Big Blind: shows [Ac 3d] (a hand...)
Hero: shows [Tc Jc] (a hand...)
UTG+2: shows [Ts 5h] (a hand...)
Dealer: shows [2d 5s] (a hand...)
UTG: shows [Js 4c] (a hand...)
UTG+1: shows [6c 7c] (a hand...)
Uncalled bet ($564.14) returned to UTG+1
Hero collected $3381.68 from pot
*** SUMMARY ***
Total pot $3385.68 | Rake $4.00
Board [5c Ks 8h 7h 9d]
Seat 1: Hero showed [Tc Jc] and won ($3381.68)
Seat 2: Big Blind folded
Seat 3: UTG folded
Seat 4: UTG+1 showed [6c 7c] and lost with...
Seat 5: UTG+2 folded
Seat 6: Dealer folded



PokerStars Hand #3947911842:  Hold'em No Limit ($2.50/$5) - 2020/05/21 00:21:53 ET
Table 'Zone Poker ID 1588' 9-max Seat #2 is the button
Seat 1: UTG+2 ($364.94 in chips) 
Seat 2: Dealer ($479.50 in chips) 
Seat 3: Small Blind ($1873.89 in chips) 
Seat 4: Hero ($1804.47 in chips) 
Seat 5: UTG ($601.72 in chips) 
Seat 6: UTG+1 ($511.61 in chips) 
Small Blind: posts small blind $2.50
Hero: posts big blind $5
*** HOLE CARDS ***
Dealt to Hero [6c Kh]
UTG: calls $5
UTG+1: calls $5
UTG+2: folds 
Dealer: calls $5
Small Blind: folds 
Hero: checks 
*** FLOP *** [Kd 4h 7h]
Hero: checks 
UTG: checks 
UTG+1: bets $15
Dealer: folds 
Hero: calls $15
UTG: folds 
*** TURN *** [Kd 4h 7h] [Tc]
Hero: checks 
UTG+1: bets $34.94
Hero: calls $34.94
*** RIVER *** [Kd 4h 7h Tc] [8c]
Hero: checks 
UTG+1: bets $59.19
Hero: calls $59.19
*** SHOW DOWN ***
Small Blind: shows [7s 3s] (a hand...)
Hero: shows [6c Kh] (a hand...)
Dealer: shows [Jd Ac] (a hand...)
UTG+2: shows [5c 8d] (a hand...)
UTG: shows [Ah Jc] (a hand...)
UTG+1: shows [Th Kc] (a hand...)
UTG+1 collected $236.76 from pot
*** SUMMARY ***
Total pot $240.76 | Rake $4.00
Board [Kd 4h 7h Tc 8c]
Seat 1: UTG+2 folded
Seat 2: Dealer folded
Seat 3: Small Blind folded
Seat 4: Hero showed [6c Kh] and lost with...
Seat 5: UTG folded
Seat 6: UTG+1 showed [Th Kc] and won ($236.76)



PokerStars Hand #3947906922:  Hold'em No Limit ($2.50/$5) - 2020/05/21 00:13:37 ET
Table 'Zone Poker ID 1588' 9-max Seat #1 is the button
Seat 1: Dealer ($274.00 in chips) 
Seat 2: Small Blind ($500.00 in chips) 
Seat 3: Big Blind ($500.00 in chips) 
Seat 4: Hero ($1115.84 in chips) 
Seat 5: UTG+1 ($500.00 in chips) 
Seat 6: UTG+2 ($530.08 in chips) 
Small Blind: posts small blind $2.50
Big Blind: posts big blind $5
*** HOLE CARDS ***
Dealt to Hero [Js As]
Hero: raises $10 to $15
UTG+1: folds 
UTG+2: calls $15
Dealer: calls $15
Small Blind: raises $80.00 to $95
Big Blind: folds 
Hero: calls $80
UTG+2: folds 
Dealer: folds 
*** FLOP *** [Jh Ac Ks]
Small Blind: bets $60
Hero: calls $60
*** TURN *** [Jh Ac Ks] [9c]
Small Blind: checks 
Hero: checks 
*** RIVER *** [Jh Ac Ks 9c] [5h]
Small Blind: bets $345 and is all-in
Hero: calls $345
*** SHOW DOWN ***
Small Blind: shows [8h 8d] (a hand...)
Big Blind: shows [Jd 6c] (a hand...)
Hero: shows [Js As] (a hand...)
Dealer: shows [4h 4c] (a hand...)
UTG+2: shows [9h Th] (a hand...)
UTG+1: shows [Ad 2s] (a hand...)
Hero collected $1031 from pot
*** SUMMARY ***
Total pot $1035.00 | Rake $4.00
Board [Jh Ac Ks 9c 5h]
Seat 1: Dealer folded
Seat 2: Small Blind showed [8h 8d] and lost with...
Seat 3: Big Blind folded
Seat 4: Hero showed [Js As] and won ($1031)
Seat 5: UTG+1 folded
Seat 6: UTG+2 folded



PokerStars Hand #3947906113:  Hold'em No Limit ($2.50/$5) - 2020/05/21 00:12:17 ET
Table 'Zone Poker ID 1588' 9-max Seat #5 is the button
Seat 1: Big Blind ($771.86 in chips) 
Seat 2: UTG ($420.99 in chips) 
Seat 3: Hero ($497.50 in chips) 
Seat 4: UTG+2 ($445.12 in chips) 
Seat 5: Dealer ($1181.93 in chips) 
Seat 6: Small Blind ($786.50 in chips) 
Small Blind: posts small blind $2.50
Big Blind: posts big blind $5
*** HOLE CARDS ***
Dealt to Hero [8c Tc]
UTG: folds 
Hero: raises $7.50 to $12.50
UTG+2: raises $22.50 to $35
Dealer: folds 
Small Blind: folds 
Big Blind: folds 
Hero: calls $22.50
*** FLOP *** [Ks 4c Kc]
Hero: checks 
UTG+2: checks 
*** TURN *** [Ks 4c Kc] [6h]
Hero: checks 
UTG+2: checks 
*** RIVER *** [Ks 4c Kc 6h] [2h]
Hero: checks 
UTG+2: bets $40
Hero: folds 
*** SHOW DOWN ***
Small Blind: shows [2c 3h] (a hand...)
Big Blind: shows [6s As] (a hand...)
Hero: shows [8c Tc] (a hand...)
Dealer: shows [Jd 2s] (a hand...)
UTG+2: shows [Ac Ah] (a hand...)
UTG: shows [7s 4s] (a hand...)
Uncalled bet ($40.00) returned to UTG+2
UTG+2 collected $73.63 from pot
*** SUMMARY ***
Total pot $77.50 | Rake $3.87
Board [Ks 4c Kc 6h 2h]
Seat 1: Big Blind folded
Seat 2: UTG folded
Seat 3: Hero folded
Seat 4: UTG+2 collected ($73.63)
Seat 5: Dealer folded
Seat 6: Small Blind folded



PokerStars Hand #3947905841:  Hold'em No Limit ($2.50/$5) - 2020/05/21 00:11:48 ET
Table 'Zone Poker ID 1588' 9-max Seat #5 is the button
Seat 1: Hero ($1047.34 in chips) 
Seat 2: UTG ($423.64 in chips) 
Seat 3: UTG+1 ($157.70 in chips) 
Seat 4: UTG+2 ($500.00 in chips) 
Seat 5: Dealer ($1348.97 in chips) 
Seat 6: Small Blind ($2180.60 in chips) 
Small Blind: posts small blind $2.50
Hero: posts big blind $5
*** HOLE CARDS ***
Dealt to Hero [Qc 6d]
UTG: folds 
UTG+1: folds 
UTG+2: folds 
Dealer: folds 
Small Blind: raises $10.00 to $15
Hero: calls $10
*** FLOP *** [5s 6h 3s]
Small Blind: checks 
Hero: bets $20
Small Blind: calls $20
*** TURN *** [5s 6h 3s] [5c]
Small Blind: checks 
Hero: checks 
*** RIVER *** [5s 6h 3s 5c] [Td]
Small Blind: bets $35
Hero: calls $35
*** SHOW DOWN ***
Small Blind: shows [7d Kd] (a hand...)
Hero: shows [Qc 6d] (a hand...)
Dealer: shows [Ad 6s] (a hand...)
UTG+2: shows [Th 4h] (a hand...)
UTG: shows [4c 5d] (a hand...)
UTG+1: shows [Tc 5h] (a hand...)
Hero collected $136 from pot
*** SUMMARY ***
Total pot $140.00 | Rake $4.00
Board [5s 6h 3s 5c Td]
Seat 1: Hero showed [Qc 6d] and won ($136)
Seat 2: UTG folded
Seat 3: UTG+1 folded
Seat 4: UTG+2 folded
Seat 5: Dealer folded
Seat 6: Small Blind showed [7d Kd] and lost with...



PokerStars Hand #3947905082:  Hold'em No Limit ($2.50/$5) - 2020/05/21 00:10:36 ET
Table 'Zone Poker ID 1588' 9-max Seat #1 is the button
Seat 1: Dealer ($834.76 in chips) 
Seat 2: Small Blind ($253.17 in chips) 
Seat 3: Hero ($1073.75 in chips) 
Seat 4: UTG ($480.00 in chips) 
Seat 5: UTG+1 ($230.00 in chips) 
Seat 6: UTG+2 ($491.37 in chips) 
Small Blind: posts small blind $2.50
Hero: posts big blind $5
*** HOLE CARDS ***
Dealt to Hero [2d 8s]
UTG: calls $5
UTG+1: folds 
UTG+2: folds 
Dealer: folds 
Small Blind: folds 
Hero: checks 
*** FLOP *** [3d 2h Kd]
Hero: checks 
UTG: checks 
*** TURN *** [3d 2h Kd] [8d]
Hero: checks 
UTG: bets $5
Hero: raises $16.41 to $21.41
UTG: calls $16.41
*** RIVER *** [3d 2h Kd 8d] [4d]
Hero: checks 
UTG: bets $26.28
Hero: folds 
*** SHOW DOWN ***
Small Blind: shows [Ts 4c] (a hand...)
Hero: shows [2d 8s] (a hand...)
Dealer: shows [6h 5c] (a hand...)
UTG+2: shows [Qh 9s] (a hand...)
UTG: shows [Kh Jd] (a hand...)
UTG+1: shows [5h Td] (a hand...)
Uncalled bet ($26.28) returned to UTG
UTG collected $52.56 from pot
*** SUMMARY ***
Total pot $55.32 | Rake $2.76
Board [3d 2h Kd 8d 4d]
Seat 1: Dealer folded
Seat 2: Small Blind folded
Seat 3: Hero folded
Seat 4: UTG collected ($52.56)
Seat 5: UTG+1 folded
Seat 6: UTG+2 folded



PokerStars Hand #3947900212:  Hold'em No Limit ($2.50/$5) - 2020/05/21 00:02:34 ET
Table 'Zone Poker ID 1588' 9-max Seat #5 is the button
Seat 1: Small Blind ($303.23 in chips) 
Seat 2: Hero ($507.50 in chips) 
Seat 3: UTG ($502.18 in chips) 
Seat 4: UTG+1 ($672.48 in chips) 
Seat 5: Dealer ($497.50 in chips) 
Small Blind: posts small blind $2.50
Hero: posts big blind $5
*** HOLE CARDS ***
Dealt to Hero [Kd 9d]
UTG: folds 
UTG+1: raises $10 to $15
Dealer: folds 
Small Blind: folds 
Hero: calls $10
*** FLOP *** [2s 9s 2h]
Hero: checks 
UTG+1: bets $23.16
Hero: calls $23.16
*** TURN *** [2s 9s 2h] [Td]
Hero: checks 
UTG+1: checks 
*** RIVER *** [2s 9s 2h Td] [8d]
Hero: bets $25
UTG+1: raises $100 to $125
Hero: calls $100
*** SHOW DOWN ***
Small Blind: shows [8h 7s] (a hand...)
Hero: shows [Kd 9d] (a hand...)
Dealer: shows [7c 8s] (a hand...)
UTG: shows [Ah 3d] (a hand...)
UTG+1: shows [7h 6h] (a hand...)
UTG+1 collected $325.82 from pot
*** SUMMARY ***
Total pot $328.82 | Rake $3.00
Board [2s 9s 2h Td 8d]
Seat 1: Small Blind folded
Seat 2: Hero showed [Kd 9d] and lost with...
Seat 3: UTG folded
Seat 4: UTG+1 showed [7h 6h] and won ($325.82)
Seat 5: Dealer folded



PokerStars Hand #3947894282:  Hold'em No Limit ($2.50/$5) - 2020/05/20 23:53:08 ET
Table 'Zone Poker ID 1588' 9-max Seat #3 is the button
Seat 1: Hero ($495.00 in chips) 
Seat 2: UTG+2 ($599.49 in chips) 
Seat 3: Dealer ($1173.50 in chips) 
Seat 4: Small Blind ($527.32 in chips) 
Seat 5: Big Blind ($399.94 in chips) 
Seat 6: UTG ($502.50 in chips) 
Small Blind: posts small blind $2.50
Big Blind: posts big blind $5
*** HOLE CARDS ***
Dealt to Hero [4d Ad]
UTG: folds 
Hero: raises $7.50 to $12.50
UTG+2: folds 
Dealer: folds 
Small Blind: folds 
Big Blind: raises $42.50 to $55
Hero: calls $42.50
*** FLOP *** [7d 5c Qs]
Big Blind: bets $35
Hero: calls $35
*** TURN *** [7d 5c Qs] [Ah]
Big Blind: checks 
Hero: checks 
*** RIVER *** [7d 5c Qs Ah] [Tc]
Big Blind: checks 
Hero: bets $112.59
Big Blind: raises $197.35 to $309.94 and is all-in
Hero: calls $197.35
*** SHOW DOWN ***
Small Blind: shows [3h 4h] (a hand...)
Big Blind: shows [Jh Jd] (a hand...)
Hero: shows [4d Ad] (a hand...)
Dealer: shows [7h As] (a hand...)
UTG+2: shows [2d Qh] (a hand...)
UTG: shows [Th 6c] (a hand...)
Hero collected $798.38 from pot
*** SUMMARY ***
Total pot $802.38 | Rake $4.00
Board [7d 5c Qs Ah Tc]
Seat 1: Hero showed [4d Ad] and won ($798.38)
Seat 2: UTG+2 folded
Seat 3: Dealer folded
Seat 4: Small Blind folded
Seat 5: Big Blind showed [Jh Jd] and lost with...
Seat 6: UTG folded



PokerStars Hand #3947718334:  Hold'em No Limit ($2.50/$5) - 2020/05/20 19:02:06 ET
Table 'Zone Poker ID 1588' 9-max Seat #1 is the button
Seat 1: Dealer ($775.43 in chips) 
Seat 2: Small Blind ($525.89 in chips) 
Seat 3: Big Blind ($783.97 in chips) 
Seat 4: UTG ($654.08 in chips) 
Seat 5: UTG+1 ($635.92 in chips) 
Seat 6: Hero ($581.38 in chips) 
Small Blind: posts small blind $2.50
Big Blind: posts big blind $5
*** HOLE CARDS ***
Dealt to Hero [Tc Th]
UTG: calls $5
UTG+1: calls $5
Hero: raises $20 to $25
Dealer: calls $25
Small Blind: folds 
Big Blind: folds 
UTG: calls $20
UTG+1: calls $20
*** FLOP *** [3c 2s 3d]
UTG: checks 
UTG+1: checks 
Hero: bets $51.75
Dealer: calls $51.75
UTG: folds 
UTG+1: folds 
*** TURN *** [3c 2s 3d] [Jh]
Hero: checks 
Dealer: bets $103.50
Hero: calls $103.50
*** RIVER *** [3c 2s 3d Jh] [Qs]
Hero: checks 
Dealer: bets $414
Hero: calls $401.13 and is all-in
*** SHOW DOWN ***
Small Blind: shows [7s 7d] (a hand...)
Big Blind: shows [2c Qc] (a hand...)
Hero: shows [Tc Th] (a hand...)
Dealer: shows [Js Jc] (a hand...)
UTG: shows [9c 8c] (a hand...)
UTG+1: shows [Ad 6d] (a hand...)
Uncalled bet ($12.87) returned to Dealer
Dealer collected $1216.26 from pot
*** SUMMARY ***
Total pot $1220.26 | Rake $4.00
Board [3c 2s 3d Jh Qs]
Seat 1: Dealer showed [Js Jc] and won ($1216.26)
Seat 2: Small Blind folded
Seat 3: Big Blind folded
Seat 4: UTG folded
Seat 5: UTG+1 folded
Seat 6: Hero showed [Tc Th] and lost with...



PokerStars Hand #3947717626:  Hold'em No Limit ($2.50/$5) - 2020/05/20 19:00:48 ET
Table 'Zone Poker ID 1588' 9-max Seat #2 is the button
Seat 1: UTG+2 ($391.45 in chips) 
Seat 2: Dealer ($500.00 in chips) 
Seat 3: Small Blind ($530.89 in chips) 
Seat 4: Big Blind ($668.17 in chips) 
Seat 5: Hero ($636.38 in chips) 
Seat 6: UTG+1 ($1086.57 in chips) 
Small Blind: posts small blind $2.50
Big Blind: posts big blind $5
*** HOLE CARDS ***
Dealt to Hero [Tc 9c]
Hero: raises $10 to $15
UTG+1: folds 
UTG+2: folds 
Dealer: folds 
Small Blind: folds 
Big Blind: raises $40 to $55
Hero: calls $40
*** FLOP *** [Jd 2c 7d]
Big Blind: checks 
Hero: checks 
*** TURN *** [Jd 2c 7d] [9h]
Big Blind: checks 
Hero: checks 
*** RIVER *** [Jd 2c 7d 9h] [Kc]
Big Blind: bets $81.38
Hero: folds 
*** SHOW DOWN ***
Small Blind: shows [3c 6c] (a hand...)
Big Blind: shows [As 4s] (a hand...)
Hero: shows [Tc 9c] (a hand...)
Dealer: shows [8c 3d] (a hand...)
UTG+2: shows [7h 3s] (a hand...)
UTG+1: shows [7s Kh] (a hand...)
Uncalled bet ($81.38) returned to Big Blind
Big Blind collected $108.50 from pot
*** SUMMARY ***
Total pot $112.50 | Rake $4.00
Board [Jd 2c 7d 9h Kc]
Seat 1: UTG+2 folded
Seat 2: Dealer folded
Seat 3: Small Blind folded
Seat 4: Big Blind collected ($108.50)
Seat 5: Hero folded
Seat 6: UTG+1 folded



PokerStars Hand #3947716345:  Hold'em No Limit ($2.50/$5) - 2020/05/20 18:58:22 ET
Table 'Zone Poker ID 1588' 9-max Seat #3 is the button
Seat 1: UTG+1 ($596.08 in chips) 
Seat 2: UTG+2 ($475.50 in chips) 
Seat 3: Dealer ($686.58 in chips) 
Seat 4: Small Blind ($1696.09 in chips) 
Seat 5: Hero ($779.70 in chips) 
Seat 6: UTG ($541.85 in chips) 
Small Blind: posts small blind $2.50
Hero: posts big blind $5
*** HOLE CARDS ***
Dealt to Hero [Qc Ks]
UTG: calls $5
UTG+1: folds 
UTG+2: raises $12 to $17
Dealer: folds 
Small Blind: folds 
Hero: calls $12
UTG: calls $12
*** FLOP *** [3h 7s 5s]
Hero: checks 
UTG: checks 
UTG+2: checks 
*** TURN *** [3h 7s 5s] [8c]
Hero: checks 
UTG: checks 
UTG+2: checks 
*** RIVER *** [3h 7s 5s 8c] [Jc]
Hero: checks 
UTG: bets $21
UTG+2: folds 
Hero: folds 
*** SHOW DOWN ***
Small Blind: shows [8s Th] (a hand...)
Hero: shows [Qc Ks] (a hand...)
Dealer: shows [9s 7d] (a hand...)
UTG+2: shows [4d 4s] (a hand...)
UTG: shows [Qh Kh] (a hand...)
UTG+1: shows [Ad 7c] (a hand...)
Uncalled bet ($21) returned to UTG
UTG collected $50.83 from pot
*** SUMMARY ***
Total pot $53.50 | Rake $2.67
Board [3h 7s 5s 8c Jc]
Seat 1: UTG+1 folded
Seat 2: UTG+2 folded
Seat 3: Dealer folded
Seat 4: Small Blind folded
Seat 5: Hero folded
Seat 6: UTG collected ($50.83)



PokerStars Hand #3947710314:  Hold'em No Limit ($2.50/$5) - 2020/05/20 18:47:01 ET
Table 'Zone Poker ID 1588' 9-max Seat #6 is the button
Seat 1: Small Blind ($500.00 in chips) 
Seat 2: Big Blind ($1293.62 in chips) 
Seat 3: UTG ($962.25 in chips) 
Seat 4: Hero ($750.94 in chips) 
Seat 5: UTG+2 ($1257.83 in chips) 
Seat 6: Dealer ($506.13 in chips) 
Small Blind: posts small blind $2.50
Big Blind: posts big blind $5
*** HOLE CARDS ***
Dealt to Hero [Ad Jd]
UTG: folds 
Hero: raises $7.50 to $12.50
UTG+2: calls $12.50
Dealer: folds 
Small Blind: folds 
Big Blind: folds 
*** FLOP *** [2s 7d 5s]
Hero: checks 
UTG+2: bets $15
Hero: calls $15
*** TURN *** [2s 7d 5s] [8d]
Hero: checks 
UTG+2: bets $40
Hero: calls $40
*** RIVER *** [2s 7d 5s 8d] [6c]
Hero: checks 
UTG+2: bets $40
Hero: folds 
*** SHOW DOWN ***
Small Blind: shows [4d 3d] (a hand...)
Big Blind: shows [Td 4s] (a hand...)
Hero: shows [Ad Jd] (a hand...)
UTG+2: shows [4c 5c] (a hand...)
Dealer: shows [9h 7h] (a hand...)
UTG: shows [8h Qc] (a hand...)
Uncalled bet ($40.00) returned to UTG+2
UTG+2 collected $138.50 from pot
*** SUMMARY ***
Total pot $142.50 | Rake $4.00
Board [2s 7d 5s 8d 6c]
Seat 1: Small Blind folded
Seat 2: Big Blind folded
Seat 3: UTG folded
Seat 4: Hero folded
Seat 5: UTG+2 collected ($138.50)
Seat 6: Dealer folded



PokerStars Hand #3947709391:  Hold'em No Limit ($2.50/$5) - 2020/05/20 18:45:20 ET
Table 'Zone Poker ID 1588' 9-max Seat #5 is the button
Seat 1: Hero ($757.58 in chips) 
Seat 2: UTG ($710.00 in chips) 
Seat 3: UTG+1 ($515.88 in chips) 
Seat 4: UTG+2 ($321.08 in chips) 
Seat 5: Dealer ($622.39 in chips) 
Seat 6: Small Blind ($757.24 in chips) 
Small Blind: posts small blind $2.50
Hero: posts big blind $5
*** HOLE CARDS ***
Dealt to Hero [Th 7h]
UTG: folds 
UTG+1: folds 
UTG+2: folds 
Dealer: raises $6 to $11
Small Blind: folds 
Hero: calls $6
*** FLOP *** [6c 7s 9c]
Hero: checks 
Dealer: checks 
*** TURN *** [6c 7s 9c] [Jh]
Hero: checks 
Dealer: bets $11.64
Hero: calls $11.64
*** RIVER *** [6c 7s 9c Jh] [Kd]
Hero: checks 
Dealer: bets $22.70
Hero: folds 
*** SHOW DOWN ***
Small Blind: shows [Ts 8h] (a hand...)
Hero: shows [Th 7h] (a hand...)
Dealer: shows [Ks Td] (a hand...)
UTG+2: shows [2h 5s] (a hand...)
UTG: shows [Jc 4h] (a hand...)
UTG+1: shows [2c 3d] (a hand...)
Uncalled bet ($22.70) returned to Dealer
Dealer collected $45.40 from pot
*** SUMMARY ***
Total pot $47.78 | Rake $2.38
Board [6c 7s 9c Jh Kd]
Seat 1: Hero folded
Seat 2: UTG folded
Seat 3: UTG+1 folded
Seat 4: UTG+2 folded
Seat 5: Dealer collected ($45.40)
Seat 6: Small Blind folded



PokerStars Hand #3947704875:  Hold'em No Limit ($2.50/$5) - 2020/05/20 18:37:03 ET
Table 'Zone Poker ID 1588' 9-max Seat #2 is the button
Seat 1: Hero ($594.11 in chips) 
Seat 2: Dealer ($128.75 in chips) 
Seat 3: Small Blind ($511.88 in chips) 
Seat 4: Big Blind ($1187.54 in chips) 
Seat 5: UTG ($723.48 in chips) 
Seat 6: UTG+1 ($651.00 in chips) 
Small Blind: posts small blind $2.50
Big Blind: posts big blind $5
*** HOLE CARDS ***
Dealt to Hero [Kc Jh]
UTG: folds 
UTG+1: folds 
Hero: raises $7.50 to $12.50
Dealer: folds 
Small Blind: folds 
Big Blind: calls $7.50
*** FLOP *** [8d 2s Kh]
Big Blind: checks 
Hero: bets $7.84
Big Blind: raises $17.84 to $25.68
Hero: calls $17.84
*** TURN *** [8d 2s Kh] [6c]
Big Blind: bets $56.19
Hero: calls $56.19
*** RIVER *** [8d 2s Kh 6c] [4c]
Big Blind: bets $128.62
Hero: calls $128.62
*** SHOW DOWN ***
Small Blind: shows [3h Ad] (a hand...)
Big Blind: shows [Kd 2d] (a hand...)
Hero: shows [Kc Jh] (a hand...)
Dealer: shows [Js 8c] (a hand...)
UTG: shows [Ac 6h] (a hand...)
UTG+1: shows [4d 3s] (a hand...)
Big Blind collected $444.48 from pot
*** SUMMARY ***
Total pot $448.48 | Rake $4.00
Board [8d 2s Kh 6c 4c]
Seat 1: Hero showed [Kc Jh] and lost with...
Seat 2: Dealer folded
Seat 3: Small Blind folded
Seat 4: Big Blind showed [Kd 2d] and won ($444.48)
Seat 5: UTG folded
Seat 6: UTG+1 folded



PokerStars Hand #3947704707:  Hold'em No Limit ($2.50/$5) - 2020/05/20 18:36:44 ET
Table 'Zone Poker ID 1588' 9-max Seat #6 is the button
Seat 1: Small Blind ($1232.87 in chips) 
Seat 2: Hero ($716.54 in chips) 
Seat 3: UTG ($163.26 in chips) 
Seat 4: UTG+1 ($841.20 in chips) 
Seat 5: UTG+2 ($1187.54 in chips) 
Seat 6: Dealer ($511.32 in chips) 
Small Blind: posts small blind $2.50
Hero: posts big blind $5
*** HOLE CARDS ***
Dealt to Hero [Ad 3d]
UTG: calls $5
UTG+1: folds 
UTG+2: folds 
Dealer: folds 
Small Blind: calls $2.50
Hero: checks 
*** FLOP *** [4s 7c 5s]
Small Blind: checks 
Hero: checks 
UTG: checks 
*** TURN *** [4s 7c 5s] [Td]
Small Blind: checks 
Hero: checks 
UTG: checks 
*** RIVER *** [4s 7c 5s Td] [3c]
Small Blind: bets $10.69
Hero: folds 
UTG: folds 
*** SHOW DOWN ***
Small Blind: shows [Js 9h] (a hand...)
Hero: shows [Ad 3d] (a hand...)
UTG+2: shows [7h Ks] (a hand...)
Dealer: shows [Th 5d] (a hand...)
UTG: shows [Qh Jc] (a hand...)
UTG+1: shows [6d 5h] (a hand...)
Uncalled bet ($10.69) returned to Small Blind
Small Blind collected $14.25 from pot
*** SUMMARY ***
Total pot $15.00 | Rake $0.75
Board [4s 7c 5s Td 3c]
Seat 1: Small Blind collected ($14.25)
Seat 2: Hero folded
Seat 3: UTG folded
Seat 4: UTG+1 folded
Seat 5: UTG+2 folded
Seat 6: Dealer folded



PokerStars Hand #3947595503:  Hold'em No Limit ($2.50/$5) - 2020/05/20 14:37:22 ET
Table 'Zone Poker ID 1588' 9-max Seat #3 is the button
Seat 1: Small Blind ($500.00 in chips) 
Seat 2: Hero ($662.95 in chips) 
Seat 3: Dealer ($522.05 in chips) 
Small Blind: posts small blind $2.50
Hero: posts big blind $5
*** HOLE CARDS ***
Dealt to Hero [Kd Jd]
Dealer: raises $7 to $12
Small Blind: folds 
Hero: raises $45.50 to $57.50
Dealer: calls $45.50
*** FLOP *** [9h 3d 6h]
Hero: bets $63.52
Dealer: calls $63.52
*** TURN *** [9h 3d 6h] [3c]
Hero: checks 
Dealer: checks 
*** RIVER *** [9h 3d 6h 3c] [Jc]
Hero: checks 
Dealer: bets $121.27
Hero: calls $121.27
*** SHOW DOWN ***
Small Blind: shows [4s 2d] (a hand...)
Dealer: shows [8d Td] (a hand...)
Hero: shows [Kd Jd] (a hand...)
Hero collected $485.08 from pot
*** SUMMARY ***
Total pot $487.08 | Rake $2.00
Board [9h 3d 6h 3c Jc]
Seat 1: Small Blind folded
Seat 2: Hero showed [Kd Jd] and won ($485.08)
Seat 3: Dealer showed [8d Td] and lost with...



PokerStars Hand #3947594559:  Hold'em No Limit ($2.50/$5) - 2020/05/20 14:35:06 ET
Table 'Zone Poker ID 1588' 9-max Seat #2 is the button
Seat 1: Big Blind ($520.00 in chips) 
Seat 2: Dealer ($1075.25 in chips) 
Seat 3: Hero ($633.50 in chips) 
Hero: posts small blind $2.50
Big Blind: posts big blind $5
*** HOLE CARDS ***
Dealt to Hero [4c 4s]
Dealer: folds 
Hero: raises $10.00 to $15
Big Blind: calls $10
*** FLOP *** [Qs 9c Ac]
Hero: bets $8.55
Big Blind: calls $8.55
*** TURN *** [Qs 9c Ac] [5d]
Hero: checks 
Big Blind: checks 
*** RIVER *** [Qs 9c Ac 5d] [2s]
Hero: checks 
Big Blind: bets $15
Hero: folds 
*** SHOW DOWN ***
Dealer: shows [4d 2d] (a hand...)
Big Blind: shows [8d Ad] (a hand...)
Hero: shows [4c 4s] (a hand...)
Uncalled bet ($15.00) returned to Big Blind
Big Blind collected $45.10 from pot
*** SUMMARY ***
Total pot $47.10 | Rake $2.00
Board [Qs 9c Ac 5d 2s]
Seat 1: Big Blind collected ($45.10)
Seat 2: Dealer folded
Seat 3: Hero folded



PokerStars Hand #3947592936:  Hold'em No Limit ($2.50/$5) - 2020/05/20 14:31:11 ET
Table 'Zone Poker ID 1588' 9-max Seat #1 is the button
Seat 1: Dealer ($515.00 in chips) 
Seat 2: Small Blind ($445.34 in chips) 
Seat 3: Hero ($715.59 in chips) 
Small Blind: posts small blind $2.50
Hero: posts big blind $5
*** HOLE CARDS ***
Dealt to Hero [9d Kh]
Dealer: folds 
Small Blind: raises $7.50 to $12.50
Hero: calls $7.50
*** FLOP *** [9s 7s Ad]
Small Blind: bets $8
Hero: calls $8
*** TURN *** [9s 7s Ad] [7c]
Small Blind: bets $29.25
Hero: calls $29.25
*** RIVER *** [9s 7s Ad 7c] [5h]
Small Blind: bets $82.18
Hero: folds 
*** SHOW DOWN ***
Small Blind: shows [8s 6d] (a hand...)
Dealer: shows [Kd 2c] (a hand...)
Hero: shows [9d Kh] (a hand...)
Uncalled bet ($82.18) returned to Small Blind
Small Blind collected $97.50 from pot
*** SUMMARY ***
Total pot $99.50 | Rake $2.00
Board [9s 7s Ad 7c 5h]
Seat 1: Dealer folded
Seat 2: Small Blind collected ($97.50)
Seat 3: Hero folded



PokerStars Hand #3947592541:  Hold'em No Limit ($2.50/$5) - 2020/05/20 14:30:12 ET
Table 'Zone Poker ID 1588' 9-max Seat #1 is the button
Seat 1: Dealer ($500.00 in chips) 
Seat 2: Hero ($626.20 in chips) 
Seat 3: Big Blind ($581.37 in chips) 
Hero: posts small blind $2.50
Big Blind: posts big blind $5
*** HOLE CARDS ***
Dealt to Hero [Ks 9s]
Dealer: raises $10 to $15
Hero: raises $50.00 to $65
Big Blind: folds 
Dealer: calls $50
*** FLOP *** [6c 7d Jd]
Hero: bets $73.15
Dealer: calls $73.15
*** TURN *** [6c 7d Jd] [3s]
Hero: checks 
Dealer: checks 
*** RIVER *** [6c 7d Jd 3s] [8d]
Hero: checks 
Dealer: bets $139.65
Hero: folds 
*** SHOW DOWN ***
Dealer: shows [8c 8s] (a hand...)
Big Blind: shows [Qc 6h] (a hand...)
Hero: shows [Ks 9s] (a hand...)
Uncalled bet ($139.65) returned to Dealer
Dealer collected $279.30 from pot
*** SUMMARY ***
Total pot $281.30 | Rake $2.00
Board [6c 7d Jd 3s 8d]
Seat 1: Dealer collected ($279.30)
Seat 2: Hero folded
Seat 3: Big Blind folded



PokerStars Hand #3947592344:  Hold'em No Limit ($2.50/$5) - 2020/05/20 14:29:42 ET
Table 'Zone Poker ID 1588' 9-max Seat #3 is the button
Seat 1: Small Blind ($500.00 in chips) 
Seat 2: Hero ($739.13 in chips) 
Seat 3: Dealer ($907.98 in chips) 
Small Blind: posts small blind $2.50
Hero: posts big blind $5
*** HOLE CARDS ***
Dealt to Hero [Jd Qs]
Dealer: raises $5 to $10
Small Blind: folds 
Hero: calls $5
*** FLOP *** [Ac 6h Js]
Hero: checks 
Dealer: checks 
*** TURN *** [Ac 6h Js] [3d]
Hero: checks 
Dealer: bets $16.04
Hero: calls $16.04
*** RIVER *** [Ac 6h Js 3d] [9d]
Hero: checks 
Dealer: bets $72.58
Hero: folds 
*** SHOW DOWN ***
Small Blind: shows [6d Qh] (a hand...)
Dealer: shows [7h 4h] (a hand...)
Hero: shows [Jd Qs] (a hand...)
Uncalled bet ($72.58) returned to Dealer
Dealer collected $52.58 from pot
*** SUMMARY ***
Total pot $54.58 | Rake $2.00
Board [Ac 6h Js 3d 9d]
Seat 1: Small Blind folded
Seat 2: Hero folded
Seat 3: Dealer collected ($52.58)



PokerStars Hand #3947589254:  Hold'em No Limit ($2.50/$5) - 2020/05/20 14:22:07 ET
Table 'Zone Poker ID 1588' 9-max Seat #1 is the button
Seat 1: Dealer ($2830.09 in chips) 
Seat 2: Small Blind ($542.24 in chips) 
Seat 3: Hero ($549.25 in chips) 
Small Blind: posts small blind $2.50
Hero: posts big blind $5
*** HOLE CARDS ***
Dealt to Hero [Ks 6h]
Dealer: folds 
Small Blind: raises $7.50 to $12.50
Hero: calls $7.50
*** FLOP *** [Kc 5c Ac]
Small Blind: bets $8
Hero: calls $8
*** TURN *** [Kc 5c Ac] [9d]
Small Blind: checks 
Hero: checks 
*** RIVER *** [Kc 5c Ac 9d] [Ad]
Small Blind: bets $29.25
Hero: calls $29.25
*** SHOW DOWN ***
Small Blind: shows [Qh 5s] (a hand...)
Dealer: shows [3h 7s] (a hand...)
Hero: shows [Ks 6h] (a hand...)
Hero collected $97.50 from pot
*** SUMMARY ***
Total pot $99.50 | Rake $2.00
Board [Kc 5c Ac 9d Ad]
Seat 1: Dealer folded
Seat 2: Small Blind showed [Qh 5s] and lost with...
Seat 3: Hero showed [Ks 6h] and won ($97.50)



PokerStars Hand #3947585304:  Hold'em No Limit ($2.50/$5) - 2020/05/20 14:12:05 ET
Table 'Zone Poker ID 1588' 9-max Seat #3 is the button
Seat 1: Small Blind ($158.56 in chips) 
Seat 2: Hero ($457.94 in chips) 
Seat 3: Dealer ($516.82 in chips) 
Small Blind: posts small blind $2.50
Hero: posts big blind $5
*** HOLE CARDS ***
Dealt to Hero [6h 8c]
Dealer: folds 
Small Blind: calls $2.50
Hero: checks 
*** FLOP *** [2s 9c 5c]
Small Blind: checks 
Hero: bets $5
Small Blind: calls $5
*** TURN *** [2s 9c 5c] [Tc]
Small Blind: checks 
Hero: bets $16
Small Blind: calls $16
*** RIVER *** [2s 9c 5c Tc] [Ad]
Small Blind: bets $50
Hero: folds 
*** SHOW DOWN ***
Small Blind: shows [9s Ts] (a hand...)
Dealer: shows [2c Kh] (a hand...)
Hero: shows [6h 8c] (a hand...)
Uncalled bet ($50.00) returned to Small Blind
Small Blind collected $50 from pot
*** SUMMARY ***
Total pot $52.00 | Rake $2.00
Board [2s 9c 5c Tc Ad]
Seat 1: Small Blind collected ($50)
Seat 2: Hero folded
Seat 3: Dealer folded



PokerStars Hand #3947583136:  Hold'em No Limit ($2.50/$5) - 2020/05/20 14:06:25 ET
Table 'Zone Poker ID 1588' 9-max Seat #1 is the button
Seat 1: Hero ($485.89 in chips) 
Seat 2: Small Blind ($576.85 in chips) 
Seat 3: Big Blind ($1232.58 in chips) 
Seat 4: UTG ($515.80 in chips) 
Small Blind: posts small blind $2.50
Big Blind: posts big blind $5
*** HOLE CARDS ***
Dealt to Hero [Ac 6c]
UTG: folds 
Hero: raises $7.50 to $12.50
Small Blind: folds 
Big Blind: calls $7.50
*** FLOP *** [Jh 7h 5d]
Big Blind: checks 
Hero: checks 
*** TURN *** [Jh 7h 5d] [3c]
Big Blind: bets $19.60
Hero: calls $19.60
*** RIVER *** [Jh 7h 5d 3c] [8d]
Big Blind: bets $47.78
Hero: folds 
*** SHOW DOWN ***
Small Blind: shows [9s 2h] (a hand...)
UTG: shows [2d 5s] (a hand...)
Big Blind: shows [Jc Qd] (a hand...)
Hero: shows [Ac 6c] (a hand...)
Uncalled bet ($47.78) returned to Big Blind
Big Blind collected $63.70 from pot
*** SUMMARY ***
Total pot $66.70 | Rake $3.00
Board [Jh 7h 5d 3c 8d]
Seat 1: Hero folded
Seat 2: Small Blind folded
Seat 3: Big Blind collected ($63.70)
Seat 4: UTG folded



PokerStars Hand #3947582341:  Hold'em No Limit ($2.50/$5) - 2020/05/20 14:04:18 ET
Table 'Zone Poker ID 1588' 9-max Seat #5 is the button
Seat 1: Hero ($615.19 in chips) 
Seat 2: Big Blind ($503.38 in chips) 
Seat 3: UTG ($2414.24 in chips) 
Seat 4: UTG+1 ($574.15 in chips) 
Seat 5: Dealer ($245.90 in chips) 
Hero: posts small blind $2.50
Big Blind: posts big blind $5
*** HOLE CARDS ***
Dealt to Hero [8h 8c]
UTG: folds 
UTG+1: raises $7 to $12
Dealer: folds 
Hero: raises $43.00 to $55
Big Blind: folds 
UTG+1: calls $43
*** FLOP *** [Ad 5s Ks]
Hero: bets $33.60
UTG+1: calls $33.60
*** TURN *** [Ad 5s Ks] [3h]
Hero: checks 
UTG+1: checks 
*** RIVER *** [Ad 5s Ks 3h] [Ah]
Hero: checks 
UTG+1: bets $135
Hero: folds 
*** SHOW DOWN ***
Big Blind: shows [4c Kc] (a hand...)
Hero: shows [8h 8c] (a hand...)
Dealer: shows [3d 8d] (a hand...)
UTG: shows [5d Jh] (a hand...)
UTG+1: shows [Js Ac] (a hand...)
Uncalled bet ($135.00) returned to UTG+1
UTG+1 collected $179.20 from pot
*** SUMMARY ***
Total pot $182.20 | Rake $3.00
Board [Ad 5s Ks 3h Ah]
Seat 1: Hero folded
Seat 2: Big Blind folded
Seat 3: UTG folded
Seat 4: UTG+1 collected ($179.20)
Seat 5: Dealer folded



PokerStars Hand #3947545912:  Hold'em No Limit ($2.50/$5) - 2020/05/20 12:20:21 ET
Table 'Zone Poker ID 1588' 9-max Seat #2 is the button
Seat 1: Hero ($487.50 in chips) 
Seat 2: Dealer ($501.13 in chips) 
Seat 3: Small Blind ($1156.27 in chips) 
Small Blind: posts small blind $2.50
Hero: posts big blind $5
*** HOLE CARDS ***
Dealt to Hero [4h Jh]
Dealer: folds 
Small Blind: raises $10.00 to $15
Hero: calls $10
*** FLOP *** [8c Ac Ks]
Small Blind: checks 
Hero: checks 
*** TURN *** [8c Ac Ks] [8h]
Small Blind: checks 
Hero: checks 
*** RIVER *** [8c Ac Ks 8h] [7d]
Small Blind: bets $10
Hero: folds 
*** SHOW DOWN ***
Small Blind: shows [Kd Qh] (a hand...)
Dealer: shows [3h 7s] (a hand...)
Hero: shows [4h Jh] (a hand...)
Uncalled bet ($10.00) returned to Small Blind
Small Blind collected $28.50 from pot
*** SUMMARY ***
Total pot $30.00 | Rake $1.50
Board [8c Ac Ks 8h 7d]
Seat 1: Hero folded
Seat 2: Dealer folded
Seat 3: Small Blind collected ($28.50)



PokerStars Hand #3947544998:  Hold'em No Limit ($2.50/$5) - 2020/05/20 12:17:28 ET
Table 'Zone Poker ID 1588' 9-max Seat #3 is the button
Seat 1: Small Blind ($500.00 in chips) 
Seat 2: Hero ($478.88 in chips) 
Seat 3: Dealer ($518.38 in chips) 
Small Blind: posts small blind $2.50
Hero: posts big blind $5
*** HOLE CARDS ***
Dealt to Hero [7d Kh]
Dealer: raises $5 to $10
Small Blind: folds 
Hero: calls $5
*** FLOP *** [Ts 7c 2s]
Hero: checks 
Dealer: bets $10.69
Hero: calls $10.69
*** TURN *** [Ts 7c 2s] [Td]
Hero: checks 
Dealer: bets $25.94
Hero: calls $25.94
*** RIVER *** [Ts 7c 2s Td] [Js]
Hero: checks 
Dealer: bets $75.32
Hero: folds 
*** SHOW DOWN ***
Small Blind: shows [6h Jd] (a hand...)
Dealer: shows [Th Jc] (a hand...)
Hero: shows [7d Kh] (a hand...)
Uncalled bet ($75.32) returned to Dealer
Dealer collected $93.76 from pot
*** SUMMARY ***
Total pot $95.76 | Rake $2.00
Board [Ts 7c 2s Td Js]
Seat 1: Small Blind folded
Seat 2: Hero folded
Seat 3: Dealer collected ($93.76)



PokerStars Hand #3947544582:  Hold'em No Limit ($2.50/$5) - 2020/05/20 12:16:05 ET
Table 'Zone Poker ID 1588' 9-max Seat #1 is the button
Seat 1: Dealer ($1011.71 in chips) 
Seat 2: Small Blind ($521.32 in chips) 
Seat 3: Hero ($500.00 in chips) 
Small Blind: posts small blind $2.50
Hero: posts big blind $5
*** HOLE CARDS ***
Dealt to Hero [8d 8s]
Dealer: raises $7.50 to $12.50
Small Blind: folds 
Hero: calls $7.50
*** FLOP *** [6s 6d Ah]
Hero: checks 
Dealer: bets $8.62
Hero: calls $8.62
*** TURN *** [6s 6d Ah] [7h]
Hero: checks 
Dealer: checks 
*** RIVER *** [6s 6d Ah 7h] [2s]
Hero: checks 
Dealer: bets $21.37
Hero: folds 
*** SHOW DOWN ***
Small Blind: shows [Ts 8h] (a hand...)
Dealer: shows [Kd Jh] (a hand...)
Hero: shows [8d 8s] (a hand...)
Uncalled bet ($21.37) returned to Dealer
Dealer collected $42.74 from pot
*** SUMMARY ***
Total pot $44.74 | Rake $2.00
Board [6s 6d Ah 7h 2s]
Seat 1: Dealer collected ($42.74)
Seat 2: Small Blind folded
Seat 3: Hero folded



PokerStars Hand #3947540545:  Hold'em No Limit ($2.50/$5) - 2020/05/20 12:02:44 ET
Table 'Zone Poker ID 1588' 9-max Seat #1 is the button
Seat 1: Hero ($497.50 in chips) 
Seat 2: Small Blind ($946.39 in chips) 
Seat 3: Big Blind ($1028.19 in chips) 
Small Blind: posts small blind $2.50
Big Blind: posts big blind $5
*** HOLE CARDS ***
Dealt to Hero [5c 6c]
Hero: raises $7.50 to $12.50
Small Blind: folds 
Big Blind: calls $7.50
*** FLOP *** [Kc 8s Qs]
Big Blind: checks 
Hero: bets $7.84
Big Blind: calls $7.84
*** TURN *** [Kc 8s Qs] [8d]
Big Blind: checks 
Hero: checks 
*** RIVER *** [Kc 8s Qs 8d] [9s]
Big Blind: bets $13
Hero: folds 
*** SHOW DOWN ***
Small Blind: shows [Jc Td] (a hand...)
Big Blind: shows [7s Kd] (a hand...)
Hero: shows [5c 6c] (a hand...)
Uncalled bet ($13.00) returned to Big Blind
Big Blind collected $41.18 from pot
*** SUMMARY ***
Total pot $43.18 | Rake $2.00
Board [Kc 8s Qs 8d 9s]
Seat 1: Hero folded
Seat 2: Small Blind folded
Seat 3: Big Blind collected ($41.18)



PokerStars Hand #3947325988:  Hold'em No Limit ($2.50/$5) - 2020/05/20 00:31:12 ET
Table 'Zone Poker ID 1588' 9-max Seat #2 is the button
Seat 1: Hero ($577.50 in chips) 
Seat 2: Dealer ($599.00 in chips) 
Seat 3: Small Blind ($636.03 in chips) 
Small Blind: posts small blind $2.50
Hero: posts big blind $5
*** HOLE CARDS ***
Dealt to Hero [8c 9h]
Dealer: raises $5 to $10
Small Blind: folds 
Hero: calls $5
*** FLOP *** [2h 3s 6h]
Hero: checks 
Dealer: bets $5.69
Hero: calls $5.69
*** TURN *** [2h 3s 6h] [9c]
Hero: checks 
Dealer: bets $47.19
Hero: calls $47.19
*** RIVER *** [2h 3s 6h 9c] [Td]
Hero: checks 
Dealer: bets $63.13
Hero: calls $63.13
*** SHOW DOWN ***
Small Blind: shows [4s 2s] (a hand...)
Dealer: shows [Js Jc] (a hand...)
Hero: shows [8c 9h] (a hand...)
Dealer collected $252.52 from pot
*** SUMMARY ***
Total pot $254.52 | Rake $2.00
Board [2h 3s 6h 9c Td]
Seat 1: Hero showed [8c 9h] and lost with...
Seat 2: Dealer showed [Js Jc] and won ($252.52)
Seat 3: Small Blind folded



PokerStars Hand #3947314226:  Hold'em No Limit ($2.50/$5) - 2020/05/20 00:11:44 ET
Table 'Zone Poker ID 1588' 9-max Seat #3 is the button
Seat 1: Small Blind ($460.00 in chips) 
Seat 2: Big Blind ($222.50 in chips) 
Seat 3: Hero ($862.46 in chips) 
Small Blind: posts small blind $2.50
Big Blind: posts big blind $5
*** HOLE CARDS ***
Dealt to Hero [Td Qd]
Hero: raises $7.50 to $12.50
Small Blind: folds 
Big Blind: calls $7.50
*** FLOP *** [Ad Qh Ah]
Big Blind: checks 
Hero: checks 
*** TURN *** [Ad Qh Ah] [9d]
Big Blind: checks 
Hero: bets $13.07
Big Blind: calls $13.07
*** RIVER *** [Ad Qh Ah 9d] [6d]
Big Blind: checks 
Hero: bets $38.73
Big Blind: raises $61.27 to $100
Hero: calls $61.27
*** SHOW DOWN ***
Small Blind: shows [Kc 7s] (a hand...)
Big Blind: shows [Kd 5d] (a hand...)
Hero: shows [Td Qd] (a hand...)
Big Blind collected $251.64 from pot
*** SUMMARY ***
Total pot $253.64 | Rake $2.00
Board [Ad Qh Ah 9d 6d]
Seat 1: Small Blind folded
Seat 2: Big Blind showed [Kd 5d] and won ($251.64)
Seat 3: Hero showed [Td Qd] and lost with...



PokerStars Hand #3947311457:  Hold'em No Limit ($2.50/$5) - 2020/05/20 00:07:14 ET
Table 'Zone Poker ID 1588' 9-max Seat #3 is the button
Seat 1: Small Blind ($489.63 in chips) 
Seat 2: Hero ($515.68 in chips) 
Seat 3: Dealer ($893.18 in chips) 
Small Blind: posts small blind $2.50
Hero: posts big blind $5
*** HOLE CARDS ***
Dealt to Hero [5d 5s]
Dealer: folds 
Small Blind: raises $15.00 to $20
Hero: calls $15
*** FLOP *** [6d Th 2h]
Small Blind: bets $19
Hero: calls $19
*** TURN *** [6d Th 2h] [5c]
Small Blind: bets $38
Hero: raises $80 to $118
Small Blind: calls $80
*** RIVER *** [6d Th 2h 5c] [9s]
Small Blind: bets $332.63 and is all-in
Hero: calls $332.63
*** SHOW DOWN ***
Small Blind: shows [8c 7c] (a hand...)
Dealer: shows [7h 3s] (a hand...)
Hero: shows [5d 5s] (a hand...)
Small Blind collected $977.26 from pot
*** SUMMARY ***
Total pot $979.26 | Rake $2.00
Board [6d Th 2h 5c 9s]
Seat 1: Small Blind showed [8c 7c] and won ($977.26)
Seat 2: Hero showed [5d 5s] and lost with...
Seat 3: Dealer folded



PokerStars Hand #3947310535:  Hold'em No Limit ($2.50/$5) - 2020/05/20 00:05:45 ET
Table 'Zone Poker ID 1588' 9-max Seat #3 is the button
Seat 1: Hero ($580.21 in chips) 
Seat 2: Big Blind ($881.63 in chips) 
Seat 3: Dealer ($982.00 in chips) 
Hero: posts small blind $2.50
Big Blind: posts big blind $5
*** HOLE CARDS ***
Dealt to Hero [Js 9c]
Dealer: folds 
Hero: raises $10.00 to $15
Big Blind: calls $10
*** FLOP *** [Ah 8d 4c]
Hero: checks 
Big Blind: checks 
*** TURN *** [Ah 8d 4c] [Qd]
Hero: checks 
Big Blind: checks 
*** RIVER *** [Ah 8d 4c Qd] [8c]
Hero: bets $8.55
Big Blind: raises $29.20 to $37.75
Hero: folds 
*** SHOW DOWN ***
Dealer: shows [9d 3c] (a hand...)
Big Blind: shows [8s 6c] (a hand...)
Hero: shows [Js 9c] (a hand...)
Uncalled bet ($29.20) returned to Big Blind
Big Blind collected $45.10 from pot
*** SUMMARY ***
Total pot $47.10 | Rake $2.00
Board [Ah 8d 4c Qd 8c]
Seat 1: Hero folded
Seat 2: Big Blind collected ($45.10)
Seat 3: Dealer folded



PokerStars Hand #3947306856:  Hold'em No Limit ($2.50/$5) - 2020/05/19 23:59:54 ET
Table 'Zone Poker ID 1588' 9-max Seat #3 is the button
Seat 1: Hero ($798.37 in chips) 
Seat 2: Big Blind ($538.00 in chips) 
Seat 3: Dealer ($909.73 in chips) 
Hero: posts small blind $2.50
Big Blind: posts big blind $5
*** HOLE CARDS ***
Dealt to Hero [Ac Jh]
Dealer: folds 
Hero: raises $10.00 to $15
Big Blind: calls $10
*** FLOP *** [Td 9s 7c]
Hero: checks 
Big Blind: checks 
*** TURN *** [Td 9s 7c] [Ah]
Hero: checks 
Big Blind: bets $16.38
Hero: calls $16.38
*** RIVER *** [Td 9s 7c Ah] [5h]
Hero: checks 
Big Blind: bets $45.57
Hero: calls $45.57
*** SHOW DOWN ***
Dealer: shows [9d 4h] (a hand...)
Big Blind: shows [6d 5s] (a hand...)
Hero: shows [Ac Jh] (a hand...)
Hero collected $151.90 from pot
*** SUMMARY ***
Total pot $153.90 | Rake $2.00
Board [Td 9s 7c Ah 5h]
Seat 1: Hero showed [Ac Jh] and won ($151.90)
Seat 2: Big Blind showed [6d 5s] and lost with...
Seat 3: Dealer folded



PokerStars Hand #3947103975:  Hold'em No Limit ($2.50/$5) - 2020/05/19 18:21:43 ET
Table 'Zone Poker ID 1588' 9-max Seat #2 is the button
Seat 1: Big Blind ($725.44 in chips) 
Seat 2: Dealer ($500.00 in chips) 
Seat 3: Hero ($529.15 in chips) 
Hero: posts small blind $2.50
Big Blind: posts big blind $5
*** HOLE CARDS ***
Dealt to Hero [5c 4c]
Dealer: folds 
Hero: raises $10.00 to $15
Big Blind: calls $10
*** FLOP *** [7d 9d 4d]
Hero: checks 
Big Blind: checks 
*** TURN *** [7d 9d 4d] [Qd]
Hero: checks 
Big Blind: checks 
*** RIVER *** [7d 9d 4d Qd] [Jd]
Hero: checks 
Big Blind: bets $14.25
Hero: calls $14.25
*** SHOW DOWN ***
Dealer: shows [8d 3h] (a hand...)
Big Blind: shows [Ac Th] (a hand...)
Hero: shows [5c 4c] (a hand...)
Big Blind collected $28.25 from pot
Hero collected $28.25 from pot
*** SUMMARY ***
Total pot $58.50 | Rake $2.00
Board [7d 9d 4d Qd Jd]
Seat 1: Big Blind showed [Ac Th] and won ($28.25)
Seat 2: Dealer folded
Seat 3: Hero showed [5c 4c] and won ($28.25)



PokerStars Hand #3947102006:  Hold'em No Limit ($2.50/$5) - 2020/05/19 18:17:55 ET
Table 'Zone Poker ID 1588' 9-max Seat #2 is the button
Seat 1: Hero ($683.15 in chips) 
Seat 2: Dealer ($513.75 in chips) 
Seat 3: Small Blind ($1005.88 in chips) 
Small Blind: posts small blind $2.50
Hero: posts big blind $5
*** HOLE CARDS ***
Dealt to Hero [Js Tc]
Dealer: raises $7.50 to $12.50
Small Blind: folds 
Hero: calls $7.50
*** FLOP *** [Ad 9c Jc]
Hero: checks 
Dealer: checks 
*** TURN *** [Ad 9c Jc] [Qs]
Hero: checks 
Dealer: bets $19.60
Hero: calls $19.60
*** RIVER *** [Ad 9c Jc Qs] [2d]
Hero: checks 
Dealer: bets $48.53
Hero: folds 
*** SHOW DOWN ***
Small Blind: shows [5c 7h] (a hand...)
Dealer: shows [Qc 9s] (a hand...)
Hero: shows [Js Tc] (a hand...)
Uncalled bet ($48.53) returned to Dealer
Dealer collected $64.70 from pot
*** SUMMARY ***
Total pot $66.70 | Rake $2.00
Board [Ad 9c Jc Qs 2d]
Seat 1: Hero folded
Seat 2: Dealer collected ($64.70)
Seat 3: Small Blind folded



PokerStars Hand #3947100964:  Hold'em No Limit ($2.50/$5) - 2020/05/19 18:15:54 ET
Table 'Zone Poker ID 1588' 9-max Seat #3 is the button
Seat 1: Small Blind ($553.45 in chips) 
Seat 2: Hero ($692.90 in chips) 
Seat 3: Dealer ($574.95 in chips) 
Small Blind: posts small blind $2.50
Hero: posts big blind $5
*** HOLE CARDS ***
Dealt to Hero [4s Ad]
Dealer: raises $7.50 to $12.50
Small Blind: folds 
Hero: calls $7.50
*** FLOP *** [8d 9d Ah]
Hero: checks 
Dealer: bets $8.07
Hero: calls $8.07
*** TURN *** [8d 9d Ah] [5h]
Hero: checks 
Dealer: checks 
*** RIVER *** [8d 9d Ah 5h] [5c]
Hero: checks 
Dealer: bets $31.23
Hero: calls $31.23
*** SHOW DOWN ***
Small Blind: shows [Ts Jd] (a hand...)
Dealer: shows [4d Ac] (a hand...)
Hero: shows [4s Ad] (a hand...)
Hero collected $52.05 from pot
Dealer collected $52.05 from pot
*** SUMMARY ***
Total pot $106.10 | Rake $2.00
Board [8d 9d Ah 5h 5c]
Seat 1: Small Blind folded
Seat 2: Hero showed [4s Ad] and won ($52.05)
Seat 3: Dealer showed [4d Ac] and won ($52.05)



PokerStars Hand #3947100888:  Hold'em No Limit ($2.50/$5) - 2020/05/19 18:15:45 ET
Table 'Zone Poker ID 1588' 9-max Seat #2 is the button
Seat 1: Hero ($975.50 in chips) 
Seat 2: Dealer ($603.29 in chips) 
Seat 3: Small Blind ($906.68 in chips) 
Small Blind: posts small blind $2.50
Hero: posts big blind $5
*** HOLE CARDS ***
Dealt to Hero [Jc Ts]
Dealer: folds 
Small Blind: raises $7.50 to $12.50
Hero: calls $7.50
*** FLOP *** [Ac 7c 6d]
Small Blind: checks 
Hero: checks 
*** TURN *** [Ac 7c 6d] [Kd]
Small Blind: bets $11.88
Hero: calls $11.88
*** RIVER *** [Ac 7c 6d Kd] [Js]
Small Blind: bets $46.76
Hero: folds 
*** SHOW DOWN ***
Small Blind: shows [9c Qd] (a hand...)
Dealer: shows [9h 3d] (a hand...)
Hero: shows [Jc Ts] (a hand...)
Uncalled bet ($46.76) returned to Small Blind
Small Blind collected $46.76 from pot
*** SUMMARY ***
Total pot $48.76 | Rake $2.00
Board [Ac 7c 6d Kd Js]
Seat 1: Hero folded
Seat 2: Dealer folded
Seat 3: Small Blind collected ($46.76)



PokerStars Hand #3947098248:  Hold'em No Limit ($2.50/$5) - 2020/05/19 18:10:31 ET
Table 'Zone Poker ID 1588' 9-max Seat #1 is the button
Seat 1: Hero ($854.65 in chips) 
Seat 2: Small Blind ($500.00 in chips) 
Seat 3: Big Blind ($516.13 in chips) 
Small Blind: posts small blind $2.50
Big Blind: posts big blind $5
*** HOLE CARDS ***
Dealt to Hero [Ah Kd]
Hero: raises $7.50 to $12.50
Small Blind: raises $37.50 to $50
Big Blind: folds 
Hero: raises $70.00 to $120
Small Blind: calls $70
*** FLOP *** [6s Td 4d]
Small Blind: checks 
Hero: checks 
*** TURN *** [6s Td 4d] [Jc]
Small Blind: checks 
Hero: checks 
*** RIVER *** [6s Td 4d Jc] [Ad]
Small Blind: bets $380 and is all-in
Hero: folds 
*** SHOW DOWN ***
Small Blind: shows [9c Tc] (a hand...)
Big Blind: shows [Kc 3s] (a hand...)
Hero: shows [Ah Kd] (a hand...)
Uncalled bet ($380.00) returned to Small Blind
Small Blind collected $243 from pot
*** SUMMARY ***
Total pot $245.00 | Rake $2.00
Board [6s Td 4d Jc Ad]
Seat 1: Hero folded
Seat 2: Small Blind collected ($243)
Seat 3: Big Blind folded



PokerStars Hand #3947097102:  Hold'em No Limit ($2.50/$5) - 2020/05/19 18:08:16 ET
Table 'Zone Poker ID 1588' 9-max Seat #2 is the button
Seat 1: Hero ($517.00 in chips) 
Seat 2: Dealer ($477.50 in chips) 
Seat 3: Small Blind ($123.04 in chips) 
Small Blind: posts small blind $2.50
Hero: posts big blind $5
*** HOLE CARDS ***
Dealt to Hero [Ah Ts]
Dealer: raises $7.50 to $12.50
Small Blind: folds 
Hero: calls $7.50
*** FLOP *** [7s 9h 8c]
Hero: checks 
Dealer: checks 
*** TURN *** [7s 9h 8c] [4s]
Hero: bets $8
Dealer: calls $8
*** RIVER *** [7s 9h 8c 4s] [Kh]
Hero: checks 
Dealer: bets $31.13
Hero: calls $31.13
*** SHOW DOWN ***
Small Blind: shows [Ad 2h] (a hand...)
Dealer: shows [7c Kc] (a hand...)
Hero: shows [Ah Ts] (a hand...)
Dealer collected $103.76 from pot
*** SUMMARY ***
Total pot $105.76 | Rake $2.00
Board [7s 9h 8c 4s Kh]
Seat 1: Hero showed [Ah Ts] and lost with...
Seat 2: Dealer showed [7c Kc] and won ($103.76)
Seat 3: Small Blind folded



PokerStars Hand #3947096937:  Hold'em No Limit ($2.50/$5) - 2020/05/19 18:07:56 ET
Table 'Zone Poker ID 1588' 9-max Seat #1 is the button
Seat 1: Dealer ($734.84 in chips) 
Seat 2: Small Blind ($319.28 in chips) 
Seat 3: Hero ($855.22 in chips) 
Small Blind: posts small blind $2.50
Hero: posts big blind $5
*** HOLE CARDS ***
Dealt to Hero [6s As]
Dealer: raises $7.50 to $12.50
Small Blind: folds 
Hero: calls $7.50
*** FLOP *** [4s Kd 3d]
Hero: checks 
Dealer: bets $8.07
Hero: calls $8.07
*** TURN *** [4s Kd 3d] [2d]
Hero: checks 
Dealer: checks 
*** RIVER *** [4s Kd 3d 2d] [8d]
Hero: checks 
Dealer: bets $31.23
Hero: folds 
*** SHOW DOWN ***
Small Blind: shows [Th 4c] (a hand...)
Dealer: shows [Jd Ks] (a hand...)
Hero: shows [6s As] (a hand...)
Uncalled bet ($31.23) returned to Dealer
Dealer collected $41.64 from pot
*** SUMMARY ***
Total pot $43.64 | Rake $2.00
Board [4s Kd 3d 2d 8d]
Seat 1: Dealer collected ($41.64)
Seat 2: Small Blind folded
Seat 3: Hero folded



PokerStars Hand #3947096571:  Hold'em No Limit ($2.50/$5) - 2020/05/19 18:07:11 ET
Table 'Zone Poker ID 1588' 9-max Seat #3 is the button
Seat 1: Small Blind ($133.04 in chips) 
Seat 2: Big Blind ($283.44 in chips) 
Seat 3: Hero ($890.56 in chips) 
Small Blind: posts small blind $2.50
Big Blind: posts big blind $5
*** HOLE CARDS ***
Dealt to Hero [4d Ah]
Hero: raises $7.50 to $12.50
Small Blind: folds 
Big Blind: calls $7.50
*** FLOP *** [Jc 7d 3s]
Big Blind: checks 
Hero: bets $7.84
Big Blind: calls $7.84
*** TURN *** [Jc 7d 3s] [4s]
Big Blind: checks 
Hero: checks 
*** RIVER *** [Jc 7d 3s 4s] [Jh]
Big Blind: bets $15
Hero: calls $15
*** SHOW DOWN ***
Small Blind: shows [Js 3h] (a hand...)
Big Blind: shows [Jd As] (a hand...)
Hero: shows [4d Ah] (a hand...)
Big Blind collected $71.18 from pot
*** SUMMARY ***
Total pot $73.18 | Rake $2.00
Board [Jc 7d 3s 4s Jh]
Seat 1: Small Blind folded
Seat 2: Big Blind showed [Jd As] and won ($71.18)
Seat 3: Hero showed [4d Ah] and lost with...



PokerStars Hand #3947095901:  Hold'em No Limit ($2.50/$5) - 2020/05/19 18:05:53 ET
Table 'Zone Poker ID 1588' 9-max Seat #3 is the button
Seat 1: Small Blind ($17.89 in chips) 
Seat 2: Hero ($974.24 in chips) 
Seat 3: Dealer ($554.11 in chips) 
Small Blind: posts small blind $2.50
Hero: posts big blind $5
*** HOLE CARDS ***
Dealt to Hero [Ah Qc]
Dealer: raises $6 to $11
Small Blind: folds 
Hero: calls $6
*** FLOP *** [2d 6c Ks]
Hero: checks 
Dealer: bets $7.68
Hero: calls $7.68
*** TURN *** [2d 6c Ks] [8c]
Hero: checks 
Dealer: bets $65
Hero: calls $65
*** RIVER *** [2d 6c Ks 8c] [5h]
Hero: checks 
Dealer: bets $200
Hero: folds 
*** SHOW DOWN ***
Small Blind: shows [Ts 7d] (a hand...)
Dealer: shows [6h 6d] (a hand...)
Hero: shows [Ah Qc] (a hand...)
Uncalled bet ($200.00) returned to Dealer
Dealer collected $167.86 from pot
*** SUMMARY ***
Total pot $169.86 | Rake $2.00
Board [2d 6c Ks 8c 5h]
Seat 1: Small Blind folded
Seat 2: Hero folded
Seat 3: Dealer collected ($167.86)



PokerStars Hand #3947095146:  Hold'em No Limit ($2.50/$5) - 2020/05/19 18:04:22 ET
Table 'Zone Poker ID 1588' 9-max Seat #1 is the button
Seat 1: Dealer ($503.51 in chips) 
Seat 2: Hero ($485.62 in chips) 
Seat 3: Big Blind ($870.09 in chips) 
Hero: posts small blind $2.50
Big Blind: posts big blind $5
*** HOLE CARDS ***
Dealt to Hero [Th Ah]
Dealer: raises $7.50 to $12.50
Hero: raises $42.50 to $55
Big Blind: folds 
Dealer: calls $42.50
*** FLOP *** [4d Kh 4c]
Hero: bets $33.90
Dealer: calls $33.90
*** TURN *** [4d Kh 4c] [Ts]
Hero: checks 
Dealer: bets $65.40
Hero: calls $65.40
*** RIVER *** [4d Kh 4c Ts] [7s]
Hero: checks 
Dealer: bets $349.21 and is all-in
Hero: calls $331.32 and is all-in
*** SHOW DOWN ***
Dealer: shows [8c Ac] (a hand...)
Big Blind: shows [3d 9s] (a hand...)
Hero: shows [Th Ah] (a hand...)
Uncalled bet ($17.89) returned to Dealer
Hero collected $974.24 from pot
*** SUMMARY ***
Total pot $976.24 | Rake $2.00
Board [4d Kh 4c Ts 7s]
Seat 1: Dealer showed [8c Ac] and lost with...
Seat 2: Hero showed [Th Ah] and won ($974.24)
Seat 3: Big Blind folded



PokerStars Hand #3947094758:  Hold'em No Limit ($2.50/$5) - 2020/05/19 18:03:35 ET
Table 'Zone Poker ID 1588' 9-max Seat #1 is the button
Seat 1: Dealer ($860.09 in chips) 
Seat 2: Small Blind ($689.62 in chips) 
Seat 3: Hero ($512.50 in chips) 
Small Blind: posts small blind $2.50
Hero: posts big blind $5
*** HOLE CARDS ***
Dealt to Hero [Qd Ts]
Dealer: folds 
Small Blind: raises $7.50 to $12.50
Hero: calls $7.50
*** FLOP *** [Ad Th Kh]
Small Blind: checks 
Hero: checks 
*** TURN *** [Ad Th Kh] [5s]
Small Blind: bets $11.88
Hero: calls $11.88
*** RIVER *** [Ad Th Kh 5s] [9s]
Small Blind: bets $95
Hero: folds 
*** SHOW DOWN ***
Small Blind: shows [5h Jc] (a hand...)
Dealer: shows [6s 3d] (a hand...)
Hero: shows [Qd Ts] (a hand...)
Uncalled bet ($95.00) returned to Small Blind
Small Blind collected $46.76 from pot
*** SUMMARY ***
Total pot $48.76 | Rake $2.00
Board [Ad Th Kh 5s 9s]
Seat 1: Dealer folded
Seat 2: Small Blind collected ($46.76)
Seat 3: Hero folded



PokerStars Hand #3946501522:  Hold'em No Limit ($2.50/$5) - 2020/05/18 17:26:42 ET
Table 'Zone Poker ID 1588' 9-max Seat #3 is the button
Seat 1: Big Blind ($520.35 in chips) 
Seat 2: Hero ($484.06 in chips) 
Seat 3: Dealer ($988.75 in chips) 
Seat 4: Small Blind ($480.00 in chips) 
Small Blind: posts small blind $2.50
Big Blind: posts big blind $5
*** HOLE CARDS ***
Dealt to Hero [4c 4h]
Hero: raises $7.50 to $12.50
Dealer: folds 
Small Blind: folds 
Big Blind: raises $20.50 to $33
Hero: calls $20.50
*** FLOP *** [9c Jd 5s]
Big Blind: bets $19
Hero: calls $19
*** TURN *** [9c Jd 5s] [8s]
Big Blind: checks 
Hero: checks 
*** RIVER *** [9c Jd 5s 8s] [Ks]
Big Blind: bets $49
Hero: folds 
*** SHOW DOWN ***
Small Blind: shows [Th Qd] (a hand...)
Dealer: shows [3s 4s] (a hand...)
Big Blind: shows [Kc Qc] (a hand...)
Hero: shows [4c 4h] (a hand...)
Uncalled bet ($49.00) returned to Big Blind
Big Blind collected $103.50 from pot
*** SUMMARY ***
Total pot $106.50 | Rake $3.00
Board [9c Jd 5s 8s Ks]
Seat 1: Big Blind collected ($103.50)
Seat 2: Hero folded
Seat 3: Dealer folded
Seat 4: Small Blind folded



PokerStars Hand #3946500939:  Hold'em No Limit ($2.50/$5) - 2020/05/18 17:25:37 ET
Table 'Zone Poker ID 1588' 9-max Seat #2 is the button
Seat 1: Hero ($546.00 in chips) 
Seat 2: Dealer ($485.00 in chips) 
Seat 3: Small Blind ($1834.80 in chips) 
Seat 4: Big Blind ($922.99 in chips) 
Small Blind: posts small blind $2.50
Big Blind: posts big blind $5
*** HOLE CARDS ***
Dealt to Hero [Qh Td]
Hero: raises $7.50 to $12.50
Dealer: folds 
Small Blind: calls $10
Big Blind: folds 
*** FLOP *** [6h Kh 8c]
Small Blind: checks 
Hero: bets $14.25
Small Blind: raises $28.50 to $42.75
Hero: raises $49.77 to $92.52
Small Blind: calls $49.77
*** TURN *** [6h Kh 8c] [Qd]
Small Blind: checks 
Hero: checks 
*** RIVER *** [6h Kh 8c Qd] [4h]
Small Blind: bets $106.02
Hero: folds 
*** SHOW DOWN ***
Small Blind: shows [8h 9h] (a hand...)
Dealer: shows [4d Qs] (a hand...)
Big Blind: shows [Ts 2c] (a hand...)
Hero: shows [Qh Td] (a hand...)
Uncalled bet ($106.02) returned to Small Blind
Small Blind collected $212.04 from pot
*** SUMMARY ***
Total pot $215.04 | Rake $3.00
Board [6h Kh 8c Qd 4h]
Seat 1: Hero folded
Seat 2: Dealer folded
Seat 3: Small Blind collected ($212.04)
Seat 4: Big Blind folded



PokerStars Hand #3946427007:  Hold'em No Limit ($2.50/$5) - 2020/05/18 14:39:26 ET
Table 'Zone Poker ID 1588' 9-max Seat #4 is the button
Seat 1: Big Blind ($500.00 in chips) 
Seat 2: UTG ($530.50 in chips) 
Seat 3: UTG+1 ($2005.19 in chips) 
Seat 4: Hero ($1569.00 in chips) 
Seat 5: Small Blind ($533.69 in chips) 
Small Blind: posts small blind $2.50
Big Blind: posts big blind $5
*** HOLE CARDS ***
Dealt to Hero [5d 8d]
UTG: folds 
UTG+1: folds 
Hero: raises $7.50 to $12.50
Small Blind: calls $10
Big Blind: folds 
*** FLOP *** [Jd 2c 5s]
Small Blind: checks 
Hero: bets $8.55
Small Blind: calls $8.55
*** TURN *** [Jd 2c 5s] [9c]
Small Blind: checks 
Hero: checks 
*** RIVER *** [Jd 2c 5s 9c] [Jh]
Small Blind: bets $44.75
Hero: folds 
*** SHOW DOWN ***
Small Blind: shows [3h 4h] (a hand...)
Big Blind: shows [3c 6c] (a hand...)
Hero: shows [5d 8d] (a hand...)
UTG: shows [9d 4s] (a hand...)
UTG+1: shows [Td 8s] (a hand...)
Uncalled bet ($44.75) returned to Small Blind
Small Blind collected $44.75 from pot
*** SUMMARY ***
Total pot $47.10 | Rake $2.35
Board [Jd 2c 5s 9c Jh]
Seat 1: Big Blind folded
Seat 2: UTG folded
Seat 3: UTG+1 folded
Seat 4: Hero folded
Seat 5: Small Blind collected ($44.75)



PokerStars Hand #3946424526:  Hold'em No Limit ($2.50/$5) - 2020/05/18 14:33:21 ET
Table 'Zone Poker ID 1588' 9-max Seat #4 is the button
Seat 1: Big Blind ($500.00 in chips) 
Seat 2: Hero ($507.00 in chips) 
Seat 3: UTG+1 ($1042.26 in chips) 
Seat 4: Dealer ($179.15 in chips) 
Seat 5: Small Blind ($2025.83 in chips) 
Small Blind: posts small blind $2.50
Big Blind: posts big blind $5
*** HOLE CARDS ***
Dealt to Hero [8d 8c]
Hero: raises $7.50 to $12.50
UTG+1: raises $30.00 to $42.50
Dealer: folds 
Small Blind: folds 
Big Blind: folds 
Hero: calls $30
*** FLOP *** [2d 8h Ac]
Hero: checks 
UTG+1: bets $32
Hero: calls $32
*** TURN *** [2d 8h Ac] [Td]
Hero: checks 
UTG+1: bets $110.13
Hero: calls $110.13
*** RIVER *** [2d 8h Ac Td] [Js]
Hero: checks 
UTG+1: bets $857.63 and is all-in
Hero: calls $322.37 and is all-in
*** SHOW DOWN ***
Small Blind: shows [4d 3c] (a hand...)
Big Blind: shows [7d 2s] (a hand...)
Hero: shows [8d 8c] (a hand...)
Dealer: shows [6d 2c] (a hand...)
UTG+1: shows [Kh As] (a hand...)
Uncalled bet ($535.26) returned to UTG+1
Hero collected $1018.50 from pot
*** SUMMARY ***
Total pot $1021.50 | Rake $3.00
Board [2d 8h Ac Td Js]
Seat 1: Big Blind folded
Seat 2: Hero showed [8d 8c] and won ($1018.50)
Seat 3: UTG+1 showed [Kh As] and lost with...
Seat 4: Dealer folded
Seat 5: Small Blind folded



PokerStars Hand #3946421041:  Hold'em No Limit ($2.50/$5) - 2020/05/18 14:24:48 ET
Table 'Zone Poker ID 1588' 9-max Seat #3 is the button
Seat 1: UTG ($500.00 in chips) 
Seat 2: UTG+1 ($2107.48 in chips) 
Seat 3: Hero ($500.00 in chips) 
Seat 4: Small Blind ($577.57 in chips) 
Seat 5: Big Blind ($492.50 in chips) 
Small Blind: posts small blind $2.50
Big Blind: posts big blind $5
*** HOLE CARDS ***
Dealt to Hero [Kc 6c]
UTG: folds 
UTG+1: folds 
Hero: raises $7.50 to $12.50
Small Blind: raises $35.00 to $47.50
Big Blind: folds 
Hero: calls $35
*** FLOP *** [7s 6s Jc]
Small Blind: bets $43.50
Hero: calls $43.50
*** TURN *** [7s 6s Jc] [Ah]
Small Blind: checks 
Hero: checks 
*** RIVER *** [7s 6s Jc Ah] [Ac]
Small Blind: bets $55
Hero: calls $55
*** SHOW DOWN ***
Small Blind: shows [Jh 9s] (a hand...)
Big Blind: shows [3h 5s] (a hand...)
Hero: shows [Kc 6c] (a hand...)
UTG: shows [2c 3c] (a hand...)
UTG+1: shows [2d Ts] (a hand...)
Small Blind collected $294 from pot
*** SUMMARY ***
Total pot $297.00 | Rake $3.00
Board [7s 6s Jc Ah Ac]
Seat 1: UTG folded
Seat 2: UTG+1 folded
Seat 3: Hero showed [Kc 6c] and lost with...
Seat 4: Small Blind showed [Jh 9s] and won ($294)
Seat 5: Big Blind folded



PokerStars Hand #3946420631:  Hold'em No Limit ($2.50/$5) - 2020/05/18 14:23:47 ET
Table 'Zone Poker ID 1588' 9-max Seat #4 is the button
Seat 1: Hero ($500.00 in chips) 
Seat 2: UTG ($1143.81 in chips) 
Seat 3: UTG+1 ($500.00 in chips) 
Seat 4: Dealer ($1017.07 in chips) 
Seat 5: Small Blind ($518.19 in chips) 
Small Blind: posts small blind $2.50
Hero: posts big blind $5
*** HOLE CARDS ***
Dealt to Hero [6h Qc]
UTG: folds 
UTG+1: folds 
Dealer: folds 
Small Blind: raises $10.00 to $15
Hero: calls $10
*** FLOP *** [6d 2c Ah]
Small Blind: bets $21.38
Hero: calls $21.38
*** TURN *** [6d 2c Ah] [2d]
Small Blind: bets $26
Hero: calls $26
*** RIVER *** [6d 2c Ah 2d] [Kd]
Small Blind: bets $91.32
Hero: folds 
*** SHOW DOWN ***
Small Blind: shows [9d Tc] (a hand...)
Hero: shows [6h Qc] (a hand...)
Dealer: shows [4d Th] (a hand...)
UTG: shows [8h 6c] (a hand...)
UTG+1: shows [3c Td] (a hand...)
Uncalled bet ($91.32) returned to Small Blind
Small Blind collected $121.76 from pot
*** SUMMARY ***
Total pot $124.76 | Rake $3.00
Board [6d 2c Ah 2d Kd]
Seat 1: Hero folded
Seat 2: UTG folded
Seat 3: UTG+1 folded
Seat 4: Dealer folded
Seat 5: Small Blind collected ($121.76)



PokerStars Hand #3946420339:  Hold'em No Limit ($2.50/$5) - 2020/05/18 14:23:02 ET
Table 'Zone Poker ID 1588' 9-max Seat #3 is the button
Seat 1: Big Blind ($500.00 in chips) 
Seat 2: UTG ($515.00 in chips) 
Seat 3: Hero ($495.00 in chips) 
Seat 4: Small Blind ($558.24 in chips) 
Small Blind: posts small blind $2.50
Big Blind: posts big blind $5
*** HOLE CARDS ***
Dealt to Hero [5c 4c]
UTG: folds 
Hero: raises $7.50 to $12.50
Small Blind: folds 
Big Blind: calls $7.50
*** FLOP *** [Ts Qd 3c]
Big Blind: checks 
Hero: bets $7.84
Big Blind: calls $7.84
*** TURN *** [Ts Qd 3c] [Jh]
Big Blind: checks 
Hero: checks 
*** RIVER *** [Ts Qd 3c Jh] [Th]
Big Blind: bets $30.77
Hero: folds 
*** SHOW DOWN ***
Small Blind: shows [9c 2h] (a hand...)
UTG: shows [8d Kh] (a hand...)
Big Blind: shows [Js Td] (a hand...)
Hero: shows [5c 4c] (a hand...)
Uncalled bet ($30.77) returned to Big Blind
Big Blind collected $41.03 from pot
*** SUMMARY ***
Total pot $43.18 | Rake $2.15
Board [Ts Qd 3c Jh Th]
Seat 1: Big Blind collected ($41.03)
Seat 2: UTG folded
Seat 3: Hero folded
Seat 4: Small Blind folded



PokerStars Hand #3946367974:  Hold'em No Limit ($2.50/$5) - 2020/05/18 11:46:57 ET
Table 'Zone Poker ID 1588' 9-max Seat #1 is the button
Seat 1: Dealer ($469.91 in chips) 
Seat 2: Small Blind ($666.25 in chips) 
Seat 3: Hero ($502.50 in chips) 
Small Blind: posts small blind $2.50
Hero: posts big blind $5
*** HOLE CARDS ***
Dealt to Hero [Tc Ah]
Dealer: raises $7.50 to $12.50
Small Blind: folds 
Hero: calls $7.50
*** FLOP *** [Qd 5s Th]
Hero: checks 
Dealer: bets $8.07
Hero: calls $8.07
*** TURN *** [Qd 5s Th] [2h]
Hero: checks 
Dealer: bets $31.64
Hero: calls $31.64
*** RIVER *** [Qd 5s Th 2h] [5c]
Hero: checks 
Dealer: bets $83.69
Hero: folds 
*** SHOW DOWN ***
Small Blind: shows [8s 9d] (a hand...)
Dealer: shows [Qs Td] (a hand...)
Hero: shows [Tc Ah] (a hand...)
Uncalled bet ($83.69) returned to Dealer
Dealer collected $104.92 from pot
*** SUMMARY ***
Total pot $106.92 | Rake $2.00
Board [Qd 5s Th 2h 5c]
Seat 1: Dealer collected ($104.92)
Seat 2: Small Blind folded
Seat 3: Hero folded



PokerStars Hand #3944951522:  Hold'em No Limit ($2.50/$5) - 2020/05/16 01:52:30 ET
Table 'Zone Poker ID 1588' 9-max Seat #1 is the button
Seat 1: Dealer ($227.50 in chips) 
Seat 2: Small Blind ($475.00 in chips) 
Seat 3: Big Blind ($187.19 in chips) 
Seat 4: UTG ($567.88 in chips) 
Seat 5: UTG+1 ($481.58 in chips) 
Seat 6: Hero ($797.00 in chips) 
Small Blind: posts small blind $2.50
Big Blind: posts big blind $5
*** HOLE CARDS ***
Dealt to Hero [Jd Jh]
UTG: folds 
UTG+1: folds 
Hero: raises $7.50 to $12.50
Dealer: folds 
Small Blind: folds 
Big Blind: calls $7.50
*** FLOP *** [8s 7d 5d]
Big Blind: checks 
Hero: bets $20
Big Blind: calls $20
*** TURN *** [8s 7d 5d] [9s]
Big Blind: checks 
Hero: checks 
*** RIVER *** [8s 7d 5d 9s] [9c]
Big Blind: bets $48.10
Hero: calls $48.10
*** SHOW DOWN ***
Small Blind: shows [Kh 4c] (a hand...)
Big Blind: shows [7c Ad] (a hand...)
Hero: shows [Jd Jh] (a hand...)
Dealer: shows [3d 7s] (a hand...)
UTG: shows [6s 2c] (a hand...)
UTG+1: shows [5c 2h] (a hand...)
Hero collected $159.70 from pot
*** SUMMARY ***
Total pot $163.70 | Rake $4.00
Board [8s 7d 5d 9s 9c]
Seat 1: Dealer folded
Seat 2: Small Blind folded
Seat 3: Big Blind showed [7c Ad] and lost with...
Seat 4: UTG folded
Seat 5: UTG+1 folded
Seat 6: Hero showed [Jd Jh] and won ($159.70)



PokerStars Hand #3944950474:  Hold'em No Limit ($2.50/$5) - 2020/05/16 01:50:48 ET
Table 'Zone Poker ID 1588' 9-max Seat #1 is the button
Seat 1: Dealer ($492.50 in chips) 
Seat 2: Small Blind ($305.22 in chips) 
Seat 3: Big Blind ($453.70 in chips) 
Seat 4: UTG ($647.50 in chips) 
Seat 5: Hero ($563.50 in chips) 
Seat 6: UTG+2 ($526.63 in chips) 
Small Blind: posts small blind $2.50
Big Blind: posts big blind $5
*** HOLE CARDS ***
Dealt to Hero [8h 8c]
UTG: folds 
Hero: raises $7.50 to $12.50
UTG+2: folds 
Dealer: folds 
Small Blind: folds 
Big Blind: calls $7.50
*** FLOP *** [2d Ks Td]
Big Blind: checks 
Hero: bets $7.84
Big Blind: calls $7.84
*** TURN *** [2d Ks Td] [Kd]
Big Blind: checks 
Hero: checks 
*** RIVER *** [2d Ks Td Kd] [2h]
Big Blind: bets $68.98
Hero: folds 
*** SHOW DOWN ***
Small Blind: shows [2s Jd] (a hand...)
Big Blind: shows [Qh Ad] (a hand...)
Hero: shows [8h 8c] (a hand...)
Dealer: shows [8d 7c] (a hand...)
UTG+2: shows [5c Ah] (a hand...)
UTG: shows [8s 9c] (a hand...)
Uncalled bet ($68.98) returned to Big Blind
Big Blind collected $41.03 from pot
*** SUMMARY ***
Total pot $43.18 | Rake $2.15
Board [2d Ks Td Kd 2h]
Seat 1: Dealer folded
Seat 2: Small Blind folded
Seat 3: Big Blind collected ($41.03)
Seat 4: UTG folded
Seat 5: Hero folded
Seat 6: UTG+2 folded



PokerStars Hand #3944949152:  Hold'em No Limit ($2.50/$5) - 2020/05/16 01:48:40 ET
Table 'Zone Poker ID 1588' 9-max Seat #5 is the button
Seat 1: Big Blind ($507.50 in chips) 
Seat 2: UTG ($943.22 in chips) 
Seat 3: Hero ($500.00 in chips) 
Seat 4: UTG+2 ($500.00 in chips) 
Seat 5: Dealer ($849.67 in chips) 
Seat 6: Small Blind ($1616.76 in chips) 
Small Blind: posts small blind $2.50
Big Blind: posts big blind $5
*** HOLE CARDS ***
Dealt to Hero [Ks Kc]
UTG: folds 
Hero: raises $7.50 to $12.50
UTG+2: folds 
Dealer: folds 
Small Blind: folds 
Big Blind: calls $7.50
*** FLOP *** [As 4c 2d]
Big Blind: checks 
Hero: checks 
*** TURN *** [As 4c 2d] [6c]
Big Blind: bets $40
Hero: calls $40
*** RIVER *** [As 4c 2d 6c] [3d]
Big Blind: bets $125
Hero: folds 
*** SHOW DOWN ***
Small Blind: shows [6s Td] (a hand...)
Big Blind: shows [2h 2s] (a hand...)
Hero: shows [Ks Kc] (a hand...)
Dealer: shows [8d Jh] (a hand...)
UTG+2: shows [3c 4s] (a hand...)
UTG: shows [6h Ac] (a hand...)
Uncalled bet ($125.00) returned to Big Blind
Big Blind collected $103.50 from pot
*** SUMMARY ***
Total pot $107.50 | Rake $4.00
Board [As 4c 2d 6c 3d]
Seat 1: Big Blind collected ($103.50)
Seat 2: UTG folded
Seat 3: Hero folded
Seat 4: UTG+2 folded
Seat 5: Dealer folded
Seat 6: Small Blind folded



PokerStars Hand #3944546846:  Hold'em No Limit ($2.50/$5) - 2020/05/15 15:02:22 ET
Table 'Zone Poker ID 1588' 9-max Seat #1 is the button
Seat 1: Hero ($1320.18 in chips) 
Seat 2: Small Blind ($595.69 in chips) 
Seat 3: Big Blind ($510.84 in chips) 
Small Blind: posts small blind $2.50
Big Blind: posts big blind $5
*** HOLE CARDS ***
Dealt to Hero [Jh 8d]
Hero: raises $7.50 to $12.50
Small Blind: folds 
Big Blind: calls $7.50
*** FLOP *** [2d Jc 6h]
Big Blind: checks 
Hero: bets $7.84
Big Blind: calls $7.84
*** TURN *** [2d Jc 6h] [5s]
Big Blind: checks 
Hero: bets $25.67
Big Blind: calls $25.67
*** RIVER *** [2d Jc 6h 5s] [6c]
Big Blind: bets $92.52
Hero: folds 
*** SHOW DOWN ***
Small Blind: shows [2c 8s] (a hand...)
Big Blind: shows [9c 7s] (a hand...)
Hero: shows [Jh 8d] (a hand...)
Uncalled bet ($92.52) returned to Big Blind
Big Blind collected $92.52 from pot
*** SUMMARY ***
Total pot $94.52 | Rake $2.00
Board [2d Jc 6h 5s 6c]
Seat 1: Hero folded
Seat 2: Small Blind folded
Seat 3: Big Blind collected ($92.52)



PokerStars Hand #3944544288:  Hold'em No Limit ($2.50/$5) - 2020/05/15 14:56:53 ET
Table 'Zone Poker ID 1588' 9-max Seat #3 is the button
Seat 1: Big Blind ($489.31 in chips) 
Seat 2: UTG ($1345.12 in chips) 
Seat 3: Dealer ($521.31 in chips) 
Seat 4: Hero ($1207.20 in chips) 
Hero: posts small blind $2.50
Big Blind: posts big blind $5
*** HOLE CARDS ***
Dealt to Hero [6h 5h]
UTG: folds 
Dealer: folds 
Hero: raises $10.00 to $15
Big Blind: calls $10
*** FLOP *** [Ts 9d Jc]
Hero: bets $8.55
Big Blind: calls $8.55
*** TURN *** [Ts 9d Jc] [6c]
Hero: checks 
Big Blind: checks 
*** RIVER *** [Ts 9d Jc 6c] [4s]
Hero: checks 
Big Blind: bets $44.75
Hero: folds 
*** SHOW DOWN ***
UTG: shows [8h 2c] (a hand...)
Dealer: shows [Qh 5c] (a hand...)
Big Blind: shows [Jh Qc] (a hand...)
Hero: shows [6h 5h] (a hand...)
Uncalled bet ($44.75) returned to Big Blind
Big Blind collected $44.75 from pot
*** SUMMARY ***
Total pot $47.10 | Rake $2.35
Board [Ts 9d Jc 6c 4s]
Seat 1: Big Blind collected ($44.75)
Seat 2: UTG folded
Seat 3: Dealer folded
Seat 4: Hero folded



PokerStars Hand #3943922259:  Hold'em No Limit ($2.50/$5) - 2020/05/14 15:43:05 ET
Table 'Zone Poker ID 1588' 9-max Seat #2 is the button
Seat 1: Hero ($685.32 in chips) 
Seat 2: Dealer ($810.36 in chips) 
Seat 3: Small Blind ($200.68 in chips) 
Small Blind: posts small blind $2.50
Hero: posts big blind $5
*** HOLE CARDS ***
Dealt to Hero [4h Jh]
Dealer: raises $7.50 to $12.50
Small Blind: folds 
Hero: calls $7.50
*** FLOP *** [Jd 5d Ks]
Hero: checks 
Dealer: checks 
*** TURN *** [Jd 5d Ks] [2c]
Hero: checks 
Dealer: bets $10.19
Hero: calls $10.19
*** RIVER *** [Jd 5d Ks 2c] [9s]
Hero: checks 
Dealer: bets $15.30
Hero: folds 
*** SHOW DOWN ***
Small Blind: shows [7h 9c] (a hand...)
Dealer: shows [Js As] (a hand...)
Hero: shows [4h Jh] (a hand...)
Uncalled bet ($15.30) returned to Dealer
Dealer collected $45.88 from pot
*** SUMMARY ***
Total pot $47.88 | Rake $2.00
Board [Jd 5d Ks 2c 9s]
Seat 1: Hero folded
Seat 2: Dealer collected ($45.88)
Seat 3: Small Blind folded



PokerStars Hand #3943920701:  Hold'em No Limit ($2.50/$5) - 2020/05/14 15:39:56 ET
Table 'Zone Poker ID 1588' 9-max Seat #2 is the button
Seat 1: Big Blind ($1130.02 in chips) 
Seat 2: Hero ($506.55 in chips) 
Seat 3: Small Blind ($176.25 in chips) 
Small Blind: posts small blind $2.50
Big Blind: posts big blind $5
*** HOLE CARDS ***
Dealt to Hero [Kh Qs]
Hero: raises $7.50 to $12.50
Small Blind: folds 
Big Blind: raises $37.50 to $50
Hero: calls $37.50
*** FLOP *** [4d As 3d]
Big Blind: checks 
Hero: checks 
*** TURN *** [4d As 3d] [5c]
Big Blind: checks 
Hero: checks 
*** RIVER *** [4d As 3d 5c] [Td]
Big Blind: bets $36.49
Hero: folds 
*** SHOW DOWN ***
Small Blind: shows [5s 6d] (a hand...)
Big Blind: shows [Jc Jh] (a hand...)
Hero: shows [Kh Qs] (a hand...)
Uncalled bet ($36.49) returned to Big Blind
Big Blind collected $100.50 from pot
*** SUMMARY ***
Total pot $102.50 | Rake $2.00
Board [4d As 3d 5c Td]
Seat 1: Big Blind collected ($100.50)
Seat 2: Hero folded
Seat 3: Small Blind folded



PokerStars Hand #3943920308:  Hold'em No Limit ($2.50/$5) - 2020/05/14 15:39:07 ET
Table 'Zone Poker ID 1588' 9-max Seat #2 is the button
Seat 1: Hero ($658.13 in chips) 
Seat 2: Dealer ($392.15 in chips) 
Seat 3: Small Blind ($622.77 in chips) 
Small Blind: posts small blind $2.50
Hero: posts big blind $5
*** HOLE CARDS ***
Dealt to Hero [Jd Ts]
Dealer: raises $10 to $15
Small Blind: folds 
Hero: calls $10
*** FLOP *** [As Js 8d]
Hero: checks 
Dealer: bets $15.44
Hero: calls $15.44
*** TURN *** [As Js 8d] [7h]
Hero: checks 
Dealer: checks 
*** RIVER *** [As Js 8d 7h] [Ks]
Hero: checks 
Dealer: bets $30.69
Hero: folds 
*** SHOW DOWN ***
Small Blind: shows [4h 6s] (a hand...)
Dealer: shows [5s 3s] (a hand...)
Hero: shows [Jd Ts] (a hand...)
Uncalled bet ($30.69) returned to Dealer
Dealer collected $61.38 from pot
*** SUMMARY ***
Total pot $63.38 | Rake $2.00
Board [As Js 8d 7h Ks]
Seat 1: Hero folded
Seat 2: Dealer collected ($61.38)
Seat 3: Small Blind folded



PokerStars Hand #3943919733:  Hold'em No Limit ($2.50/$5) - 2020/05/14 15:37:58 ET
Table 'Zone Poker ID 1588' 9-max Seat #2 is the button
Seat 1: Big Blind ($647.59 in chips) 
Seat 2: Hero ($510.13 in chips) 
Seat 3: Small Blind ($762.77 in chips) 
Small Blind: posts small blind $2.50
Big Blind: posts big blind $5
*** HOLE CARDS ***
Dealt to Hero [Qd Tc]
Hero: raises $7.50 to $12.50
Small Blind: calls $10
Big Blind: calls $7.50
*** FLOP *** [5c 9d Qs]
Small Blind: checks 
Big Blind: checks 
Hero: bets $20
Small Blind: calls $20
Big Blind: folds 
*** TURN *** [5c 9d Qs] [9c]
Small Blind: checks 
Hero: checks 
*** RIVER *** [5c 9d Qs 9c] [3c]
Small Blind: checks 
Hero: bets $25
Small Blind: raises $80 to $105
Hero: calls $80
*** SHOW DOWN ***
Small Blind: shows [5d 8d] (a hand...)
Big Blind: shows [Ah Jd] (a hand...)
Hero: shows [Qd Tc] (a hand...)
Hero collected $285.50 from pot
*** SUMMARY ***
Total pot $287.50 | Rake $2.00
Board [5c 9d Qs 9c 3c]
Seat 1: Big Blind folded
Seat 2: Hero showed [Qd Tc] and won ($285.50)
Seat 3: Small Blind showed [5d 8d] and lost with...



PokerStars Hand #3943915730:  Hold'em No Limit ($2.50/$5) - 2020/05/14 15:29:26 ET
Table 'Zone Poker ID 1588' 9-max Seat #2 is the button
Seat 1: Big Blind ($403.88 in chips) 
Seat 2: Hero ($490.00 in chips) 
Seat 3: Small Blind ($970.44 in chips) 
Small Blind: posts small blind $2.50
Big Blind: posts big blind $5
*** HOLE CARDS ***
Dealt to Hero [Jd Qd]
Hero: raises $7.50 to $12.50
Small Blind: raises $37.50 to $50
Big Blind: folds 
Hero: calls $37.50
*** FLOP *** [3s 3d 5d]
Small Blind: bets $40
Hero: calls $40
*** TURN *** [3s 3d 5d] [Ks]
Small Blind: bets $91.50
Hero: calls $91.50
*** RIVER *** [3s 3d 5d Ks] [2c]
Small Blind: bets $366
Hero: folds 
*** SHOW DOWN ***
Small Blind: shows [Jc Kc] (a hand...)
Big Blind: shows [9s Ac] (a hand...)
Hero: shows [Jd Qd] (a hand...)
Uncalled bet ($366.00) returned to Small Blind
Small Blind collected $366 from pot
*** SUMMARY ***
Total pot $368.00 | Rake $2.00
Board [3s 3d 5d Ks 2c]
Seat 1: Big Blind folded
Seat 2: Hero folded
Seat 3: Small Blind collected ($366)



PokerStars Hand #3943912831:  Hold'em No Limit ($2.50/$5) - 2020/05/14 15:23:14 ET
Table 'Zone Poker ID 1588' 9-max Seat #3 is the button
Seat 1: Small Blind ($1476.16 in chips) 
Seat 2: Hero ($505.00 in chips) 
Seat 3: Dealer ($500.82 in chips) 
Small Blind: posts small blind $2.50
Hero: posts big blind $5
*** HOLE CARDS ***
Dealt to Hero [Ks 3s]
Dealer: folds 
Small Blind: raises $7.50 to $12.50
Hero: calls $7.50
*** FLOP *** [Qs Qc 7s]
Small Blind: checks 
Hero: bets $8
Small Blind: raises $19.88 to $27.88
Hero: calls $19.88
*** TURN *** [Qs Qc 7s] [8c]
Small Blind: bets $50
Hero: calls $50
*** RIVER *** [Qs Qc 7s 8c] [Ac]
Small Blind: bets $55
Hero: folds 
*** SHOW DOWN ***
Small Blind: shows [Ad Qh] (a hand...)
Dealer: shows [2c 6c] (a hand...)
Hero: shows [Ks 3s] (a hand...)
Uncalled bet ($55.00) returned to Small Blind
Small Blind collected $178.76 from pot
*** SUMMARY ***
Total pot $180.76 | Rake $2.00
Board [Qs Qc 7s 8c Ac]
Seat 1: Small Blind collected ($178.76)
Seat 2: Hero folded
Seat 3: Dealer folded



PokerStars Hand #3943911840:  Hold'em No Limit ($2.50/$5) - 2020/05/14 15:21:02 ET
Table 'Zone Poker ID 1588' 9-max Seat #3 is the button
Seat 1: Big Blind ($506.55 in chips) 
Seat 2: UTG ($500.00 in chips) 
Seat 3: Dealer ($557.93 in chips) 
Seat 4: Hero ($536.14 in chips) 
Hero: posts small blind $2.50
Big Blind: posts big blind $5
*** HOLE CARDS ***
Dealt to Hero [7s 6s]
UTG: raises $5 to $10
Dealer: folds 
Hero: raises $35.00 to $45
Big Blind: folds 
UTG: raises $60 to $105
Hero: calls $60
*** FLOP *** [Ts Ks 4s]
Hero: checks 
UTG: checks 
*** TURN *** [Ts Ks 4s] [Jc]
Hero: checks 
UTG: checks 
*** RIVER *** [Ts Ks 4s Jc] [8s]
Hero: checks 
UTG: bets $53
Hero: calls $53
*** SHOW DOWN ***
UTG: shows [Qd Qs] (a hand...)
Dealer: shows [Ah 6c] (a hand...)
Big Blind: shows [2c 9s] (a hand...)
Hero: shows [7s 6s] (a hand...)
UTG collected $318 from pot
*** SUMMARY ***
Total pot $321.00 | Rake $3.00
Board [Ts Ks 4s Jc 8s]
Seat 1: Big Blind folded
Seat 2: UTG showed [Qd Qs] and won ($318)
Seat 3: Dealer folded
Seat 4: Hero showed [7s 6s] and lost with...



PokerStars Hand #3943910648:  Hold'em No Limit ($2.50/$5) - 2020/05/14 15:18:27 ET
Table 'Zone Poker ID 1588' 9-max Seat #1 is the button
Seat 1: Dealer ($582.99 in chips) 
Seat 2: Small Blind ($551.87 in chips) 
Seat 3: Hero ($528.89 in chips) 
Seat 4: UTG ($502.50 in chips) 
Seat 5: UTG+1 ($490.00 in chips) 
Small Blind: posts small blind $2.50
Hero: posts big blind $5
*** HOLE CARDS ***
Dealt to Hero [3h Ad]
UTG: folds 
UTG+1: folds 
Dealer: raises $7.50 to $12.50
Small Blind: folds 
Hero: calls $7.50
*** FLOP *** [Ah Jd 5h]
Hero: checks 
Dealer: checks 
*** TURN *** [Ah Jd 5h] [Kc]
Hero: checks 
Dealer: bets $9
Hero: calls $9
*** RIVER *** [Ah Jd 5h Kc] [9s]
Hero: checks 
Dealer: bets $21.62
Hero: calls $21.62
*** SHOW DOWN ***
Small Blind: shows [6c 4s] (a hand...)
Hero: shows [3h Ad] (a hand...)
Dealer: shows [8d As] (a hand...)
UTG: shows [Jc 9h] (a hand...)
UTG+1: shows [8h Qs] (a hand...)
Dealer collected $42.87 from pot
Hero collected $42.87 from pot
*** SUMMARY ***
Total pot $88.74 | Rake $3.00
Board [Ah Jd 5h Kc 9s]
Seat 1: Dealer showed [8d As] and won ($42.87)
Seat 2: Small Blind folded
Seat 3: Hero showed [3h Ad] and won ($42.87)
Seat 4: UTG folded
Seat 5: UTG+1 folded



