PokerStars Hand #3965953223:  Hold'em No Limit ($2.50/$5) - 2020/06/25 15:18:27 ET
Table '21911818' 9-max Seat #4 is the button
Seat 1: UTG ($492.50 in chips) 
Seat 2: UTG+1 ($789.14 in chips) 
Seat 3: UTG+2 ($701.95 in chips) 
Seat 4: Hero ($671.88 in chips) 
Seat 5: Small Blind ($1237.49 in chips) 
Seat 6: Big Blind ($585.91 in chips) 
Small Blind: posts small blind $2.50
Big Blind: posts big blind $5
*** HOLE CARDS ***
Dealt to Hero [Ah Qc]
UTG: folds 
UTG+1: folds 
UTG+2: folds 
Hero: raises $7.50 to $12.50
Small Blind: folds 
Big Blind: calls $7.50
*** FLOP *** [3s 2h 5c]
Big Blind: checks 
Hero: checks 
*** TURN *** [3s 2h 5c] [6c]
Big Blind: bets $20
Hero: calls $20
*** RIVER *** [3s 2h 5c 6c] [9h]
Big Blind: bets $84.13
Hero: folds 
*** SHOW DOWN ***
Small Blind: shows [Th 7s] (a hand...)
Big Blind: shows [4s 4h] (a hand...)
Hero: shows [Ah Qc] (a hand...)
UTG+2: shows [2c 3d] (a hand...)
UTG: shows [9c 6d] (a hand...)
UTG+1: shows [7d 5d] (a hand...)
Uncalled bet ($84.13) returned to Big Blind
Big Blind collected $64.13 from pot
*** SUMMARY ***
Total pot $67.50 | Rake $3.37
Board [3s 2h 5c 6c 9h]
Seat 1: UTG folded
Seat 2: UTG+1 folded
Seat 3: UTG+2 folded
Seat 4: Hero folded
Seat 5: Small Blind folded
Seat 6: Big Blind collected ($64.13)



PokerStars Hand #3965951603:  Hold'em No Limit ($2.50/$5) - 2020/06/25 15:13:38 ET
Table '21913629' 9-max Seat #2 is the button
Seat 1: UTG ($659.70 in chips) 
Seat 2: Hero ($748.96 in chips) 
Seat 3: Small Blind ($468.00 in chips) 
Seat 4: Big Blind ($633.50 in chips) 
Small Blind: posts small blind $2.50
Big Blind: posts big blind $5
*** HOLE CARDS ***
Dealt to Hero [As 8s]
UTG: folds 
Hero: raises $7.50 to $12.50
Small Blind: folds 
Big Blind: calls $7.50
*** FLOP *** [Ah 5d Qs]
Big Blind: checks 
Hero: bets $7.84
Big Blind: calls $7.84
*** TURN *** [Ah 5d Qs] [Qh]
Big Blind: checks 
Hero: checks 
*** RIVER *** [Ah 5d Qs Qh] [Qd]
Big Blind: checks 
Hero: bets $30.77
Big Blind: raises $46.88 to $77.65
Hero: calls $46.88
*** SHOW DOWN ***
Small Blind: shows [9c Jh] (a hand...)
UTG: shows [7d 6c] (a hand...)
Big Blind: shows [Ac 5s] (a hand...)
Hero: shows [As 8s] (a hand...)
Hero collected $97.74 from pot
Big Blind collected $97.74 from pot
*** SUMMARY ***
Total pot $198.48 | Rake $3.00
Board [Ah 5d Qs Qh Qd]
Seat 1: UTG folded
Seat 2: Hero showed [As 8s] and won ($97.74)
Seat 3: Small Blind folded
Seat 4: Big Blind showed [Ac 5s] and won ($97.74)



PokerStars Hand #3965948420:  Hold'em No Limit ($2.50/$5) - 2020/06/25 15:04:30 ET
Table '21913595' 9-max Seat #6 is the button
Seat 1: Small Blind ($530.41 in chips) 
Seat 2: Hero ($1004.10 in chips) 
Seat 3: UTG ($943.29 in chips) 
Seat 4: UTG+1 ($500.00 in chips) 
Seat 5: UTG+2 ($287.88 in chips) 
Seat 6: Dealer ($523.64 in chips) 
Small Blind: posts small blind $2.50
Hero: posts big blind $5
*** HOLE CARDS ***
Dealt to Hero [Ad Qc]
UTG: folds 
UTG+1: folds 
UTG+2: folds 
Dealer: raises $6.50 to $11.50
Small Blind: folds 
Hero: raises $43.50 to $55
Dealer: calls $43.50
*** FLOP *** [Td Ks 4h]
Hero: bets $54.25
Dealer: calls $54.25
*** TURN *** [Td Ks 4h] [Ah]
Hero: checks 
Dealer: bets $80.10
Hero: calls $80.10
*** RIVER *** [Td Ks 4h Ah] [9c]
Hero: checks 
Dealer: bets $334.29 and is all-in
Hero: calls $334.29
*** SHOW DOWN ***
Small Blind: shows [4c 5s] (a hand...)
Hero: shows [Ad Qc] (a hand...)
UTG+2: shows [7c Qs] (a hand...)
Dealer: shows [Ts Th] (a hand...)
UTG: shows [8d 5c] (a hand...)
UTG+1: shows [9h 2c] (a hand...)
Dealer collected $1045.78 from pot
*** SUMMARY ***
Total pot $1049.78 | Rake $4.00
Board [Td Ks 4h Ah 9c]
Seat 1: Small Blind folded
Seat 2: Hero showed [Ad Qc] and lost with...
Seat 3: UTG folded
Seat 4: UTG+1 folded
Seat 5: UTG+2 folded
Seat 6: Dealer showed [Ts Th] and won ($1045.78)



PokerStars Hand #3965941155:  Hold'em No Limit ($2.50/$5) - 2020/06/25 14:43:22 ET
Table '21913629' 9-max Seat #6 is the button
Seat 1: Small Blind ($532.71 in chips) 
Seat 2: Hero ($487.50 in chips) 
Seat 3: UTG ($513.35 in chips) 
Seat 4: UTG+1 ($500.00 in chips) 
Seat 5: UTG+2 ($603.20 in chips) 
Seat 6: Dealer ($499.25 in chips) 
Small Blind: posts small blind $2.50
Hero: posts big blind $5
*** HOLE CARDS ***
Dealt to Hero [Td Qc]
UTG: calls $5
UTG+1: folds 
UTG+2: folds 
Dealer: folds 
Small Blind: folds 
Hero: checks 
*** FLOP *** [8s Qh 3h]
Hero: checks 
UTG: bets $15
Hero: calls $15
*** TURN *** [8s Qh 3h] [9c]
Hero: checks 
UTG: checks 
*** RIVER *** [8s Qh 3h 9c] [5s]
Hero: checks 
UTG: bets $60.38
Hero: calls $60.38
*** SHOW DOWN ***
Small Blind: shows [4c Ah] (a hand...)
Hero: shows [Td Qc] (a hand...)
UTG+2: shows [Qs 2c] (a hand...)
Dealer: shows [Kd 5d] (a hand...)
UTG: shows [Jc Kc] (a hand...)
UTG+1: shows [4h Ad] (a hand...)
Hero collected $159.26 from pot
*** SUMMARY ***
Total pot $163.26 | Rake $4.00
Board [8s Qh 3h 9c 5s]
Seat 1: Small Blind folded
Seat 2: Hero showed [Td Qc] and won ($159.26)
Seat 3: UTG showed [Jc Kc] and lost with...
Seat 4: UTG+1 folded
Seat 5: UTG+2 folded
Seat 6: Dealer folded



PokerStars Hand #3965939801:  Hold'em No Limit ($2.50/$5) - 2020/06/25 14:39:21 ET
Table '21907860' 9-max Seat #6 is the button
Seat 1: Small Blind ($562.00 in chips) 
Seat 2: Hero ($504.38 in chips) 
Seat 3: UTG ($611.85 in chips) 
Seat 4: UTG+1 ($500.00 in chips) 
Seat 5: UTG+2 ($403.50 in chips) 
Seat 6: Dealer ($290.72 in chips) 
Small Blind: posts small blind $2.50
Hero: posts big blind $5
*** HOLE CARDS ***
Dealt to Hero [Qh 9h]
UTG: raises $5 to $10
UTG+1: folds 
UTG+2: folds 
Dealer: calls $10
Small Blind: folds 
Hero: calls $5
*** FLOP *** [6s 8h 5d]
Hero: checks 
UTG: checks 
Dealer: checks 
*** TURN *** [6s 8h 5d] [7c]
Hero: bets $10
UTG: calls $10
Dealer: calls $10
*** RIVER *** [6s 8h 5d 7c] [8d]
Hero: checks 
UTG: bets $34.69
Dealer: calls $34.69
Hero: calls $34.69
*** SHOW DOWN ***
Small Blind: shows [8c Td] (a hand...)
Hero: shows [Qh 9h] (a hand...)
UTG+2: shows [Jh 2d] (a hand...)
Dealer: shows [4h 3h] (a hand...)
UTG: shows [9c Ac] (a hand...)
UTG+1: shows [2s Qs] (a hand...)
Hero collected $81.29 from pot
UTG collected $81.28 from pot
*** SUMMARY ***
Total pot $166.57 | Rake $4.00
Board [6s 8h 5d 7c 8d]
Seat 1: Small Blind folded
Seat 2: Hero showed [Qh 9h] and won ($81.29)
Seat 3: UTG showed [9c Ac] and won ($81.28)
Seat 4: UTG+1 folded
Seat 5: UTG+2 folded
Seat 6: Dealer showed [4h 3h] and lost with...



PokerStars Hand #3965939240:  Hold'em No Limit ($2.50/$5) - 2020/06/25 14:37:42 ET
Table '21913629' 9-max Seat #2 is the button
Seat 1: UTG+2 ($537.71 in chips) 
Seat 2: Hero ($492.51 in chips) 
Seat 3: Small Blind ($435.10 in chips) 
Seat 4: Big Blind ($483.38 in chips) 
Seat 5: UTG ($598.95 in chips) 
Seat 6: UTG+1 ($507.50 in chips) 
Small Blind: posts small blind $2.50
Big Blind: posts big blind $5
*** HOLE CARDS ***
Dealt to Hero [Tc 9h]
UTG: folds 
UTG+1: folds 
UTG+2: folds 
Hero: raises $7.50 to $12.50
Small Blind: calls $10
Big Blind: folds 
*** FLOP *** [7h Js Ts]
Small Blind: checks 
Hero: checks 
*** TURN *** [7h Js Ts] [2h]
Small Blind: bets $35
Hero: calls $35
*** RIVER *** [7h Js Ts 2h] [6d]
Small Blind: bets $96
Hero: folds 
*** SHOW DOWN ***
Small Blind: shows [6s 7s] (a hand...)
Big Blind: shows [2s 6h] (a hand...)
Hero: shows [Tc 9h] (a hand...)
UTG+2: shows [2d 3s] (a hand...)
UTG: shows [3d Th] (a hand...)
UTG+1: shows [7c 8d] (a hand...)
Uncalled bet ($96.00) returned to Small Blind
Small Blind collected $96 from pot
*** SUMMARY ***
Total pot $100.00 | Rake $4.00
Board [7h Js Ts 2h 6d]
Seat 1: UTG+2 folded
Seat 2: Hero folded
Seat 3: Small Blind collected ($96)
Seat 4: Big Blind folded
Seat 5: UTG folded
Seat 6: UTG+1 folded



PokerStars Hand #3965938680:  Hold'em No Limit ($2.50/$5) - 2020/06/25 14:35:57 ET
Table '21913595' 9-max Seat #2 is the button
Seat 1: UTG+2 ($514.50 in chips) 
Seat 2: Hero ($998.00 in chips) 
Seat 3: Small Blind ($887.61 in chips) 
Seat 4: Big Blind ($396.63 in chips) 
Seat 5: UTG ($436.29 in chips) 
Seat 6: UTG+1 ($500.00 in chips) 
Small Blind: posts small blind $2.50
Big Blind: posts big blind $5
*** HOLE CARDS ***
Dealt to Hero [3h 3s]
UTG: folds 
UTG+1: folds 
UTG+2: folds 
Hero: raises $7.50 to $12.50
Small Blind: folds 
Big Blind: calls $7.50
*** FLOP *** [6s 4d As]
Big Blind: checks 
Hero: bets $8.07
Big Blind: calls $8.07
*** TURN *** [6s 4d As] [Th]
Big Blind: checks 
Hero: checks 
*** RIVER *** [6s 4d As Th] [Jd]
Big Blind: bets $30
Hero: folds 
*** SHOW DOWN ***
Small Blind: shows [8h Ts] (a hand...)
Big Blind: shows [8d 7h] (a hand...)
Hero: shows [3h 3s] (a hand...)
UTG+2: shows [7s Kc] (a hand...)
UTG: shows [6c Qd] (a hand...)
UTG+1: shows [8s 2d] (a hand...)
Uncalled bet ($30.00) returned to Big Blind
Big Blind collected $41.46 from pot
*** SUMMARY ***
Total pot $43.64 | Rake $2.18
Board [6s 4d As Th Jd]
Seat 1: UTG+2 folded
Seat 2: Hero folded
Seat 3: Small Blind folded
Seat 4: Big Blind collected ($41.46)
Seat 5: UTG folded
Seat 6: UTG+1 folded



PokerStars Hand #3965935321:  Hold'em No Limit ($2.50/$5) - 2020/06/25 14:25:34 ET
Table '21913629' 9-max Seat #1 is the button
Seat 1: Dealer ($577.71 in chips) 
Seat 2: Hero ($549.13 in chips) 
Seat 3: Big Blind ($451.84 in chips) 
Seat 4: UTG ($500.00 in chips) 
Seat 5: UTG+1 ($492.50 in chips) 
Seat 6: UTG+2 ($891.25 in chips) 
Hero: posts small blind $2.50
Big Blind: posts big blind $5
*** HOLE CARDS ***
Dealt to Hero [Kd Kc]
UTG: folds 
UTG+1: folds 
UTG+2: folds 
Dealer: folds 
Hero: raises $10.00 to $15
Big Blind: calls $10
*** FLOP *** [3s 4d 2c]
Hero: checks 
Big Blind: bets $33
Hero: calls $33
*** TURN *** [3s 4d 2c] [5d]
Hero: checks 
Big Blind: checks 
*** RIVER *** [3s 4d 2c 5d] [Ac]
Hero: checks 
Big Blind: bets $200
Hero: folds 
*** SHOW DOWN ***
Big Blind: shows [Jc 6d] (a hand...)
Hero: shows [Kd Kc] (a hand...)
Dealer: shows [3c 9c] (a hand...)
UTG+2: shows [2d 5s] (a hand...)
UTG: shows [8d Kh] (a hand...)
UTG+1: shows [9h Qd] (a hand...)
Uncalled bet ($200.00) returned to Big Blind
Big Blind collected $92 from pot
*** SUMMARY ***
Total pot $96.00 | Rake $4.00
Board [3s 4d 2c 5d Ac]
Seat 1: Dealer folded
Seat 2: Hero folded
Seat 3: Big Blind collected ($92)
Seat 4: UTG folded
Seat 5: UTG+1 folded
Seat 6: UTG+2 folded



PokerStars Hand #3965932954:  Hold'em No Limit ($2.50/$5) - 2020/06/25 14:17:50 ET
Table '21907860' 9-max Seat #5 is the button
Seat 1: Small Blind ($1443.14 in chips) 
Seat 2: Hero ($539.26 in chips) 
Seat 3: UTG ($516.38 in chips) 
Seat 4: UTG+1 ($505.88 in chips) 
Seat 5: Dealer ($160.83 in chips) 
Small Blind: posts small blind $2.50
Hero: posts big blind $5
*** HOLE CARDS ***
Dealt to Hero [Kc Qh]
UTG: raises $7.50 to $12.50
UTG+1: folds 
Dealer: folds 
Small Blind: folds 
Hero: calls $7.50
*** FLOP *** [Qd 7h Td]
Hero: checks 
UTG: checks 
*** TURN *** [Qd 7h Td] [2d]
Hero: bets $20
UTG: raises $60 to $80
Hero: calls $60
*** RIVER *** [Qd 7h Td 2d] [8s]
Hero: checks 
UTG: bets $423.88 and is all-in
Hero: folds 
*** SHOW DOWN ***
Small Blind: shows [Ac 4h] (a hand...)
Hero: shows [Kc Qh] (a hand...)
Dealer: shows [5s Jc] (a hand...)
UTG: shows [Ad 7d] (a hand...)
UTG+1: shows [Js 6h] (a hand...)
Uncalled bet ($423.88) returned to UTG
UTG collected $184.50 from pot
*** SUMMARY ***
Total pot $187.50 | Rake $3.00
Board [Qd 7h Td 2d 8s]
Seat 1: Small Blind folded
Seat 2: Hero folded
Seat 3: UTG collected ($184.50)
Seat 4: UTG+1 folded
Seat 5: Dealer folded



PokerStars Hand #3965929734:  Hold'em No Limit ($2.50/$5) - 2020/06/25 14:07:18 ET
Table '21907860' 9-max Seat #5 is the button
Seat 1: Small Blind ($1456.87 in chips) 
Seat 2: Hero ($500.00 in chips) 
Seat 3: UTG ($500.00 in chips) 
Seat 4: UTG+1 ($500.00 in chips) 
Seat 5: Dealer ($492.50 in chips) 
Small Blind: posts small blind $2.50
Hero: posts big blind $5
*** HOLE CARDS ***
Dealt to Hero [5d 3d]
UTG: folds 
UTG+1: folds 
Dealer: raises $10 to $15
Small Blind: folds 
Hero: calls $10
*** FLOP *** [2s Qh Jh]
Hero: checks 
Dealer: checks 
*** TURN *** [2s Qh Jh] [2c]
Hero: checks 
Dealer: checks 
*** RIVER *** [2s Qh Jh 2c] [5h]
Hero: checks 
Dealer: bets $20
Hero: folds 
*** SHOW DOWN ***
Small Blind: shows [Ac 8h] (a hand...)
Hero: shows [5d 3d] (a hand...)
Dealer: shows [Js 8d] (a hand...)
UTG: shows [Ts 7s] (a hand...)
UTG+1: shows [6c Td] (a hand...)
Uncalled bet ($20) returned to Dealer
Dealer collected $30.88 from pot
*** SUMMARY ***
Total pot $32.50 | Rake $1.62
Board [2s Qh Jh 2c 5h]
Seat 1: Small Blind folded
Seat 2: Hero folded
Seat 3: UTG folded
Seat 4: UTG+1 folded
Seat 5: Dealer collected ($30.88)



PokerStars Hand #3965025663:  Hold'em No Limit ($2.50/$5) - 2020/06/23 14:41:56 ET
Table '21864300' 9-max Seat #4 is the button
Seat 1: Big Blind ($651.50 in chips) 
Seat 2: UTG ($742.62 in chips) 
Seat 3: UTG+1 ($836.23 in chips) 
Seat 4: Hero ($485.07 in chips) 
Seat 5: Small Blind ($614.07 in chips) 
Small Blind: posts small blind $2.50
Big Blind: posts big blind $5
*** HOLE CARDS ***
Dealt to Hero [Kc 3c]
UTG: folds 
UTG+1: folds 
Hero: raises $7.50 to $12.50
Small Blind: raises $17.50 to $30
Big Blind: folds 
Hero: calls $17.50
*** FLOP *** [Qc 7c Ts]
Small Blind: bets $46.50
Hero: calls $46.50
*** TURN *** [Qc 7c Ts] [3s]
Small Blind: bets $121.25
Hero: calls $121.25
*** RIVER *** [Qc 7c Ts 3s] [Th]
Small Blind: bets $416.32 and is all-in
Hero: folds 
*** SHOW DOWN ***
Small Blind: shows [8d 8h] (a hand...)
Big Blind: shows [9s Kh] (a hand...)
Hero: shows [Kc 3c] (a hand...)
UTG: shows [5s Ac] (a hand...)
UTG+1: shows [4c As] (a hand...)
Uncalled bet ($416.32) returned to Small Blind
Small Blind collected $397.50 from pot
*** SUMMARY ***
Total pot $400.50 | Rake $3.00
Board [Qc 7c Ts 3s Th]
Seat 1: Big Blind folded
Seat 2: UTG folded
Seat 3: UTG+1 folded
Seat 4: Hero folded
Seat 5: Small Blind collected ($397.50)



PokerStars Hand #3965025564:  Hold'em No Limit ($2.50/$5) - 2020/06/23 14:41:39 ET
Table '21862921' 9-max Seat #5 is the button
Seat 1: Small Blind ($500.88 in chips) 
Seat 2: Hero ($1111.50 in chips) 
Seat 3: UTG ($557.31 in chips) 
Seat 4: UTG+1 ($500.00 in chips) 
Seat 5: Dealer ($954.40 in chips) 
Small Blind: posts small blind $2.50
Hero: posts big blind $5
*** HOLE CARDS ***
Dealt to Hero [2c Ac]
UTG: folds 
UTG+1: raises $7.50 to $12.50
Dealer: calls $12.50
Small Blind: folds 
Hero: raises $55.00 to $67.50
UTG+1: calls $55
Dealer: folds 
*** FLOP *** [7h 4s Jd]
Hero: checks 
UTG+1: checks 
*** TURN *** [7h 4s Jd] [6d]
Hero: checks 
UTG+1: checks 
*** RIVER *** [7h 4s Jd 6d] [3h]
Hero: checks 
UTG+1: bets $49
Hero: folds 
*** SHOW DOWN ***
Small Blind: shows [3s 9d] (a hand...)
Hero: shows [2c Ac] (a hand...)
Dealer: shows [Qd Th] (a hand...)
UTG: shows [2h 5c] (a hand...)
UTG+1: shows [Ts Tc] (a hand...)
Uncalled bet ($49.00) returned to UTG+1
UTG+1 collected $147 from pot
*** SUMMARY ***
Total pot $150.00 | Rake $3.00
Board [7h 4s Jd 6d 3h]
Seat 1: Small Blind folded
Seat 2: Hero folded
Seat 3: UTG folded
Seat 4: UTG+1 collected ($147)
Seat 5: Dealer folded



PokerStars Hand #3965025282:  Hold'em No Limit ($2.50/$5) - 2020/06/23 14:40:49 ET
Table '21863855' 9-max Seat #6 is the button
Seat 1: Small Blind ($487.50 in chips) 
Seat 2: Big Blind ($1044.24 in chips) 
Seat 3: UTG ($523.63 in chips) 
Seat 4: UTG+1 ($486.13 in chips) 
Seat 5: Hero ($647.12 in chips) 
Seat 6: Dealer ($612.48 in chips) 
Small Blind: posts small blind $2.50
Big Blind: posts big blind $5
*** HOLE CARDS ***
Dealt to Hero [6c 6h]
UTG: folds 
UTG+1: folds 
Hero: raises $7.50 to $12.50
Dealer: folds 
Small Blind: folds 
Big Blind: calls $7.50
*** FLOP *** [Jc 7d 8h]
Big Blind: checks 
Hero: checks 
*** TURN *** [Jc 7d 8h] [5h]
Big Blind: bets $8.07
Hero: calls $8.07
*** RIVER *** [Jc 7d 8h 5h] [Qc]
Big Blind: bets $15.73
Hero: folds 
*** SHOW DOWN ***
Small Blind: shows [2s Kh] (a hand...)
Big Blind: shows [Qd Ts] (a hand...)
Hero: shows [6c 6h] (a hand...)
Dealer: shows [9d 2c] (a hand...)
UTG: shows [Qh 3h] (a hand...)
UTG+1: shows [Js 5d] (a hand...)
Uncalled bet ($15.73) returned to Big Blind
Big Blind collected $41.46 from pot
*** SUMMARY ***
Total pot $43.64 | Rake $2.18
Board [Jc 7d 8h 5h Qc]
Seat 1: Small Blind folded
Seat 2: Big Blind collected ($41.46)
Seat 3: UTG folded
Seat 4: UTG+1 folded
Seat 5: Hero folded
Seat 6: Dealer folded



PokerStars Hand #3965024448:  Hold'em No Limit ($2.50/$5) - 2020/06/23 14:38:19 ET
Table '21863855' 9-max Seat #4 is the button
Seat 1: UTG ($480.70 in chips) 
Seat 2: UTG+1 ($1044.24 in chips) 
Seat 3: UTG+2 ($523.63 in chips) 
Seat 4: Dealer ($472.50 in chips) 
Seat 5: Hero ($694.22 in chips) 
Seat 6: Big Blind ($571.88 in chips) 
Hero: posts small blind $2.50
Big Blind: posts big blind $5
*** HOLE CARDS ***
Dealt to Hero [Ad 7h]
UTG: folds 
UTG+1: folds 
UTG+2: folds 
Dealer: folds 
Hero: raises $10.00 to $15
Big Blind: calls $10
*** FLOP *** [Jd Td 9s]
Hero: checks 
Big Blind: bets $15
Hero: calls $15
*** TURN *** [Jd Td 9s] [Qc]
Hero: checks 
Big Blind: checks 
*** RIVER *** [Jd Td 9s Qc] [Ac]
Hero: bets $17.10
Big Blind: raises $47.10 to $64.20
Hero: folds 
*** SHOW DOWN ***
Big Blind: shows [3s Kc] (a hand...)
Hero: shows [Ad 7h] (a hand...)
Dealer: shows [3h Qs] (a hand...)
UTG+2: shows [7s 3d] (a hand...)
UTG: shows [Kh 5d] (a hand...)
UTG+1: shows [4c 6h] (a hand...)
Uncalled bet ($47.10) returned to Big Blind
Big Blind collected $90.20 from pot
*** SUMMARY ***
Total pot $94.20 | Rake $4.00
Board [Jd Td 9s Qc Ac]
Seat 1: UTG folded
Seat 2: UTG+1 folded
Seat 3: UTG+2 folded
Seat 4: Dealer folded
Seat 5: Hero folded
Seat 6: Big Blind collected ($90.20)



PokerStars Hand #3965020429:  Hold'em No Limit ($2.50/$5) - 2020/06/23 14:25:15 ET
Table '21863855' 9-max Seat #3 is the button
Seat 1: UTG ($1221.32 in chips) 
Seat 2: UTG+1 ($513.63 in chips) 
Seat 3: Dealer ($525.09 in chips) 
Seat 4: Hero ($542.50 in chips) 
Seat 5: Big Blind ($458.45 in chips) 
Hero: posts small blind $2.50
Big Blind: posts big blind $5
*** HOLE CARDS ***
Dealt to Hero [9s 9h]
UTG: folds 
UTG+1: folds 
Dealer: folds 
Hero: raises $10.00 to $15
Big Blind: calls $10
*** FLOP *** [4s 3h Qc]
Hero: bets $8.55
Big Blind: calls $8.55
*** TURN *** [4s 3h Qc] [5s]
Hero: checks 
Big Blind: checks 
*** RIVER *** [4s 3h Qc 5s] [3c]
Hero: bets $13.71
Big Blind: raises $52.17 to $65.88
Hero: calls $52.17
*** SHOW DOWN ***
Big Blind: shows [2h 6h] (a hand...)
Hero: shows [9s 9h] (a hand...)
Dealer: shows [5c Kh] (a hand...)
UTG: shows [Ad 9c] (a hand...)
UTG+1: shows [6s 3s] (a hand...)
Big Blind collected $175.86 from pot
*** SUMMARY ***
Total pot $178.86 | Rake $3.00
Board [4s 3h Qc 5s 3c]
Seat 1: UTG folded
Seat 2: UTG+1 folded
Seat 3: Dealer folded
Seat 4: Hero showed [9s 9h] and lost with...
Seat 5: Big Blind showed [2h 6h] and won ($175.86)



PokerStars Hand #3965016860:  Hold'em No Limit ($2.50/$5) - 2020/06/23 14:12:55 ET
Table '21863855' 9-max Seat #1 is the button
Seat 1: Dealer ($552.39 in chips) 
Seat 2: Small Blind ($954.20 in chips) 
Seat 3: Big Blind ($540.38 in chips) 
Seat 4: UTG ($529.26 in chips) 
Seat 5: Hero ($548.59 in chips) 
Seat 6: UTG+2 ($520.95 in chips) 
Small Blind: posts small blind $2.50
Big Blind: posts big blind $5
*** HOLE CARDS ***
Dealt to Hero [Qd Jh]
UTG: folds 
Hero: raises $7.50 to $12.50
UTG+2: folds 
Dealer: folds 
Small Blind: folds 
Big Blind: calls $7.50
*** FLOP *** [7c 8d 3s]
Big Blind: checks 
Hero: bets $20
Big Blind: calls $20
*** TURN *** [7c 8d 3s] [2h]
Big Blind: checks 
Hero: bets $48.10
Big Blind: calls $48.10
*** RIVER *** [7c 8d 3s 2h] [4d]
Big Blind: bets $114.78
Hero: folds 
*** SHOW DOWN ***
Small Blind: shows [5h 9s] (a hand...)
Big Blind: shows [4c 4s] (a hand...)
Hero: shows [Qd Jh] (a hand...)
Dealer: shows [Th Kc] (a hand...)
UTG+2: shows [2d 3c] (a hand...)
UTG: shows [Qc Jd] (a hand...)
Uncalled bet ($114.78) returned to Big Blind
Big Blind collected $159.70 from pot
*** SUMMARY ***
Total pot $163.70 | Rake $4.00
Board [7c 8d 3s 2h 4d]
Seat 1: Dealer folded
Seat 2: Small Blind folded
Seat 3: Big Blind collected ($159.70)
Seat 4: UTG folded
Seat 5: Hero folded
Seat 6: UTG+2 folded



PokerStars Hand #3965016455:  Hold'em No Limit ($2.50/$5) - 2020/06/23 14:11:28 ET
Table '21863354' 9-max Seat #6 is the button
Seat 1: Small Blind ($506.38 in chips) 
Seat 2: Hero ($547.78 in chips) 
Seat 3: UTG ($838.52 in chips) 
Seat 4: UTG+1 ($690.25 in chips) 
Seat 5: UTG+2 ($150.00 in chips) 
Seat 6: Dealer ($445.79 in chips) 
Small Blind: posts small blind $2.50
Hero: posts big blind $5
UTG+2: posts big blind $5
*** HOLE CARDS ***
Dealt to Hero [Qs Qc]
UTG: raises $10 to $15
UTG+1: folds 
UTG+2: folds 
Dealer: folds 
Small Blind: folds 
Hero: raises $52.50 to $67.50
UTG: calls $52.50
*** FLOP *** [3h Jd Kc]
Hero: bets $41.55
UTG: calls $41.55
*** TURN *** [3h Jd Kc] [Kh]
Hero: checks 
UTG: checks 
*** RIVER *** [3h Jd Kc Kh] [Jc]
Hero: checks 
UTG: bets $166.20
Hero: calls $166.20
*** SHOW DOWN ***
Small Blind: shows [7s Ks] (a hand...)
Hero: shows [Qs Qc] (a hand...)
UTG+2: shows [Js 3c] (a hand...)
Dealer: shows [7c Ad] (a hand...)
UTG: shows [Qd Kd] (a hand...)
UTG+1: shows [4h 3s] (a hand...)
UTG collected $554 from pot
*** SUMMARY ***
Total pot $558.00 | Rake $4.00
Board [3h Jd Kc Kh Jc]
Seat 1: Small Blind folded
Seat 2: Hero showed [Qs Qc] and lost with...
Seat 3: UTG showed [Qd Kd] and won ($554)
Seat 4: UTG+1 folded
Seat 5: UTG+2 folded
Seat 6: Dealer folded



PokerStars Hand #3965015630:  Hold'em No Limit ($2.50/$5) - 2020/06/23 14:08:46 ET
Table '21862921' 9-max Seat #6 is the button
Seat 1: Small Blind ($469.51 in chips) 
Seat 2: Hero ($554.72 in chips) 
Seat 3: UTG ($543.48 in chips) 
Seat 4: UTG+1 ($500.00 in chips) 
Seat 5: UTG+2 ($524.18 in chips) 
Seat 6: Dealer ($664.88 in chips) 
Small Blind: posts small blind $2.50
Hero: posts big blind $5
*** HOLE CARDS ***
Dealt to Hero [Th Ac]
UTG: raises $7.50 to $12.50
UTG+1: folds 
UTG+2: folds 
Dealer: folds 
Small Blind: folds 
Hero: calls $7.50
*** FLOP *** [Qd Qc 2h]
Hero: checks 
UTG: bets $8.71
Hero: calls $8.71
*** TURN *** [Qd Qc 2h] [As]
Hero: checks 
UTG: bets $32.01
Hero: calls $32.01
*** RIVER *** [Qd Qc 2h As] [Td]
Hero: checks 
UTG: bets $78.71
Hero: folds 
*** SHOW DOWN ***
Small Blind: shows [3s 8d] (a hand...)
Hero: shows [Th Ac] (a hand...)
UTG+2: shows [7h 3h] (a hand...)
Dealer: shows [6s 4s] (a hand...)
UTG: shows [Js Qs] (a hand...)
UTG+1: shows [5d 7d] (a hand...)
Uncalled bet ($78.71) returned to UTG
UTG collected $104.94 from pot
*** SUMMARY ***
Total pot $108.94 | Rake $4.00
Board [Qd Qc 2h As Td]
Seat 1: Small Blind folded
Seat 2: Hero folded
Seat 3: UTG collected ($104.94)
Seat 4: UTG+1 folded
Seat 5: UTG+2 folded
Seat 6: Dealer folded



PokerStars Hand #3965011044:  Hold'em No Limit ($2.50/$5) - 2020/06/23 13:53:57 ET
Table '21862921' 9-max Seat #6 is the button
Seat 1: Small Blind ($484.51 in chips) 
Seat 2: Hero ($566.46 in chips) 
Seat 3: UTG ($544.85 in chips) 
Seat 4: UTG+1 ($537.22 in chips) 
Seat 5: UTG+2 ($535.55 in chips) 
Seat 6: Dealer ($613.54 in chips) 
Small Blind: posts small blind $2.50
Hero: posts big blind $5
*** HOLE CARDS ***
Dealt to Hero [8d 8h]
UTG: folds 
UTG+1: folds 
UTG+2: raises $7.50 to $12.50
Dealer: calls $12.50
Small Blind: folds 
Hero: calls $7.50
*** FLOP *** [5d Qd 6d]
Hero: checks 
UTG+2: checks 
Dealer: bets $24
Hero: calls $24
UTG+2: folds 
*** TURN *** [5d Qd 6d] [7c]
Hero: checks 
Dealer: bets $57
Hero: calls $57
*** RIVER *** [5d Qd 6d 7c] [Qh]
Hero: checks 
Dealer: bets $131
Hero: folds 
*** SHOW DOWN ***
Small Blind: shows [4c 7s] (a hand...)
Hero: shows [8d 8h] (a hand...)
UTG+2: shows [3h 3d] (a hand...)
Dealer: shows [6s 6c] (a hand...)
UTG: shows [5c Jh] (a hand...)
UTG+1: shows [As 6h] (a hand...)
Uncalled bet ($131.00) returned to Dealer
Dealer collected $198 from pot
*** SUMMARY ***
Total pot $202.00 | Rake $4.00
Board [5d Qd 6d 7c Qh]
Seat 1: Small Blind folded
Seat 2: Hero folded
Seat 3: UTG folded
Seat 4: UTG+1 folded
Seat 5: UTG+2 folded
Seat 6: Dealer collected ($198)



PokerStars Hand #3965010044:  Hold'em No Limit ($2.50/$5) - 2020/06/23 13:50:45 ET
Table '21864300' 9-max Seat #6 is the button
Seat 1: Small Blind ($549.01 in chips) 
Seat 2: Big Blind ($521.13 in chips) 
Seat 3: UTG ($621.98 in chips) 
Seat 4: Hero ($500.00 in chips) 
Seat 5: UTG+2 ($434.03 in chips) 
Seat 6: Dealer ($491.13 in chips) 
Small Blind: posts small blind $2.50
Big Blind: posts big blind $5
*** HOLE CARDS ***
Dealt to Hero [Ah As]
UTG: folds 
Hero: raises $7.50 to $12.50
UTG+2: folds 
Dealer: folds 
Small Blind: folds 
Big Blind: calls $7.50
*** FLOP *** [3s 4h 7c]
Big Blind: checks 
Hero: checks 
*** TURN *** [3s 4h 7c] [Qc]
Big Blind: bets $41.13
Hero: calls $41.13
*** RIVER *** [3s 4h 7c Qc] [4s]
Big Blind: bets $165.76
Hero: calls $165.76
*** SHOW DOWN ***
Small Blind: shows [8s 3c] (a hand...)
Big Blind: shows [7d 7s] (a hand...)
Hero: shows [Ah As] (a hand...)
UTG+2: shows [5c Js] (a hand...)
Dealer: shows [Kd 9c] (a hand...)
UTG: shows [9s 2d] (a hand...)
Big Blind collected $437.28 from pot
*** SUMMARY ***
Total pot $441.28 | Rake $4.00
Board [3s 4h 7c Qc 4s]
Seat 1: Small Blind folded
Seat 2: Big Blind showed [7d 7s] and won ($437.28)
Seat 3: UTG folded
Seat 4: Hero showed [Ah As] and lost with...
Seat 5: UTG+2 folded
Seat 6: Dealer folded



PokerStars Hand #3965007671:  Hold'em No Limit ($2.50/$5) - 2020/06/23 13:43:12 ET
Table '21863354' 9-max Seat #3 is the button
Seat 1: Small Blind ($604.78 in chips) 
Seat 2: Hero ($492.50 in chips) 
Seat 3: Dealer ($507.50 in chips) 
Small Blind: posts small blind $2.50
Hero: posts big blind $5
*** HOLE CARDS ***
Dealt to Hero [5h Jh]
Dealer: raises $7.50 to $12.50
Small Blind: folds 
Hero: calls $7.50
*** FLOP *** [5s Tc Jc]
Hero: checks 
Dealer: bets $8.07
Hero: calls $8.07
*** TURN *** [5s Tc Jc] [6d]
Hero: checks 
Dealer: bets $61.64
Hero: calls $61.64
*** RIVER *** [5s Tc Jc 6d] [7h]
Hero: checks 
Dealer: bets $425.29 and is all-in
Hero: calls $410.29 and is all-in
*** SHOW DOWN ***
Small Blind: shows [Th Qd] (a hand...)
Dealer: shows [9d 8h] (a hand...)
Hero: shows [5h Jh] (a hand...)
Uncalled bet ($15.00) returned to Dealer
Dealer collected $985.50 from pot
*** SUMMARY ***
Total pot $987.50 | Rake $2.00
Board [5s Tc Jc 6d 7h]
Seat 1: Small Blind folded
Seat 2: Hero showed [5h Jh] and lost with...
Seat 3: Dealer showed [9d 8h] and won ($985.50)



PokerStars Hand #3965004520:  Hold'em No Limit ($2.50/$5) - 2020/06/23 13:32:18 ET
Table '21862921' 9-max Seat #5 is the button
Seat 1: Small Blind ($509.38 in chips) 
Seat 2: Hero ($600.33 in chips) 
Seat 3: UTG ($510.00 in chips) 
Seat 4: UTG+1 ($532.58 in chips) 
Seat 5: Dealer ($614.11 in chips) 
Small Blind: posts small blind $2.50
Hero: posts big blind $5
*** HOLE CARDS ***
Dealt to Hero [9d Kd]
UTG: raises $7.50 to $12.50
UTG+1: folds 
Dealer: folds 
Small Blind: folds 
Hero: calls $7.50
*** FLOP *** [Tc Kc Td]
Hero: checks 
UTG: bets $8.71
Hero: calls $8.71
*** TURN *** [Tc Kc Td] [3h]
Hero: checks 
UTG: bets $32.01
Hero: calls $32.01
*** RIVER *** [Tc Kc Td 3h] [6d]
Hero: checks 
UTG: bets $150
Hero: folds 
*** SHOW DOWN ***
Small Blind: shows [Ad 8s] (a hand...)
Hero: shows [9d Kd] (a hand...)
Dealer: shows [3c Qs] (a hand...)
UTG: shows [Js Ts] (a hand...)
UTG+1: shows [7c 2h] (a hand...)
Uncalled bet ($150.00) returned to UTG
UTG collected $105.94 from pot
*** SUMMARY ***
Total pot $108.94 | Rake $3.00
Board [Tc Kc Td 3h 6d]
Seat 1: Small Blind folded
Seat 2: Hero folded
Seat 3: UTG collected ($105.94)
Seat 4: UTG+1 folded
Seat 5: Dealer folded



PokerStars Hand #3965004022:  Hold'em No Limit ($2.50/$5) - 2020/06/23 13:30:36 ET
Table '21863855' 9-max Seat #6 is the button
Seat 1: Small Blind ($838.96 in chips) 
Seat 2: Big Blind ($991.32 in chips) 
Seat 3: UTG ($829.24 in chips) 
Seat 4: UTG+1 ($453.58 in chips) 
Seat 5: Hero ($513.50 in chips) 
Seat 6: Dealer ($482.50 in chips) 
Small Blind: posts small blind $2.50
Big Blind: posts big blind $5
*** HOLE CARDS ***
Dealt to Hero [4c 5c]
UTG: folds 
UTG+1: folds 
Hero: raises $7.50 to $12.50
Dealer: folds 
Small Blind: folds 
Big Blind: calls $7.50
*** FLOP *** [Jc 6h Ks]
Big Blind: checks 
Hero: bets $8.07
Big Blind: calls $8.07
*** TURN *** [Jc 6h Ks] [9s]
Big Blind: checks 
Hero: checks 
*** RIVER *** [Jc 6h Ks 9s] [6d]
Big Blind: bets $31.10
Hero: folds 
*** SHOW DOWN ***
Small Blind: shows [7c 9h] (a hand...)
Big Blind: shows [Js Ad] (a hand...)
Hero: shows [4c 5c] (a hand...)
Dealer: shows [Td 7h] (a hand...)
UTG: shows [5d 3h] (a hand...)
UTG+1: shows [Jh 6c] (a hand...)
Uncalled bet ($31.10) returned to Big Blind
Big Blind collected $41.46 from pot
*** SUMMARY ***
Total pot $43.64 | Rake $2.18
Board [Jc 6h Ks 9s 6d]
Seat 1: Small Blind folded
Seat 2: Big Blind collected ($41.46)
Seat 3: UTG folded
Seat 4: UTG+1 folded
Seat 5: Hero folded
Seat 6: Dealer folded



PokerStars Hand #3965001225:  Hold'em No Limit ($2.50/$5) - 2020/06/23 13:20:46 ET
Table '21864300' 9-max Seat #1 is the button
Seat 1: Dealer ($340.20 in chips) 
Seat 2: Hero ($457.80 in chips) 
Dealer: posts small blind $2.50
Hero: posts big blind $5
*** HOLE CARDS ***
Dealt to Hero [5d Js]
Dealer: raises $5.00 to $10
Hero: calls $5
*** FLOP *** [Td 4s Qs]
Hero: checks 
Dealer: checks 
*** TURN *** [Td 4s Qs] [Ks]
Hero: bets $14.25
Dealer: raises $33.75 to $48
Hero: calls $33.75
*** RIVER *** [Td 4s Qs Ks] [Qd]
Hero: checks 
Dealer: bets $86.25
Hero: folds 
*** SHOW DOWN ***
Dealer: shows [4h 4d] (a hand...)
Hero: shows [5d Js] (a hand...)
Uncalled bet ($86.25) returned to Dealer
Dealer collected $115 from pot
*** SUMMARY ***
Total pot $116.00 | Rake $1.00
Board [Td 4s Qs Ks Qd]
Seat 1: Dealer collected ($115)
Seat 2: Hero folded



PokerStars Hand #3964712788:  Hold'em No Limit ($2.50/$5) - 2020/06/22 21:00:38 ET
Table '21855169' 9-max Seat #5 is the button
Seat 1: Small Blind ($495.00 in chips) 
Seat 2: Big Blind ($316.77 in chips) 
Seat 3: UTG ($652.92 in chips) 
Seat 4: Hero ($1170.14 in chips) 
Seat 5: Dealer ($1227.73 in chips) 
Small Blind: posts small blind $2.50
Big Blind: posts big blind $5
*** HOLE CARDS ***
Dealt to Hero [6d 6s]
UTG: folds 
Hero: raises $7.50 to $12.50
Dealer: calls $12.50
Small Blind: folds 
Big Blind: calls $7.50
*** FLOP *** [As 7c 7d]
Big Blind: checks 
Hero: bets $12.54
Dealer: folds 
Big Blind: calls $12.54
*** TURN *** [As 7c 7d] [Qh]
Big Blind: checks 
Hero: checks 
*** RIVER *** [As 7c 7d Qh] [Jd]
Big Blind: bets $10
Hero: folds 
*** SHOW DOWN ***
Small Blind: shows [2d 6h] (a hand...)
Big Blind: shows [4h Ah] (a hand...)
Hero: shows [6d 6s] (a hand...)
Dealer: shows [Qc Kc] (a hand...)
UTG: shows [8s 2s] (a hand...)
Uncalled bet ($10.00) returned to Big Blind
Big Blind collected $62.08 from pot
*** SUMMARY ***
Total pot $65.08 | Rake $3.00
Board [As 7c 7d Qh Jd]
Seat 1: Small Blind folded
Seat 2: Big Blind collected ($62.08)
Seat 3: UTG folded
Seat 4: Hero folded
Seat 5: Dealer folded



PokerStars Hand #3964711499:  Hold'em No Limit ($2.50/$5) - 2020/06/22 20:58:14 ET
Table '21853849' 9-max Seat #6 is the button
Seat 1: Small Blind ($1577.95 in chips) 
Seat 2: Big Blind ($167.59 in chips) 
Seat 3: Hero ($730.69 in chips) 
Seat 4: UTG+1 ($496.41 in chips) 
Seat 5: UTG+2 ($764.85 in chips) 
Seat 6: Dealer ($149.46 in chips) 
Small Blind: posts small blind $2.50
Big Blind: posts big blind $5
*** HOLE CARDS ***
Dealt to Hero [Jc Js]
Hero: raises $7.50 to $12.50
UTG+1: folds 
UTG+2: calls $12.50
Dealer: folds 
Small Blind: folds 
Big Blind: folds 
*** FLOP *** [9h 7c 8d]
Hero: checks 
UTG+2: bets $23.16
Hero: calls $23.16
*** TURN *** [9h 7c 8d] [Tc]
Hero: checks 
UTG+2: bets $47.44
Hero: calls $47.44
*** RIVER *** [9h 7c 8d Tc] [9s]
Hero: checks 
UTG+2: bets $139.15
Hero: calls $139.15
*** SHOW DOWN ***
Small Blind: shows [Kc 3d] (a hand...)
Big Blind: shows [Qh 3c] (a hand...)
Hero: shows [Jc Js] (a hand...)
UTG+2: shows [9c 9d] (a hand...)
Dealer: shows [Ah 6c] (a hand...)
UTG+1: shows [5d 8s] (a hand...)
UTG+2 collected $448 from pot
*** SUMMARY ***
Total pot $452.00 | Rake $4.00
Board [9h 7c 8d Tc 9s]
Seat 1: Small Blind folded
Seat 2: Big Blind folded
Seat 3: Hero showed [Jc Js] and lost with...
Seat 4: UTG+1 folded
Seat 5: UTG+2 showed [9c 9d] and won ($448)
Seat 6: Dealer folded



PokerStars Hand #3964710432:  Hold'em No Limit ($2.50/$5) - 2020/06/22 20:56:10 ET
Table '21855899' 9-max Seat #2 is the button
Seat 1: UTG+2 ($500.00 in chips) 
Seat 2: Hero ($492.50 in chips) 
Seat 3: Small Blind ($500.00 in chips) 
Seat 4: Big Blind ($744.09 in chips) 
Seat 5: UTG ($541.25 in chips) 
Seat 6: UTG+1 ($522.88 in chips) 
Small Blind: posts small blind $2.50
Big Blind: posts big blind $5
*** HOLE CARDS ***
Dealt to Hero [7d Qd]
UTG: folds 
UTG+1: folds 
UTG+2: folds 
Hero: raises $7.50 to $12.50
Small Blind: folds 
Big Blind: calls $7.50
*** FLOP *** [Jh 6d 4c]
Big Blind: checks 
Hero: bets $20
Big Blind: calls $20
*** TURN *** [Jh 6d 4c] [9c]
Big Blind: checks 
Hero: checks 
*** RIVER *** [Jh 6d 4c 9c] [Ts]
Big Blind: bets $38
Hero: folds 
*** SHOW DOWN ***
Small Blind: shows [3c 2s] (a hand...)
Big Blind: shows [5s Ac] (a hand...)
Hero: shows [7d Qd] (a hand...)
UTG+2: shows [4h 7c] (a hand...)
UTG: shows [3d 4s] (a hand...)
UTG+1: shows [2d Kc] (a hand...)
Uncalled bet ($38.00) returned to Big Blind
Big Blind collected $64.13 from pot
*** SUMMARY ***
Total pot $67.50 | Rake $3.37
Board [Jh 6d 4c 9c Ts]
Seat 1: UTG+2 folded
Seat 2: Hero folded
Seat 3: Small Blind folded
Seat 4: Big Blind collected ($64.13)
Seat 5: UTG folded
Seat 6: UTG+1 folded



PokerStars Hand #3964688773:  Hold'em No Limit ($2.50/$5) - 2020/06/22 20:12:02 ET
Table '21854942' 9-max Seat #1 is the button
Seat 1: Dealer ($1642.82 in chips) 
Seat 2: Small Blind ($500.00 in chips) 
Seat 3: Hero ($487.50 in chips) 
Seat 4: UTG ($564.04 in chips) 
Seat 5: UTG+1 ($500.00 in chips) 
Small Blind: posts small blind $2.50
Hero: posts big blind $5
*** HOLE CARDS ***
Dealt to Hero [8d Td]
UTG: folds 
UTG+1: raises $7.50 to $12.50
Dealer: calls $12.50
Small Blind: folds 
Hero: calls $7.50
*** FLOP *** [7h 5d 6s]
Hero: checks 
UTG+1: checks 
Dealer: checks 
*** TURN *** [7h 5d 6s] [As]
Hero: checks 
UTG+1: checks 
Dealer: checks 
*** RIVER *** [7h 5d 6s As] [7d]
Hero: checks 
UTG+1: bets $31.16
Dealer: folds 
Hero: folds 
*** SHOW DOWN ***
Small Blind: shows [Qh 8c] (a hand...)
Hero: shows [8d Td] (a hand...)
Dealer: shows [Kh Qd] (a hand...)
UTG: shows [3d Jc] (a hand...)
UTG+1: shows [Ad 9d] (a hand...)
Uncalled bet ($31.16) returned to UTG+1
UTG+1 collected $38 from pot
*** SUMMARY ***
Total pot $40.00 | Rake $2.00
Board [7h 5d 6s As 7d]
Seat 1: Dealer folded
Seat 2: Small Blind folded
Seat 3: Hero folded
Seat 4: UTG folded
Seat 5: UTG+1 collected ($38)



PokerStars Hand #3964683399:  Hold'em No Limit ($2.50/$5) - 2020/06/22 20:00:16 ET
Table '21855706' 9-max Seat #1 is the button
Seat 1: Dealer ($496.50 in chips) 
Seat 2: Hero ($502.50 in chips) 
Dealer: posts small blind $2.50
Hero: posts big blind $5
*** HOLE CARDS ***
Dealt to Hero [Jh 2h]
Dealer: raises $7.50 to $12.50
Hero: calls $7.50
*** FLOP *** [3c Qs 2d]
Hero: checks 
Dealer: bets $18
Hero: calls $18
*** TURN *** [3c Qs 2d] [Js]
Hero: checks 
Dealer: bets $24
Hero: raises $64 to $88
Dealer: calls $64
*** RIVER *** [3c Qs 2d Js] [Jd]
Hero: bets $200.60
Dealer: raises $177.40 to $378 and is all-in
Hero: calls $177.40
*** SHOW DOWN ***
Dealer: shows [Th Qd] (a hand...)
Hero: shows [Jh 2h] (a hand...)
Hero collected $992 from pot
*** SUMMARY ***
Total pot $993.00 | Rake $1.00
Board [3c Qs 2d Js Jd]
Seat 1: Dealer showed [Th Qd] and lost with...
Seat 2: Hero showed [Jh 2h] and won ($992)



PokerStars Hand #3964675239:  Hold'em No Limit ($2.50/$5) - 2020/06/22 19:42:12 ET
Table '21855479' 9-max Seat #1 is the button
Seat 1: Dealer ($537.20 in chips) 
Seat 2: Small Blind ($100.13 in chips) 
Seat 3: Hero ($553.30 in chips) 
Small Blind: posts small blind $2.50
Hero: posts big blind $5
*** HOLE CARDS ***
Dealt to Hero [Qd 9d]
Dealer: folds 
Small Blind: calls $2.50
Hero: raises $15 to $20
Small Blind: calls $15
*** FLOP *** [4c 5d 4d]
Small Blind: checks 
Hero: checks 
*** TURN *** [4c 5d 4d] [Kc]
Small Blind: checks 
Hero: checks 
*** RIVER *** [4c 5d 4d Kc] [8s]
Small Blind: bets $9
Hero: folds 
*** SHOW DOWN ***
Small Blind: shows [Kh Th] (a hand...)
Dealer: shows [Jh 8c] (a hand...)
Hero: shows [Qd 9d] (a hand...)
Uncalled bet ($9.00) returned to Small Blind
Small Blind collected $38 from pot
*** SUMMARY ***
Total pot $40.00 | Rake $2.00
Board [4c 5d 4d Kc 8s]
Seat 1: Dealer folded
Seat 2: Small Blind collected ($38)
Seat 3: Hero folded



PokerStars Hand #3964672668:  Hold'em No Limit ($2.50/$5) - 2020/06/22 19:36:30 ET
Table '21855479' 9-max Seat #2 is the button
Seat 1: Big Blind ($500.00 in chips) 
Seat 2: Hero ($547.70 in chips) 
Hero: posts small blind $2.50
Big Blind: posts big blind $5
*** HOLE CARDS ***
Dealt to Hero [As Jd]
Hero: raises $7.50 to $12.50
Big Blind: calls $7.50
*** FLOP *** [3h 2d Kd]
Big Blind: checks 
Hero: bets $7.20
Big Blind: calls $7.20
*** TURN *** [3h 2d Kd] [6h]
Big Blind: checks 
Hero: checks 
*** RIVER *** [3h 2d Kd 6h] [4h]
Big Blind: bets $14.20
Hero: folds 
*** SHOW DOWN ***
Big Blind: shows [Kc 6c] (a hand...)
Hero: shows [As Jd] (a hand...)
Uncalled bet ($14.20) returned to Big Blind
Big Blind collected $38.40 from pot
*** SUMMARY ***
Total pot $39.40 | Rake $1.00
Board [3h 2d Kd 6h 4h]
Seat 1: Big Blind collected ($38.40)
Seat 2: Hero folded



PokerStars Hand #3963608368:  Hold'em No Limit ($2.50/$5) - 2020/06/20 12:36:16 ET
Table '21826920' 9-max Seat #4 is the button
Seat 1: Small Blind ($705.00 in chips) 
Seat 2: Hero ($650.78 in chips) 
Seat 3: UTG ($946.61 in chips) 
Seat 4: Dealer ($533.50 in chips) 
Small Blind: posts small blind $2.50
Hero: posts big blind $5
*** HOLE CARDS ***
Dealt to Hero [Kd 2c]
UTG: folds 
Dealer: folds 
Small Blind: calls $2.50
Hero: checks 
*** FLOP *** [7h Ks Qs]
Small Blind: bets $5
Hero: calls $5
*** TURN *** [7h Ks Qs] [8h]
Small Blind: bets $19
Hero: calls $19
*** RIVER *** [7h Ks Qs 8h] [Th]
Small Blind: bets $55.10
Hero: folds 
*** SHOW DOWN ***
Small Blind: shows [Jh 4h] (a hand...)
UTG: shows [5s Qd] (a hand...)
Dealer: shows [5d 6c] (a hand...)
Hero: shows [Kd 2c] (a hand...)
Uncalled bet ($55.10) returned to Small Blind
Small Blind collected $55.10 from pot
*** SUMMARY ***
Total pot $58.00 | Rake $2.90
Board [7h Ks Qs 8h Th]
Seat 1: Small Blind collected ($55.10)
Seat 2: Hero folded
Seat 3: UTG folded
Seat 4: Dealer folded



PokerStars Hand #3963605753:  Hold'em No Limit ($2.50/$5) - 2020/06/20 12:26:28 ET
Table '21828763' 9-max Seat #5 is the button
Seat 1: Small Blind ($536.83 in chips) 
Seat 2: Big Blind ($431.50 in chips) 
Seat 3: Hero ($629.16 in chips) 
Seat 4: UTG+1 ($1088.41 in chips) 
Seat 5: Dealer ($480.00 in chips) 
Small Blind: posts small blind $2.50
Big Blind: posts big blind $5
*** HOLE CARDS ***
Dealt to Hero [Ts Qs]
Hero: raises $7.50 to $12.50
UTG+1: folds 
Dealer: calls $12.50
Small Blind: folds 
Big Blind: folds 
*** FLOP *** [2c 7h Qh]
Hero: checks 
Dealer: checks 
*** TURN *** [2c 7h Qh] [8h]
Hero: bets $10
Dealer: calls $10
*** RIVER *** [2c 7h Qh 8h] [2h]
Hero: checks 
Dealer: bets $30
Hero: calls $30
*** SHOW DOWN ***
Small Blind: shows [6d 9c] (a hand...)
Big Blind: shows [Kc 7s] (a hand...)
Hero: shows [Ts Qs] (a hand...)
Dealer: shows [Ad Jc] (a hand...)
UTG+1: shows [5c 5d] (a hand...)
Hero collected $109.50 from pot
*** SUMMARY ***
Total pot $112.50 | Rake $3.00
Board [2c 7h Qh 8h 2h]
Seat 1: Small Blind folded
Seat 2: Big Blind folded
Seat 3: Hero showed [Ts Qs] and won ($109.50)
Seat 4: UTG+1 folded
Seat 5: Dealer showed [Ad Jc] and lost with...



PokerStars Hand #3963602423:  Hold'em No Limit ($2.50/$5) - 2020/06/20 12:12:53 ET
Table '21826920' 9-max Seat #6 is the button
Seat 1: Small Blind ($767.83 in chips) 
Seat 2: Hero ($520.00 in chips) 
Seat 3: UTG ($564.17 in chips) 
Seat 4: UTG+1 ($994.50 in chips) 
Seat 5: UTG+2 ($523.31 in chips) 
Seat 6: Dealer ($231.03 in chips) 
Small Blind: posts small blind $2.50
Hero: posts big blind $5
*** HOLE CARDS ***
Dealt to Hero [As Jh]
UTG: folds 
UTG+1: folds 
UTG+2: folds 
Dealer: raises $15 to $20
Small Blind: calls $17.50
Hero: calls $15
*** FLOP *** [8c 5c Qh]
Small Blind: checks 
Hero: checks 
Dealer: checks 
*** TURN *** [8c 5c Qh] [Ah]
Small Blind: checks 
Hero: checks 
Dealer: checks 
*** RIVER *** [8c 5c Qh Ah] [Qd]
Small Blind: bets $13.50
Hero: calls $13.50
Dealer: calls $13.50
*** SHOW DOWN ***
Small Blind: shows [Ts Td] (a hand...)
Hero: shows [As Jh] (a hand...)
UTG+2: shows [7h Qs] (a hand...)
Dealer: shows [9s 9d] (a hand...)
UTG: shows [6d 3s] (a hand...)
UTG+1: shows [Js 6c] (a hand...)
Hero collected $96.50 from pot
*** SUMMARY ***
Total pot $100.50 | Rake $4.00
Board [8c 5c Qh Ah Qd]
Seat 1: Small Blind showed [Ts Td] and lost with...
Seat 2: Hero showed [As Jh] and won ($96.50)
Seat 3: UTG folded
Seat 4: UTG+1 folded
Seat 5: UTG+2 folded
Seat 6: Dealer showed [9s 9d] and lost with...



PokerStars Hand #3963601092:  Hold'em No Limit ($2.50/$5) - 2020/06/20 12:07:25 ET
Table '21826920' 9-max Seat #6 is the button
Seat 1: Small Blind ($745.08 in chips) 
Seat 2: Hero ($500.00 in chips) 
Seat 3: UTG ($512.62 in chips) 
Seat 4: UTG+1 ($1002.00 in chips) 
Seat 5: UTG+2 ($518.31 in chips) 
Seat 6: Dealer ($267.41 in chips) 
Small Blind: posts small blind $2.50
Hero: posts big blind $5
*** HOLE CARDS ***
Dealt to Hero [Ts Th]
UTG: raises $10 to $15
UTG+1: folds 
UTG+2: folds 
Dealer: folds 
Small Blind: folds 
Hero: calls $10
*** FLOP *** [3d 8h 4c]
Hero: checks 
UTG: checks 
*** TURN *** [3d 8h 4c] [Jd]
Hero: checks 
UTG: bets $15.44
Hero: calls $15.44
*** RIVER *** [3d 8h 4c Jd] [3h]
Hero: checks 
UTG: bets $30.11
Hero: calls $30.11
*** SHOW DOWN ***
Small Blind: shows [Kc 4s] (a hand...)
Hero: shows [Ts Th] (a hand...)
UTG+2: shows [As 6c] (a hand...)
Dealer: shows [3c 7s] (a hand...)
UTG: shows [Kd Jh] (a hand...)
UTG+1: shows [Tc Qs] (a hand...)
UTG collected $119.60 from pot
*** SUMMARY ***
Total pot $123.60 | Rake $4.00
Board [3d 8h 4c Jd 3h]
Seat 1: Small Blind folded
Seat 2: Hero showed [Ts Th] and lost with...
Seat 3: UTG showed [Kd Jh] and won ($119.60)
Seat 4: UTG+1 folded
Seat 5: UTG+2 folded
Seat 6: Dealer folded



PokerStars Hand #3963599196:  Hold'em No Limit ($2.50/$5) - 2020/06/20 11:59:16 ET
Table '21828427' 9-max Seat #2 is the button
Seat 1: Big Blind ($1014.89 in chips) 
Seat 2: Hero ($471.50 in chips) 
Hero: posts small blind $2.50
Big Blind: posts big blind $5
*** HOLE CARDS ***
Dealt to Hero [5d 8c]
Hero: raises $7.50 to $12.50
Big Blind: calls $7.50
*** FLOP *** [Qc 6d 7s]
Big Blind: checks 
Hero: bets $7.20
Big Blind: calls $7.20
*** TURN *** [Qc 6d 7s] [5c]
Big Blind: checks 
Hero: checks 
*** RIVER *** [Qc 6d 7s 5c] [Jh]
Big Blind: bets $29.23
Hero: folds 
*** SHOW DOWN ***
Big Blind: shows [Qd 2d] (a hand...)
Hero: shows [5d 8c] (a hand...)
Uncalled bet ($29.23) returned to Big Blind
Big Blind collected $38.40 from pot
*** SUMMARY ***
Total pot $39.40 | Rake $1.00
Board [Qc 6d 7s 5c Jh]
Seat 1: Big Blind collected ($38.40)
Seat 2: Hero folded



PokerStars Hand #3963598152:  Hold'em No Limit ($2.50/$5) - 2020/06/20 11:54:56 ET
Table '21828763' 9-max Seat #5 is the button
Seat 1: Small Blind ($305.81 in chips) 
Seat 2: Hero ($731.16 in chips) 
Seat 3: UTG ($477.50 in chips) 
Seat 4: UTG+1 ($671.01 in chips) 
Seat 5: Dealer ($304.53 in chips) 
Small Blind: posts small blind $2.50
Hero: posts big blind $5
*** HOLE CARDS ***
Dealt to Hero [Qs 9c]
UTG: folds 
UTG+1: folds 
Dealer: folds 
Small Blind: calls $2.50
Hero: checks 
*** FLOP *** [As 9s Jd]
Small Blind: checks 
Hero: checks 
*** TURN *** [As 9s Jd] [Ad]
Small Blind: checks 
Hero: checks 
*** RIVER *** [As 9s Jd Ad] [Tc]
Small Blind: bets $9.50
Hero: folds 
*** SHOW DOWN ***
Small Blind: shows [7s Jc] (a hand...)
Hero: shows [Qs 9c] (a hand...)
Dealer: shows [2c 5h] (a hand...)
UTG: shows [8c Qc] (a hand...)
UTG+1: shows [4s 6h] (a hand...)
Uncalled bet ($9.50) returned to Small Blind
Small Blind collected $9.50 from pot
*** SUMMARY ***
Total pot $10.00 | Rake $0.50
Board [As 9s Jd Ad Tc]
Seat 1: Small Blind collected ($9.50)
Seat 2: Hero folded
Seat 3: UTG folded
Seat 4: UTG+1 folded
Seat 5: Dealer folded



PokerStars Hand #3963597363:  Hold'em No Limit ($2.50/$5) - 2020/06/20 11:51:46 ET
Table '21828427' 9-max Seat #3 is the button
Seat 1: Small Blind ($795.81 in chips) 
Seat 2: Hero ($529.50 in chips) 
Seat 3: Dealer ($500.00 in chips) 
Small Blind: posts small blind $2.50
Hero: posts big blind $5
*** HOLE CARDS ***
Dealt to Hero [6s Kh]
Dealer: folds 
Small Blind: raises $10.00 to $15
Hero: calls $10
*** FLOP *** [4s 6d Js]
Small Blind: checks 
Hero: bets $9.25
Small Blind: calls $9.25
*** TURN *** [4s 6d Js] [Qh]
Small Blind: checks 
Hero: checks 
*** RIVER *** [4s 6d Js Qh] [Td]
Small Blind: bets $38.23
Hero: calls $38.23
*** SHOW DOWN ***
Small Blind: shows [2s Qs] (a hand...)
Dealer: shows [3c 6c] (a hand...)
Hero: shows [6s Kh] (a hand...)
Small Blind collected $122.96 from pot
*** SUMMARY ***
Total pot $124.96 | Rake $2.00
Board [4s 6d Js Qh Td]
Seat 1: Small Blind showed [2s Qs] and won ($122.96)
Seat 2: Hero showed [6s Kh] and lost with...
Seat 3: Dealer folded



PokerStars Hand #3963595184:  Hold'em No Limit ($2.50/$5) - 2020/06/20 11:42:44 ET
Table '21828151' 9-max Seat #4 is the button
Seat 1: UTG ($571.36 in chips) 
Seat 2: Hero ($500.00 in chips) 
Seat 3: UTG+2 ($661.75 in chips) 
Seat 4: Dealer ($634.72 in chips) 
Seat 5: Small Blind ($500.00 in chips) 
Seat 6: Big Blind ($492.50 in chips) 
Small Blind: posts small blind $2.50
Big Blind: posts big blind $5
*** HOLE CARDS ***
Dealt to Hero [Kc Kd]
UTG: folds 
Hero: raises $7.50 to $12.50
UTG+2: folds 
Dealer: raises $27.50 to $40
Small Blind: folds 
Big Blind: folds 
Hero: raises $82.50 to $122.50
Dealer: calls $82.50
*** FLOP *** [6s 7s Qs]
Hero: checks 
Dealer: checks 
*** TURN *** [6s 7s Qs] [7c]
Hero: checks 
Dealer: checks 
*** RIVER *** [6s 7s Qs 7c] [Ac]
Hero: bets $62.12
Dealer: raises $450.10 to $512.22 and is all-in
Hero: folds 
*** SHOW DOWN ***
Small Blind: shows [Jc 9h] (a hand...)
Big Blind: shows [4h 3c] (a hand...)
Hero: shows [Kc Kd] (a hand...)
Dealer: shows [Qh Qc] (a hand...)
UTG+2: shows [Ad 2s] (a hand...)
UTG: shows [3s Ah] (a hand...)
Uncalled bet ($450.10) returned to Dealer
Dealer collected $372.74 from pot
*** SUMMARY ***
Total pot $376.74 | Rake $4.00
Board [6s 7s Qs 7c Ac]
Seat 1: UTG folded
Seat 2: Hero folded
Seat 3: UTG+2 folded
Seat 4: Dealer collected ($372.74)
Seat 5: Small Blind folded
Seat 6: Big Blind folded



PokerStars Hand #3962735164:  Hold'em No Limit ($2.50/$5) - 2020/06/18 16:28:15 ET
Table '21806432' 9-max Seat #4 is the button
Seat 1: Big Blind ($709.63 in chips) 
Seat 2: UTG ($518.38 in chips) 
Seat 3: UTG+1 ($479.83 in chips) 
Seat 4: Dealer ($500.00 in chips) 
Seat 5: Hero ($1053.82 in chips) 
Hero: posts small blind $2.50
Big Blind: posts big blind $5
*** HOLE CARDS ***
Dealt to Hero [5d 6d]
UTG: folds 
UTG+1: folds 
Dealer: folds 
Hero: raises $10.00 to $15
Big Blind: raises $30 to $45
Hero: calls $30
*** FLOP *** [Kh 3h As]
Hero: checks 
Big Blind: checks 
*** TURN *** [Kh 3h As] [7h]
Hero: checks 
Big Blind: checks 
*** RIVER *** [Kh 3h As 7h] [Th]
Hero: checks 
Big Blind: bets $50
Hero: folds 
*** SHOW DOWN ***
Big Blind: shows [Qs Qh] (a hand...)
Hero: shows [5d 6d] (a hand...)
Dealer: shows [6h Td] (a hand...)
UTG: shows [9h 2d] (a hand...)
UTG+1: shows [Qd 3d] (a hand...)
Uncalled bet ($50.00) returned to Big Blind
Big Blind collected $87 from pot
*** SUMMARY ***
Total pot $90.00 | Rake $3.00
Board [Kh 3h As 7h Th]
Seat 1: Big Blind collected ($87)
Seat 2: UTG folded
Seat 3: UTG+1 folded
Seat 4: Dealer folded
Seat 5: Hero folded



PokerStars Hand #3962685237:  Hold'em No Limit ($2.50/$5) - 2020/06/18 14:10:48 ET
Table '21804670' 9-max Seat #3 is the button
Seat 1: Big Blind ($96.62 in chips) 
Seat 2: UTG ($1164.22 in chips) 
Seat 3: Hero ($492.50 in chips) 
Seat 4: Small Blind ($592.87 in chips) 
Small Blind: posts small blind $2.50
Big Blind: posts big blind $5
*** HOLE CARDS ***
Dealt to Hero [Jd Th]
UTG: folds 
Hero: raises $7.50 to $12.50
Small Blind: calls $10
Big Blind: calls $7.50
*** FLOP *** [Qh Ac 9c]
Small Blind: checks 
Big Blind: checks 
Hero: checks 
*** TURN *** [Qh Ac 9c] [7h]
Small Blind: bets $17.82
Big Blind: folds 
Hero: calls $17.82
*** RIVER *** [Qh Ac 9c 7h] [As]
Small Blind: checks 
Hero: bets $40
Small Blind: raises $60 to $100
Hero: folds 
*** SHOW DOWN ***
Small Blind: shows [Ah 3h] (a hand...)
UTG: shows [4c 2h] (a hand...)
Big Blind: shows [Kd 4d] (a hand...)
Hero: shows [Jd Th] (a hand...)
Uncalled bet ($60.00) returned to Small Blind
Small Blind collected $150.14 from pot
*** SUMMARY ***
Total pot $153.14 | Rake $3.00
Board [Qh Ac 9c 7h As]
Seat 1: Big Blind folded
Seat 2: UTG folded
Seat 3: Hero folded
Seat 4: Small Blind collected ($150.14)



PokerStars Hand #3962673661:  Hold'em No Limit ($2.50/$5) - 2020/06/18 13:34:44 ET
Table '21806645' 9-max Seat #3 is the button
Seat 1: Big Blind ($153.13 in chips) 
Seat 2: Hero ($502.17 in chips) 
Seat 3: Dealer ($510.35 in chips) 
Seat 4: Small Blind ($1111.38 in chips) 
Small Blind: posts small blind $2.50
Big Blind: posts big blind $5
*** HOLE CARDS ***
Dealt to Hero [Ac 5c]
Hero: raises $7.50 to $12.50
Dealer: folds 
Small Blind: folds 
Big Blind: calls $7.50
*** FLOP *** [Jh 3h 5h]
Big Blind: checks 
Hero: checks 
*** TURN *** [Jh 3h 5h] [6s]
Big Blind: bets $19.60
Hero: calls $19.60
*** RIVER *** [Jh 3h 5h 6s] [7s]
Big Blind: bets $31.85
Hero: folds 
*** SHOW DOWN ***
Small Blind: shows [4h Ks] (a hand...)
Dealer: shows [Jc 6d] (a hand...)
Big Blind: shows [3d 5s] (a hand...)
Hero: shows [Ac 5c] (a hand...)
Uncalled bet ($31.85) returned to Big Blind
Big Blind collected $63.70 from pot
*** SUMMARY ***
Total pot $66.70 | Rake $3.00
Board [Jh 3h 5h 6s 7s]
Seat 1: Big Blind collected ($63.70)
Seat 2: Hero folded
Seat 3: Dealer folded
Seat 4: Small Blind folded



PokerStars Hand #3962673630:  Hold'em No Limit ($2.50/$5) - 2020/06/18 13:34:38 ET
Table '21804089' 9-max Seat #2 is the button
Seat 1: Hero ($537.32 in chips) 
Seat 2: Dealer ($500.00 in chips) 
Seat 3: Small Blind ($479.43 in chips) 
Seat 4: Big Blind ($1017.68 in chips) 
Seat 5: UTG ($558.50 in chips) 
Small Blind: posts small blind $2.50
Big Blind: posts big blind $5
UTG: posts small blind $2.50
*** HOLE CARDS ***
Dealt to Hero [Jd Jc]
UTG: calls $2.50
Hero: raises $17.50 to $22.50
Dealer: folds 
Small Blind: folds 
Big Blind: folds 
UTG: calls $17.50
*** FLOP *** [2s 7d 6s]
UTG: checks 
Hero: bets $35
UTG: calls $35
*** TURN *** [2s 7d 6s] [3d]
UTG: checks 
Hero: bets $89.63
UTG: raises $120.37 to $210
Hero: calls $120.37
*** RIVER *** [2s 7d 6s 3d] [Qc]
UTG: bets $291 and is all-in
Hero: calls $269.82 and is all-in
*** SHOW DOWN ***
Small Blind: shows [9h 8c] (a hand...)
Big Blind: shows [6d 5c] (a hand...)
Hero: shows [Jd Jc] (a hand...)
Dealer: shows [4d Js] (a hand...)
UTG: shows [Ks Qs] (a hand...)
Uncalled bet ($21.18) returned to UTG
UTG collected $1079.14 from pot
*** SUMMARY ***
Total pot $1082.14 | Rake $3.00
Board [2s 7d 6s 3d Qc]
Seat 1: Hero showed [Jd Jc] and lost with...
Seat 2: Dealer folded
Seat 3: Small Blind folded
Seat 4: Big Blind folded
Seat 5: UTG showed [Ks Qs] and won ($1079.14)



PokerStars Hand #3962673377:  Hold'em No Limit ($2.50/$5) - 2020/06/18 13:33:48 ET
Table '21804670' 9-max Seat #3 is the button
Seat 1: Big Blind ($390.28 in chips) 
Seat 2: UTG ($604.63 in chips) 
Seat 3: Hero ($630.95 in chips) 
Seat 4: Small Blind ($349.28 in chips) 
Small Blind: posts small blind $2.50
Big Blind: posts big blind $5
*** HOLE CARDS ***
Dealt to Hero [5s 9s]
UTG: folds 
Hero: raises $7.50 to $12.50
Small Blind: raises $12.50 to $25
Big Blind: folds 
Hero: calls $12.50
*** FLOP *** [Qd 2s 5h]
Small Blind: checks 
Hero: checks 
*** TURN *** [Qd 2s 5h] [7d]
Small Blind: bets $35
Hero: calls $35
*** RIVER *** [Qd 2s 5h 7d] [Kc]
Small Blind: bets $97
Hero: folds 
*** SHOW DOWN ***
Small Blind: shows [Ad Ac] (a hand...)
UTG: shows [3s 6h] (a hand...)
Big Blind: shows [Qc 7h] (a hand...)
Hero: shows [5s 9s] (a hand...)
Uncalled bet ($97.00) returned to Small Blind
Small Blind collected $122 from pot
*** SUMMARY ***
Total pot $125.00 | Rake $3.00
Board [Qd 2s 5h 7d Kc]
Seat 1: Big Blind folded
Seat 2: UTG folded
Seat 3: Hero folded
Seat 4: Small Blind collected ($122)



PokerStars Hand #3962672390:  Hold'em No Limit ($2.50/$5) - 2020/06/18 13:30:32 ET
Table '21804670' 9-max Seat #5 is the button
Seat 1: Big Blind ($325.81 in chips) 
Seat 2: UTG ($587.13 in chips) 
Seat 3: UTG+1 ($500.00 in chips) 
Seat 4: UTG+2 ($970.40 in chips) 
Seat 5: Hero ($726.17 in chips) 
Seat 6: Small Blind ($366.78 in chips) 
Small Blind: posts small blind $2.50
Big Blind: posts big blind $5
*** HOLE CARDS ***
Dealt to Hero [Th Qc]
UTG: folds 
UTG+1: folds 
UTG+2: folds 
Hero: raises $7.50 to $12.50
Small Blind: calls $10
Big Blind: calls $7.50
*** FLOP *** [5s Qs 9h]
Small Blind: checks 
Big Blind: checks 
Hero: bets $20
Small Blind: folds 
Big Blind: calls $20
*** TURN *** [5s Qs 9h] [Kc]
Big Blind: checks 
Hero: checks 
*** RIVER *** [5s Qs 9h Kc] [5d]
Big Blind: bets $55.22
Hero: calls $55.22
*** SHOW DOWN ***
Small Blind: shows [6h Ad] (a hand...)
Big Blind: shows [Tc Js] (a hand...)
Hero: shows [Th Qc] (a hand...)
UTG+2: shows [7s 3d] (a hand...)
UTG: shows [8s Ks] (a hand...)
UTG+1: shows [7d 2h] (a hand...)
Big Blind collected $183.94 from pot
*** SUMMARY ***
Total pot $187.94 | Rake $4.00
Board [5s Qs 9h Kc 5d]
Seat 1: Big Blind showed [Tc Js] and won ($183.94)
Seat 2: UTG folded
Seat 3: UTG+1 folded
Seat 4: UTG+2 folded
Seat 5: Hero showed [Th Qc] and lost with...
Seat 6: Small Blind folded



PokerStars Hand #3962668291:  Hold'em No Limit ($2.50/$5) - 2020/06/18 13:16:23 ET
Table '21804089' 9-max Seat #1 is the button
Seat 1: Hero ($503.97 in chips) 
Seat 2: Small Blind ($146.71 in chips) 
Seat 3: Big Blind ($619.99 in chips) 
Seat 4: UTG ($568.50 in chips) 
Seat 5: UTG+1 ($963.18 in chips) 
Seat 6: UTG+2 ($563.50 in chips) 
Small Blind: posts small blind $2.50
Big Blind: posts big blind $5
*** HOLE CARDS ***
Dealt to Hero [3c Ad]
UTG: folds 
UTG+1: folds 
UTG+2: folds 
Hero: raises $7.50 to $12.50
Small Blind: folds 
Big Blind: calls $7.50
*** FLOP *** [Ah 5h 7d]
Big Blind: checks 
Hero: bets $7.84
Big Blind: raises $20.91 to $28.75
Hero: calls $20.91
*** TURN *** [Ah 5h 7d] [As]
Big Blind: checks 
Hero: checks 
*** RIVER *** [Ah 5h 7d As] [9h]
Big Blind: bets $35
Hero: calls $35
*** SHOW DOWN ***
Small Blind: shows [2h 8c] (a hand...)
Big Blind: shows [Jh 6h] (a hand...)
Hero: shows [3c Ad] (a hand...)
UTG+2: shows [9c 6s] (a hand...)
UTG: shows [7s 6c] (a hand...)
UTG+1: shows [Qh 4s] (a hand...)
Big Blind collected $151 from pot
*** SUMMARY ***
Total pot $155.00 | Rake $4.00
Board [Ah 5h 7d As 9h]
Seat 1: Hero showed [3c Ad] and lost with...
Seat 2: Small Blind folded
Seat 3: Big Blind showed [Jh 6h] and won ($151)
Seat 4: UTG folded
Seat 5: UTG+1 folded
Seat 6: UTG+2 folded



PokerStars Hand #3962668020:  Hold'em No Limit ($2.50/$5) - 2020/06/18 13:15:24 ET
Table '21806645' 9-max Seat #3 is the button
Seat 1: Big Blind ($369.93 in chips) 
Seat 2: UTG ($497.50 in chips) 
Seat 3: Hero ($493.88 in chips) 
Seat 4: Small Blind ($177.33 in chips) 
Small Blind: posts small blind $2.50
Big Blind: posts big blind $5
*** HOLE CARDS ***
Dealt to Hero [As Kd]
UTG: raises $10 to $15
Hero: raises $30 to $45
Small Blind: folds 
Big Blind: folds 
UTG: calls $30
*** FLOP *** [8h 6s Tc]
UTG: checks 
Hero: checks 
*** TURN *** [8h 6s Tc] [4s]
UTG: bets $70.88
Hero: calls $70.88
*** RIVER *** [8h 6s Tc 4s] [3h]
UTG: bets $118.13
Hero: folds 
*** SHOW DOWN ***
Small Blind: shows [Ts 3s] (a hand...)
UTG: shows [8s 7s] (a hand...)
Big Blind: shows [6c Th] (a hand...)
Hero: shows [As Kd] (a hand...)
Uncalled bet ($118.13) returned to UTG
UTG collected $236.26 from pot
*** SUMMARY ***
Total pot $239.26 | Rake $3.00
Board [8h 6s Tc 4s 3h]
Seat 1: Big Blind folded
Seat 2: UTG collected ($236.26)
Seat 3: Hero folded
Seat 4: Small Blind folded



PokerStars Hand #3962664709:  Hold'em No Limit ($2.50/$5) - 2020/06/18 13:03:19 ET
Table '21806645' 9-max Seat #1 is the button
Seat 1: Dealer ($258.05 in chips) 
Seat 2: Hero ($525.00 in chips) 
Seat 3: Big Blind ($500.00 in chips) 
Seat 4: UTG ($192.33 in chips) 
Seat 5: UTG+1 ($500.00 in chips) 
Hero: posts small blind $2.50
Big Blind: posts big blind $5
*** HOLE CARDS ***
Dealt to Hero [Kd Ah]
UTG: calls $5
UTG+1: folds 
Dealer: calls $5
Hero: raises $25.00 to $30
Big Blind: folds 
UTG: folds 
Dealer: calls $25
*** FLOP *** [6d 3c 4c]
Hero: checks 
Dealer: checks 
*** TURN *** [6d 3c 4c] [3h]
Hero: checks 
Dealer: checks 
*** RIVER *** [6d 3c 4c 3h] [Qc]
Hero: checks 
Dealer: bets $30
Hero: calls $30
*** SHOW DOWN ***
Big Blind: shows [2h 7d] (a hand...)
Hero: shows [Kd Ah] (a hand...)
Dealer: shows [9s Qs] (a hand...)
UTG: shows [8h 7s] (a hand...)
UTG+1: shows [Ts 2s] (a hand...)
Dealer collected $127 from pot
*** SUMMARY ***
Total pot $130.00 | Rake $3.00
Board [6d 3c 4c 3h Qc]
Seat 1: Dealer showed [9s Qs] and won ($127)
Seat 2: Hero showed [Kd Ah] and lost with...
Seat 3: Big Blind folded
Seat 4: UTG folded
Seat 5: UTG+1 folded



PokerStars Hand #3962388225:  Hold'em No Limit ($2.50/$5) - 2020/06/17 21:36:51 ET
Table '21796570' 9-max Seat #2 is the button
Seat 1: Big Blind ($500.00 in chips) 
Seat 2: Dealer ($551.13 in chips) 
Seat 3: Hero ($907.89 in chips) 
Hero: posts small blind $2.50
Big Blind: posts big blind $5
*** HOLE CARDS ***
Dealt to Hero [4d Ac]
Dealer: folds 
Hero: raises $10.00 to $15
Big Blind: calls $10
*** FLOP *** [5d 8h Js]
Hero: checks 
Big Blind: checks 
*** TURN *** [5d 8h Js] [Ks]
Hero: checks 
Big Blind: checks 
*** RIVER *** [5d 8h Js Ks] [4c]
Hero: checks 
Big Blind: bets $28.50
Hero: calls $28.50
*** SHOW DOWN ***
Dealer: shows [2h 7c] (a hand...)
Big Blind: shows [Ts Jd] (a hand...)
Hero: shows [4d Ac] (a hand...)
Big Blind collected $85 from pot
*** SUMMARY ***
Total pot $87.00 | Rake $2.00
Board [5d 8h Js Ks 4c]
Seat 1: Big Blind showed [Ts Jd] and won ($85)
Seat 2: Dealer folded
Seat 3: Hero showed [4d Ac] and lost with...



PokerStars Hand #3962386333:  Hold'em No Limit ($2.50/$5) - 2020/06/17 21:33:25 ET
Table '21799769' 9-max Seat #1 is the button
Seat 1: Dealer ($1553.49 in chips) 
Seat 2: Small Blind ($743.38 in chips) 
Seat 3: Big Blind ($606.39 in chips) 
Seat 4: UTG ($496.91 in chips) 
Seat 5: UTG+1 ($237.13 in chips) 
Seat 6: Hero ($794.78 in chips) 
Small Blind: posts small blind $2.50
Big Blind: posts big blind $5
*** HOLE CARDS ***
Dealt to Hero [8c 7c]
UTG: folds 
UTG+1: folds 
Hero: raises $7.50 to $12.50
Dealer: folds 
Small Blind: folds 
Big Blind: calls $7.50
*** FLOP *** [8s Qh 2c]
Big Blind: checks 
Hero: bets $7.84
Big Blind: calls $7.84
*** TURN *** [8s Qh 2c] [Ac]
Big Blind: checks 
Hero: checks 
*** RIVER *** [8s Qh 2c Ac] [4h]
Big Blind: bets $61.03
Hero: calls $61.03
*** SHOW DOWN ***
Small Blind: shows [5s Ks] (a hand...)
Big Blind: shows [Ad 8d] (a hand...)
Hero: shows [8c 7c] (a hand...)
Dealer: shows [7s 4d] (a hand...)
UTG: shows [Qd Tc] (a hand...)
UTG+1: shows [5h 4s] (a hand...)
Big Blind collected $161.24 from pot
*** SUMMARY ***
Total pot $165.24 | Rake $4.00
Board [8s Qh 2c Ac 4h]
Seat 1: Dealer folded
Seat 2: Small Blind folded
Seat 3: Big Blind showed [Ad 8d] and won ($161.24)
Seat 4: UTG folded
Seat 5: UTG+1 folded
Seat 6: Hero showed [8c 7c] and lost with...



PokerStars Hand #3962384354:  Hold'em No Limit ($2.50/$5) - 2020/06/17 21:29:46 ET
Table '21796570' 9-max Seat #4 is the button
Seat 1: UTG ($632.56 in chips) 
Seat 2: UTG+1 ($507.50 in chips) 
Seat 3: UTG+2 ($591.13 in chips) 
Seat 4: Dealer ($482.50 in chips) 
Seat 5: Small Blind ($543.57 in chips) 
Seat 6: Hero ($891.58 in chips) 
Small Blind: posts small blind $2.50
Hero: posts big blind $5
*** HOLE CARDS ***
Dealt to Hero [Kd Qc]
UTG: raises $5 to $10
UTG+1: folds 
UTG+2: folds 
Dealer: folds 
Small Blind: folds 
Hero: calls $5
*** FLOP *** [Jh 8c Jd]
Hero: checks 
UTG: checks 
*** TURN *** [Jh 8c Jd] [Jc]
Hero: bets $10.69
UTG: calls $10.69
*** RIVER *** [Jh 8c Jd Jc] [Ah]
Hero: checks 
UTG: bets $31.27
Hero: folds 
*** SHOW DOWN ***
Small Blind: shows [Kh 3c] (a hand...)
Hero: shows [Kd Qc] (a hand...)
Dealer: shows [2c Ks] (a hand...)
UTG+2: shows [Ts Ac] (a hand...)
UTG: shows [Ad Qh] (a hand...)
UTG+1: shows [Th 7h] (a hand...)
Uncalled bet ($31.27) returned to UTG
UTG collected $41.69 from pot
*** SUMMARY ***
Total pot $43.88 | Rake $2.19
Board [Jh 8c Jd Jc Ah]
Seat 1: UTG collected ($41.69)
Seat 2: UTG+1 folded
Seat 3: UTG+2 folded
Seat 4: Dealer folded
Seat 5: Small Blind folded
Seat 6: Hero folded



PokerStars Hand #3962381753:  Hold'em No Limit ($2.50/$5) - 2020/06/17 21:24:54 ET
Table '21799769' 9-max Seat #2 is the button
Seat 1: UTG+2 ($1608.49 in chips) 
Seat 2: Dealer ($517.38 in chips) 
Seat 3: Small Blind ($616.39 in chips) 
Seat 4: Big Blind ($333.78 in chips) 
Seat 5: UTG ($457.13 in chips) 
Seat 6: Hero ($907.41 in chips) 
Small Blind: posts small blind $2.50
Big Blind: posts big blind $5
*** HOLE CARDS ***
Dealt to Hero [6d Ad]
UTG: folds 
Hero: raises $7.50 to $12.50
UTG+2: folds 
Dealer: folds 
Small Blind: folds 
Big Blind: calls $7.50
*** FLOP *** [Kd Td Js]
Big Blind: checks 
Hero: bets $30
Big Blind: calls $30
*** TURN *** [Kd Td Js] [8s]
Big Blind: checks 
Hero: bets $62.63
Big Blind: calls $62.63
*** RIVER *** [Kd Td Js 8s] [3h]
Big Blind: bets $99.38
Hero: folds 
*** SHOW DOWN ***
Small Blind: shows [Tc Jh] (a hand...)
Big Blind: shows [As Qd] (a hand...)
Hero: shows [6d Ad] (a hand...)
Dealer: shows [7d 5c] (a hand...)
UTG+2: shows [Ac 3s] (a hand...)
UTG: shows [9s 5s] (a hand...)
Uncalled bet ($99.38) returned to Big Blind
Big Blind collected $208.76 from pot
*** SUMMARY ***
Total pot $212.76 | Rake $4.00
Board [Kd Td Js 8s 3h]
Seat 1: UTG+2 folded
Seat 2: Dealer folded
Seat 3: Small Blind folded
Seat 4: Big Blind collected ($208.76)
Seat 5: UTG folded
Seat 6: Hero folded



PokerStars Hand #3962373671:  Hold'em No Limit ($2.50/$5) - 2020/06/17 21:08:57 ET
Table '21799587' 9-max Seat #4 is the button
Seat 1: UTG ($734.22 in chips) 
Seat 2: UTG+1 ($988.50 in chips) 
Seat 3: UTG+2 ($194.50 in chips) 
Seat 4: Hero ($492.50 in chips) 
Seat 5: Small Blind ($911.26 in chips) 
Seat 6: Big Blind ($302.13 in chips) 
Small Blind: posts small blind $2.50
Big Blind: posts big blind $5
*** HOLE CARDS ***
Dealt to Hero [As Jd]
UTG: folds 
UTG+1: folds 
UTG+2: folds 
Hero: raises $7.50 to $12.50
Small Blind: raises $27.50 to $40
Big Blind: folds 
Hero: calls $27.50
*** FLOP *** [6c Qh Ts]
Small Blind: checks 
Hero: checks 
*** TURN *** [6c Qh Ts] [Ac]
Small Blind: checks 
Hero: checks 
*** RIVER *** [6c Qh Ts Ac] [Tc]
Small Blind: bets $40
Hero: calls $40
*** SHOW DOWN ***
Small Blind: shows [Kh 9h] (a hand...)
Big Blind: shows [2h 2s] (a hand...)
Hero: shows [As Jd] (a hand...)
UTG+2: shows [6d Ah] (a hand...)
UTG: shows [3h 6h] (a hand...)
UTG+1: shows [7d 2c] (a hand...)
Hero collected $161 from pot
*** SUMMARY ***
Total pot $165.00 | Rake $4.00
Board [6c Qh Ts Ac Tc]
Seat 1: UTG folded
Seat 2: UTG+1 folded
Seat 3: UTG+2 folded
Seat 4: Hero showed [As Jd] and won ($161)
Seat 5: Small Blind showed [Kh 9h] and lost with...
Seat 6: Big Blind folded



PokerStars Hand #3962366983:  Hold'em No Limit ($2.50/$5) - 2020/06/17 20:54:48 ET
Table '21799772' 9-max Seat #1 is the button
Seat 1: Hero ($763.60 in chips) 
Seat 2: Small Blind ($589.70 in chips) 
Seat 3: Big Blind ($500.00 in chips) 
Seat 4: UTG ($498.72 in chips) 
Seat 5: UTG+1 ($577.00 in chips) 
Seat 6: UTG+2 ($441.01 in chips) 
Small Blind: posts small blind $2.50
Big Blind: posts big blind $5
*** HOLE CARDS ***
Dealt to Hero [Ts Ks]
UTG: raises $10 to $15
UTG+1: folds 
UTG+2: calls $15
Hero: raises $55 to $70
Small Blind: folds 
Big Blind: folds 
UTG: folds 
UTG+2: calls $55
*** FLOP *** [8h Kd 8s]
UTG+2: checks 
Hero: checks 
*** TURN *** [8h Kd 8s] [9h]
UTG+2: bets $45
Hero: calls $45
*** RIVER *** [8h Kd 8s 9h] [Qs]
UTG+2: bets $105
Hero: calls $105
*** SHOW DOWN ***
Small Blind: shows [Qc 7c] (a hand...)
Big Blind: shows [2h 2d] (a hand...)
Hero: shows [Ts Ks] (a hand...)
UTG+2: shows [7d Jd] (a hand...)
UTG: shows [Ad Jc] (a hand...)
UTG+1: shows [Js 3c] (a hand...)
Hero collected $458.50 from pot
*** SUMMARY ***
Total pot $462.50 | Rake $4.00
Board [8h Kd 8s 9h Qs]
Seat 1: Hero showed [Ts Ks] and won ($458.50)
Seat 2: Small Blind folded
Seat 3: Big Blind folded
Seat 4: UTG folded
Seat 5: UTG+1 folded
Seat 6: UTG+2 showed [7d Jd] and lost with...



PokerStars Hand #3962362203:  Hold'em No Limit ($2.50/$5) - 2020/06/17 20:44:34 ET
Table '21799769' 9-max Seat #4 is the button
Seat 1: Big Blind ($696.45 in chips) 
Seat 2: UTG ($496.88 in chips) 
Seat 3: UTG+1 ($290.90 in chips) 
Seat 4: Dealer ($462.50 in chips) 
Seat 5: Hero ($901.83 in chips) 
Hero: posts small blind $2.50
Big Blind: posts big blind $5
*** HOLE CARDS ***
Dealt to Hero [Ah 4s]
UTG: folds 
UTG+1: folds 
Dealer: folds 
Hero: raises $10.00 to $15
Big Blind: calls $10
*** FLOP *** [Kd 7c 7s]
Hero: bets $8.55
Big Blind: calls $8.55
*** TURN *** [Kd 7c 7s] [2s]
Hero: checks 
Big Blind: checks 
*** RIVER *** [Kd 7c 7s 2s] [2h]
Hero: checks 
Big Blind: bets $29.54
Hero: folds 
*** SHOW DOWN ***
Big Blind: shows [Kc 8c] (a hand...)
Hero: shows [Ah 4s] (a hand...)
Dealer: shows [Qs 3c] (a hand...)
UTG: shows [3h As] (a hand...)
UTG+1: shows [9c 2d] (a hand...)
Uncalled bet ($29.54) returned to Big Blind
Big Blind collected $44.75 from pot
*** SUMMARY ***
Total pot $47.10 | Rake $2.35
Board [Kd 7c 7s 2s 2h]
Seat 1: Big Blind collected ($44.75)
Seat 2: UTG folded
Seat 3: UTG+1 folded
Seat 4: Dealer folded
Seat 5: Hero folded



PokerStars Hand #3962362077:  Hold'em No Limit ($2.50/$5) - 2020/06/17 20:44:18 ET
Table '21799587' 9-max Seat #4 is the button
Seat 1: Big Blind ($482.38 in chips) 
Seat 2: UTG ($510.72 in chips) 
Seat 3: UTG+1 ($507.50 in chips) 
Seat 4: Hero ($498.63 in chips) 
Seat 5: Small Blind ($510.88 in chips) 
Small Blind: posts small blind $2.50
Big Blind: posts big blind $5
*** HOLE CARDS ***
Dealt to Hero [Kh Kd]
UTG: folds 
UTG+1: folds 
Hero: raises $7.50 to $12.50
Small Blind: folds 
Big Blind: calls $7.50
*** FLOP *** [Ac Jd Ad]
Big Blind: bets $15
Hero: calls $15
*** TURN *** [Ac Jd Ad] [Qd]
Big Blind: checks 
Hero: bets $27.32
Big Blind: calls $27.32
*** RIVER *** [Ac Jd Ad Qd] [Jh]
Big Blind: bets $65
Hero: calls $65
*** SHOW DOWN ***
Small Blind: shows [4s Qh] (a hand...)
Big Blind: shows [9s Ah] (a hand...)
Hero: shows [Kh Kd] (a hand...)
UTG: shows [6c Td] (a hand...)
UTG+1: shows [5c 7c] (a hand...)
Big Blind collected $239.14 from pot
*** SUMMARY ***
Total pot $242.14 | Rake $3.00
Board [Ac Jd Ad Qd Jh]
Seat 1: Big Blind showed [9s Ah] and won ($239.14)
Seat 2: UTG folded
Seat 3: UTG+1 folded
Seat 4: Hero showed [Kh Kd] and lost with...
Seat 5: Small Blind folded



PokerStars Hand #3962360397:  Hold'em No Limit ($2.50/$5) - 2020/06/17 20:40:27 ET
Table '21796570' 9-max Seat #3 is the button
Seat 1: UTG ($559.85 in chips) 
Seat 2: UTG+1 ($1836.68 in chips) 
Seat 3: Dealer ($392.02 in chips) 
Seat 4: Small Blind ($487.50 in chips) 
Seat 5: Hero ($535.53 in chips) 
Small Blind: posts small blind $2.50
Hero: posts big blind $5
*** HOLE CARDS ***
Dealt to Hero [Kd Ks]
UTG: folds 
UTG+1: folds 
Dealer: folds 
Small Blind: raises $10.00 to $15
Hero: raises $30 to $45
Small Blind: calls $30
*** FLOP *** [5c Js As]
Small Blind: checks 
Hero: checks 
*** TURN *** [5c Js As] [Td]
Small Blind: checks 
Hero: checks 
*** RIVER *** [5c Js As Td] [Kc]
Small Blind: bets $112
Hero: calls $112
*** SHOW DOWN ***
Small Blind: shows [Ts Qc] (a hand...)
Hero: shows [Kd Ks] (a hand...)
Dealer: shows [4h Jd] (a hand...)
UTG: shows [6d 2c] (a hand...)
UTG+1: shows [3h 2s] (a hand...)
Small Blind collected $311 from pot
*** SUMMARY ***
Total pot $314.00 | Rake $3.00
Board [5c Js As Td Kc]
Seat 1: UTG folded
Seat 2: UTG+1 folded
Seat 3: Dealer folded
Seat 4: Small Blind showed [Ts Qc] and won ($311)
Seat 5: Hero showed [Kd Ks] and lost with...



PokerStars Hand #3962355249:  Hold'em No Limit ($2.50/$5) - 2020/06/17 20:28:15 ET
Table '21799772' 9-max Seat #1 is the button
Seat 1: Hero ($500.00 in chips) 
Seat 2: Big Blind ($500.00 in chips) 
Hero: posts small blind $2.50
Big Blind: posts big blind $5
*** HOLE CARDS ***
Dealt to Hero [6c Kc]
Hero: raises $7.50 to $12.50
Big Blind: calls $7.50
*** FLOP *** [5c Td 2h]
Big Blind: checks 
Hero: bets $7.20
Big Blind: calls $7.20
*** TURN *** [5c Td 2h] [Th]
Big Blind: checks 
Hero: checks 
*** RIVER *** [5c Td 2h Th] [3s]
Big Blind: bets $14.20
Hero: folds 
*** SHOW DOWN ***
Big Blind: shows [9s Jc] (a hand...)
Hero: shows [6c Kc] (a hand...)
Uncalled bet ($14.20) returned to Big Blind
Big Blind collected $38.40 from pot
*** SUMMARY ***
Total pot $39.40 | Rake $1.00
Board [5c Td 2h Th 3s]
Seat 1: Hero folded
Seat 2: Big Blind collected ($38.40)



PokerStars Hand #3962329774:  Hold'em No Limit ($2.50/$5) - 2020/06/17 19:25:59 ET
Table '21797488' 9-max Seat #6 is the button
Seat 1: Small Blind ($450.40 in chips) 
Seat 2: Hero ($597.08 in chips) 
Seat 3: UTG ($527.44 in chips) 
Seat 4: UTG+1 ($1337.54 in chips) 
Seat 5: UTG+2 ($391.69 in chips) 
Seat 6: Dealer ($910.87 in chips) 
Small Blind: posts small blind $2.50
Hero: posts big blind $5
*** HOLE CARDS ***
Dealt to Hero [As Jd]
UTG: folds 
UTG+1: folds 
UTG+2: folds 
Dealer: raises $7.50 to $12.50
Small Blind: folds 
Hero: calls $7.50
*** FLOP *** [4c 4s Qd]
Hero: checks 
Dealer: checks 
*** TURN *** [4c 4s Qd] [2h]
Hero: bets $7.84
Dealer: calls $7.84
*** RIVER *** [4c 4s Qd 2h] [5s]
Hero: checks 
Dealer: bets $36.03
Hero: folds 
*** SHOW DOWN ***
Small Blind: shows [Th 8c] (a hand...)
Hero: shows [As Jd] (a hand...)
UTG+2: shows [7d Jc] (a hand...)
Dealer: shows [Ah Ad] (a hand...)
UTG: shows [9c 4d] (a hand...)
UTG+1: shows [9d 6d] (a hand...)
Uncalled bet ($36.03) returned to Dealer
Dealer collected $41.03 from pot
*** SUMMARY ***
Total pot $43.18 | Rake $2.15
Board [4c 4s Qd 2h 5s]
Seat 1: Small Blind folded
Seat 2: Hero folded
Seat 3: UTG folded
Seat 4: UTG+1 folded
Seat 5: UTG+2 folded
Seat 6: Dealer collected ($41.03)



PokerStars Hand #3962326606:  Hold'em No Limit ($2.50/$5) - 2020/06/17 19:18:28 ET
Table '21795769' 9-max Seat #1 is the button
Seat 1: Dealer ($697.42 in chips) 
Seat 2: Small Blind ($919.53 in chips) 
Seat 3: Big Blind ($184.19 in chips) 
Seat 4: UTG ($375.57 in chips) 
Seat 5: Hero ($501.00 in chips) 
Seat 6: UTG+2 ($533.49 in chips) 
Small Blind: posts small blind $2.50
Big Blind: posts big blind $5
*** HOLE CARDS ***
Dealt to Hero [Ah 6h]
UTG: folds 
Hero: raises $7.50 to $12.50
UTG+2: folds 
Dealer: folds 
Small Blind: folds 
Big Blind: calls $7.50
*** FLOP *** [8h Jd 7s]
Big Blind: checks 
Hero: bets $7.84
Big Blind: calls $7.84
*** TURN *** [8h Jd 7s] [3h]
Big Blind: checks 
Hero: checks 
*** RIVER *** [8h Jd 7s 3h] [8d]
Big Blind: bets $20.52
Hero: folds 
*** SHOW DOWN ***
Small Blind: shows [Qh 8s] (a hand...)
Big Blind: shows [4d 6s] (a hand...)
Hero: shows [Ah 6h] (a hand...)
Dealer: shows [9h 7d] (a hand...)
UTG+2: shows [Ts 4c] (a hand...)
UTG: shows [Ac 3s] (a hand...)
Uncalled bet ($20.52) returned to Big Blind
Big Blind collected $41.03 from pot
*** SUMMARY ***
Total pot $43.18 | Rake $2.15
Board [8h Jd 7s 3h 8d]
Seat 1: Dealer folded
Seat 2: Small Blind folded
Seat 3: Big Blind collected ($41.03)
Seat 4: UTG folded
Seat 5: Hero folded
Seat 6: UTG+2 folded



PokerStars Hand #3962323418:  Hold'em No Limit ($2.50/$5) - 2020/06/17 19:10:49 ET
Table '21798826' 9-max Seat #1 is the button
Seat 1: Hero ($610.29 in chips) 
Seat 2: Small Blind ($533.95 in chips) 
Seat 3: Big Blind ($514.08 in chips) 
Seat 4: UTG ($640.99 in chips) 
Seat 5: UTG+1 ($192.00 in chips) 
Small Blind: posts small blind $2.50
Big Blind: posts big blind $5
*** HOLE CARDS ***
Dealt to Hero [As 9h]
UTG: folds 
UTG+1: folds 
Hero: raises $7.50 to $12.50
Small Blind: folds 
Big Blind: calls $7.50
*** FLOP *** [4s Th 3h]
Big Blind: checks 
Hero: checks 
*** TURN *** [4s Th 3h] [Kd]
Big Blind: checks 
Hero: checks 
*** RIVER *** [4s Th 3h Kd] [6h]
Big Blind: bets $21
Hero: calls $21
*** SHOW DOWN ***
Small Blind: shows [3d Kc] (a hand...)
Big Blind: shows [9s Qc] (a hand...)
Hero: shows [As 9h] (a hand...)
UTG: shows [Qh 2s] (a hand...)
UTG+1: shows [9c 8h] (a hand...)
Hero collected $66.50 from pot
*** SUMMARY ***
Total pot $69.50 | Rake $3.00
Board [4s Th 3h Kd 6h]
Seat 1: Hero showed [As 9h] and won ($66.50)
Seat 2: Small Blind folded
Seat 3: Big Blind showed [9s Qc] and lost with...
Seat 4: UTG folded
Seat 5: UTG+1 folded



PokerStars Hand #3962322543:  Hold'em No Limit ($2.50/$5) - 2020/06/17 19:08:40 ET
Table '21795769' 9-max Seat #3 is the button
Seat 1: UTG ($657.54 in chips) 
Seat 2: UTG+1 ($983.47 in chips) 
Seat 3: Dealer ($723.78 in chips) 
Seat 4: Small Blind ($496.95 in chips) 
Seat 5: Hero ($500.00 in chips) 
Small Blind: posts small blind $2.50
Hero: posts big blind $5
*** HOLE CARDS ***
Dealt to Hero [Ks 8d]
UTG: folds 
UTG+1: folds 
Dealer: folds 
Small Blind: calls $2.50
Hero: checks 
*** FLOP *** [3c 8s 2h]
Small Blind: checks 
Hero: bets $7.13
Small Blind: calls $7.13
*** TURN *** [3c 8s 2h] [As]
Small Blind: checks 
Hero: checks 
*** RIVER *** [3c 8s 2h As] [9c]
Small Blind: bets $30.15
Hero: folds 
*** SHOW DOWN ***
Small Blind: shows [3d 2d] (a hand...)
Hero: shows [Ks 8d] (a hand...)
Dealer: shows [Kc 3h] (a hand...)
UTG: shows [2c 5c] (a hand...)
UTG+1: shows [Js 9d] (a hand...)
Uncalled bet ($30.15) returned to Small Blind
Small Blind collected $23.05 from pot
*** SUMMARY ***
Total pot $24.26 | Rake $1.21
Board [3c 8s 2h As 9c]
Seat 1: UTG folded
Seat 2: UTG+1 folded
Seat 3: Dealer folded
Seat 4: Small Blind collected ($23.05)
Seat 5: Hero folded



PokerStars Hand #3962321437:  Hold'em No Limit ($2.50/$5) - 2020/06/17 19:05:57 ET
Table '21795769' 9-max Seat #5 is the button
Seat 1: Small Blind ($660.04 in chips) 
Seat 2: Big Blind ($1085.97 in chips) 
Seat 3: UTG ($731.28 in chips) 
Seat 4: UTG+1 ($345.45 in chips) 
Seat 5: Hero ($505.10 in chips) 
Small Blind: posts small blind $2.50
Big Blind: posts big blind $5
*** HOLE CARDS ***
Dealt to Hero [Kh Qh]
UTG: folds 
UTG+1: raises $10 to $15
Hero: raises $30 to $45
Small Blind: folds 
Big Blind: folds 
UTG+1: calls $30
*** FLOP *** [5c 9d 2s]
UTG+1: checks 
Hero: checks 
*** TURN *** [5c 9d 2s] [7s]
UTG+1: checks 
Hero: checks 
*** RIVER *** [5c 9d 2s 7s] [6h]
UTG+1: bets $30.67
Hero: folds 
*** SHOW DOWN ***
Small Blind: shows [As 4s] (a hand...)
Big Blind: shows [7h 3d] (a hand...)
Hero: shows [Kh Qh] (a hand...)
UTG: shows [Jh 5s] (a hand...)
UTG+1: shows [Js Ac] (a hand...)
Uncalled bet ($30.67) returned to UTG+1
UTG+1 collected $94.50 from pot
*** SUMMARY ***
Total pot $97.50 | Rake $3.00
Board [5c 9d 2s 7s 6h]
Seat 1: Small Blind folded
Seat 2: Big Blind folded
Seat 3: UTG folded
Seat 4: UTG+1 collected ($94.50)
Seat 5: Hero folded



PokerStars Hand #3959740589:  Hold'em No Limit ($2.50/$5) - 2020/06/12 11:54:31 ET
Table '21735908' 9-max Seat #1 is the button
Seat 1: Dealer ($1615.34 in chips) 
Seat 2: Hero ($374.40 in chips) 
Seat 3: Big Blind ($168.50 in chips) 
Hero: posts small blind $2.50
Big Blind: posts big blind $5
*** HOLE CARDS ***
Dealt to Hero [3c 3d]
Dealer: calls $5
Hero: calls $2.50
Big Blind: checks 
*** FLOP *** [7h Ts 6h]
Hero: checks 
Big Blind: checks 
Dealer: checks 
*** TURN *** [7h Ts 6h] [5h]
Hero: checks 
Big Blind: checks 
Dealer: checks 
*** RIVER *** [7h Ts 6h 5h] [4s]
Hero: checks 
Big Blind: bets $5.45
Dealer: folds 
Hero: calls $5.45
*** SHOW DOWN ***
Dealer: shows [2c 2s] (a hand...)
Big Blind: shows [8d Jd] (a hand...)
Hero: shows [3c 3d] (a hand...)
Big Blind collected $24.61 from pot
*** SUMMARY ***
Total pot $25.90 | Rake $1.29
Board [7h Ts 6h 5h 4s]
Seat 1: Dealer folded
Seat 2: Hero showed [3c 3d] and lost with...
Seat 3: Big Blind showed [8d Jd] and won ($24.61)



PokerStars Hand #3959740114:  Hold'em No Limit ($2.50/$5) - 2020/06/12 11:52:40 ET
Table '21735908' 9-max Seat #3 is the button
Seat 1: Big Blind ($1533.56 in chips) 
Seat 2: UTG ($492.50 in chips) 
Seat 3: Hero ($458.63 in chips) 
Seat 4: Small Blind ($171.00 in chips) 
Small Blind: posts small blind $2.50
Big Blind: posts big blind $5
*** HOLE CARDS ***
Dealt to Hero [7d 8h]
UTG: folds 
Hero: raises $7.50 to $12.50
Small Blind: folds 
Big Blind: calls $7.50
*** FLOP *** [7s 4h Td]
Big Blind: checks 
Hero: bets $7.84
Big Blind: calls $7.84
*** TURN *** [7s 4h Td] [4d]
Big Blind: bets $20.52
Hero: calls $20.52
*** RIVER *** [7s 4h Td 4d] [8d]
Big Blind: bets $60.92
Hero: calls $60.92
*** SHOW DOWN ***
Small Blind: shows [Jd 5d] (a hand...)
UTG: shows [3c Ad] (a hand...)
Big Blind: shows [4c Qh] (a hand...)
Hero: shows [7d 8h] (a hand...)
Big Blind collected $203.06 from pot
*** SUMMARY ***
Total pot $206.06 | Rake $3.00
Board [7s 4h Td 4d 8d]
Seat 1: Big Blind showed [4c Qh] and won ($203.06)
Seat 2: UTG folded
Seat 3: Hero showed [7d 8h] and lost with...
Seat 4: Small Blind folded



PokerStars Hand #3958756406:  Hold'em No Limit ($2.50/$5) - 2020/06/10 12:11:43 ET
Table '21719870' 9-max Seat #1 is the button
Seat 1: Dealer ($507.50 in chips) 
Seat 2: Small Blind ($513.58 in chips) 
Seat 3: Hero ($517.89 in chips) 
Seat 4: UTG ($1236.80 in chips) 
Seat 5: UTG+1 ($432.68 in chips) 
Small Blind: posts small blind $2.50
Hero: posts big blind $5
*** HOLE CARDS ***
Dealt to Hero [8s 9c]
UTG: folds 
UTG+1: folds 
Dealer: folds 
Small Blind: raises $10.00 to $15
Hero: calls $10
*** FLOP *** [Qh 2h 8c]
Small Blind: checks 
Hero: bets $8.55
Small Blind: calls $8.55
*** TURN *** [Qh 2h 8c] [5h]
Small Blind: checks 
Hero: checks 
*** RIVER *** [Qh 2h 8c 5h] [Js]
Small Blind: bets $17.38
Hero: calls $17.38
*** SHOW DOWN ***
Small Blind: shows [Th Qd] (a hand...)
Hero: shows [8s 9c] (a hand...)
Dealer: shows [3s Kc] (a hand...)
UTG: shows [5d 2d] (a hand...)
UTG+1: shows [4h 9s] (a hand...)
Small Blind collected $78.86 from pot
*** SUMMARY ***
Total pot $81.86 | Rake $3.00
Board [Qh 2h 8c 5h Js]
Seat 1: Dealer folded
Seat 2: Small Blind showed [Th Qd] and won ($78.86)
Seat 3: Hero showed [8s 9c] and lost with...
Seat 4: UTG folded
Seat 5: UTG+1 folded



PokerStars Hand #3958475715:  Hold'em No Limit ($2.50/$5) - 2020/06/09 21:33:44 ET
Table '21715124' 9-max Seat #1 is the button
Seat 1: Dealer ($500.00 in chips) 
Seat 2: Small Blind ($1063.61 in chips) 
Seat 3: Hero ($500.00 in chips) 
Seat 4: UTG ($860.22 in chips) 
Seat 5: UTG+1 ($537.36 in chips) 
Seat 6: UTG+2 ($492.50 in chips) 
Small Blind: posts small blind $2.50
Hero: posts big blind $5
*** HOLE CARDS ***
Dealt to Hero [Ac 8c]
UTG: raises $7.50 to $12.50
UTG+1: folds 
UTG+2: folds 
Dealer: folds 
Small Blind: folds 
Hero: calls $7.50
*** FLOP *** [7h 3h Jc]
Hero: checks 
UTG: bets $10
Hero: raises $28.60 to $38.60
UTG: calls $28.60
*** TURN *** [7h 3h Jc] [9h]
Hero: checks 
UTG: checks 
*** RIVER *** [7h 3h Jc 9h] [7d]
Hero: checks 
UTG: bets $30
Hero: folds 
*** SHOW DOWN ***
Small Blind: shows [3d 9c] (a hand...)
Hero: shows [Ac 8c] (a hand...)
Dealer: shows [Ts 8d] (a hand...)
UTG+2: shows [5s 3c] (a hand...)
UTG: shows [8s 7s] (a hand...)
UTG+1: shows [Tc 2h] (a hand...)
Uncalled bet ($30.00) returned to UTG
UTG collected $100.70 from pot
*** SUMMARY ***
Total pot $104.70 | Rake $4.00
Board [7h 3h Jc 9h 7d]
Seat 1: Dealer folded
Seat 2: Small Blind folded
Seat 3: Hero folded
Seat 4: UTG collected ($100.70)
Seat 5: UTG+1 folded
Seat 6: UTG+2 folded



PokerStars Hand #3958305222:  Hold'em No Limit ($2.50/$5) - 2020/06/09 15:07:55 ET
Table '21712440' 9-max Seat #3 is the button
Seat 1: UTG+1 ($562.51 in chips) 
Seat 2: UTG+2 ($519.60 in chips) 
Seat 3: Dealer ($257.50 in chips) 
Seat 4: Small Blind ($459.90 in chips) 
Seat 5: Hero ($955.76 in chips) 
Seat 6: UTG ($534.32 in chips) 
Small Blind: posts small blind $2.50
Hero: posts big blind $5
*** HOLE CARDS ***
Dealt to Hero [Ah Ad]
UTG: folds 
UTG+1: folds 
UTG+2: folds 
Dealer: folds 
Small Blind: calls $2.50
Hero: raises $15 to $20
Small Blind: calls $15
*** FLOP *** [2c Ac Ts]
Small Blind: checks 
Hero: bets $11.40
Small Blind: calls $11.40
*** TURN *** [2c Ac Ts] [8d]
Small Blind: checks 
Hero: bets $42.76
Small Blind: calls $42.76
*** RIVER *** [2c Ac Ts 8d] [Jc]
Small Blind: bets $144.32
Hero: calls $144.32
*** SHOW DOWN ***
Small Blind: shows [Tc Jd] (a hand...)
Hero: shows [Ah Ad] (a hand...)
Dealer: shows [4h 7c] (a hand...)
UTG+2: shows [9d 8c] (a hand...)
UTG: shows [3h 4s] (a hand...)
UTG+1: shows [3d 9h] (a hand...)
Hero collected $432.96 from pot
*** SUMMARY ***
Total pot $436.96 | Rake $4.00
Board [2c Ac Ts 8d Jc]
Seat 1: UTG+1 folded
Seat 2: UTG+2 folded
Seat 3: Dealer folded
Seat 4: Small Blind showed [Tc Jd] and lost with...
Seat 5: Hero showed [Ah Ad] and won ($432.96)
Seat 6: UTG folded



PokerStars Hand #3958304703:  Hold'em No Limit ($2.50/$5) - 2020/06/09 15:06:25 ET
Table '21710607' 9-max
Seat 1: Small Blind ($294.67 in chips) 
Seat 2: Big Blind ($958.56 in chips) 
Seat 3: UTG ($583.29 in chips) 
Seat 4: UTG+1 ($710.18 in chips) 
Seat 5: Hero ($505.00 in chips) 
Small Blind: posts small blind $2.50
Big Blind: posts big blind $5
*** HOLE CARDS ***
Dealt to Hero [Ad Ts]
UTG: folds 
UTG+1: folds 
Hero: raises $7.50 to $12.50
Small Blind: folds 
Big Blind: calls $7.50
*** FLOP *** [Kd 4h 9h]
Big Blind: checks 
Hero: checks 
*** TURN *** [Kd 4h 9h] [7s]
Big Blind: bets $8.75
Hero: calls $8.75
*** RIVER *** [Kd 4h 9h 7s] [Tc]
Big Blind: bets $129
Hero: folds 
*** SHOW DOWN ***
Small Blind: shows [7d 4c] (a hand...)
Big Blind: shows [Qc 6c] (a hand...)
Hero: shows [Ad Ts] (a hand...)
UTG: shows [9c 5d] (a hand...)
UTG+1: shows [2s 9d] (a hand...)
Uncalled bet ($129.00) returned to Big Blind
Big Blind collected $42.75 from pot
*** SUMMARY ***
Total pot $45.00 | Rake $2.25
Board [Kd 4h 9h 7s Tc]
Seat 1: Small Blind folded
Seat 2: Big Blind collected ($42.75)
Seat 3: UTG folded
Seat 4: UTG+1 folded
Seat 5: Hero folded



PokerStars Hand #3958301069:  Hold'em No Limit ($2.50/$5) - 2020/06/09 14:55:29 ET
Table '21711180' 9-max Seat #5 is the button
Seat 1: Small Blind ($567.25 in chips) 
Seat 2: Big Blind ($500.00 in chips) 
Seat 3: UTG ($500.00 in chips) 
Seat 4: UTG+1 ($514.83 in chips) 
Seat 5: Hero ($609.50 in chips) 
Small Blind: posts small blind $2.50
Big Blind: posts big blind $5
*** HOLE CARDS ***
Dealt to Hero [9d Ah]
UTG: folds 
UTG+1: folds 
Hero: raises $7.50 to $12.50
Small Blind: folds 
Big Blind: calls $7.50
*** FLOP *** [7h 6c 7s]
Big Blind: checks 
Hero: checks 
*** TURN *** [7h 6c 7s] [8s]
Big Blind: checks 
Hero: bets $8.07
Big Blind: raises $31.14 to $39.21
Hero: calls $31.14
*** RIVER *** [7h 6c 7s 8s] [9h]
Big Blind: bets $82.92
Hero: calls $82.92
*** SHOW DOWN ***
Small Blind: shows [Jd 6d] (a hand...)
Big Blind: shows [8c 7c] (a hand...)
Hero: shows [9d Ah] (a hand...)
UTG: shows [Ts Qc] (a hand...)
UTG+1: shows [Qd 2s] (a hand...)
Big Blind collected $268.76 from pot
*** SUMMARY ***
Total pot $271.76 | Rake $3.00
Board [7h 6c 7s 8s 9h]
Seat 1: Small Blind folded
Seat 2: Big Blind showed [8c 7c] and won ($268.76)
Seat 3: UTG folded
Seat 4: UTG+1 folded
Seat 5: Hero showed [9d Ah] and lost with...



PokerStars Hand #3958294302:  Hold'em No Limit ($2.50/$5) - 2020/06/09 14:35:02 ET
Table '21710607' 9-max Seat #3 is the button
Seat 1: Hero ($1274.44 in chips) 
Seat 2: UTG+2 ($916.83 in chips) 
Seat 3: Dealer ($562.50 in chips) 
Seat 4: Small Blind ($475.65 in chips) 
Seat 5: Big Blind ($500.00 in chips) 
Seat 6: UTG ($449.81 in chips) 
Small Blind: posts small blind $2.50
Big Blind: posts big blind $5
*** HOLE CARDS ***
Dealt to Hero [Kc As]
UTG: folds 
Hero: raises $7.50 to $12.50
UTG+2: folds 
Dealer: folds 
Small Blind: folds 
Big Blind: calls $7.50
*** FLOP *** [Js 4h 6h]
Big Blind: checks 
Hero: checks 
*** TURN *** [Js 4h 6h] [8h]
Big Blind: checks 
Hero: checks 
*** RIVER *** [Js 4h 6h 8h] [6c]
Big Blind: bets $24.60
Hero: folds 
*** SHOW DOWN ***
Small Blind: shows [Qc 7c] (a hand...)
Big Blind: shows [Kd 6d] (a hand...)
Hero: shows [Kc As] (a hand...)
Dealer: shows [2h Td] (a hand...)
UTG+2: shows [5d Qd] (a hand...)
UTG: shows [7d 9c] (a hand...)
Uncalled bet ($24.60) returned to Big Blind
Big Blind collected $26.13 from pot
*** SUMMARY ***
Total pot $27.50 | Rake $1.37
Board [Js 4h 6h 8h 6c]
Seat 1: Hero folded
Seat 2: UTG+2 folded
Seat 3: Dealer folded
Seat 4: Small Blind folded
Seat 5: Big Blind collected ($26.13)
Seat 6: UTG folded



PokerStars Hand #3958289055:  Hold'em No Limit ($2.50/$5) - 2020/06/09 14:18:37 ET
Table '21712312' 9-max Seat #2 is the button
Seat 1: UTG ($629.88 in chips) 
Seat 2: Dealer ($513.50 in chips) 
Seat 3: Small Blind ($437.98 in chips) 
Seat 4: Hero ($622.73 in chips) 
Small Blind: posts small blind $2.50
Hero: posts big blind $5
*** HOLE CARDS ***
Dealt to Hero [5s Kh]
UTG: folds 
Dealer: folds 
Small Blind: raises $5.00 to $10
Hero: calls $5
*** FLOP *** [Td As 6s]
Small Blind: checks 
Hero: checks 
*** TURN *** [Td As 6s] [5d]
Small Blind: checks 
Hero: checks 
*** RIVER *** [Td As 6s 5d] [Ts]
Small Blind: bets $10
Hero: calls $10
*** SHOW DOWN ***
Small Blind: shows [Qs Jh] (a hand...)
UTG: shows [8h 3c] (a hand...)
Dealer: shows [9d 2s] (a hand...)
Hero: shows [5s Kh] (a hand...)
Hero collected $38 from pot
*** SUMMARY ***
Total pot $40.00 | Rake $2.00
Board [Td As 6s 5d Ts]
Seat 1: UTG folded
Seat 2: Dealer folded
Seat 3: Small Blind showed [Qs Jh] and lost with...
Seat 4: Hero showed [5s Kh] and won ($38)



PokerStars Hand #3958288946:  Hold'em No Limit ($2.50/$5) - 2020/06/09 14:18:16 ET
Table '21712136' 9-max Seat #1 is the button
Seat 1: Dealer ($500.00 in chips) 
Seat 2: Small Blind ($840.25 in chips) 
Seat 3: Big Blind ($542.28 in chips) 
Seat 4: Hero ($640.46 in chips) 
Seat 5: UTG+1 ($520.25 in chips) 
Small Blind: posts small blind $2.50
Big Blind: posts big blind $5
*** HOLE CARDS ***
Dealt to Hero [Jc Jd]
Hero: raises $7.50 to $12.50
UTG+1: folds 
Dealer: folds 
Small Blind: raises $47.50 to $60
Big Blind: folds 
Hero: calls $47.50
*** FLOP *** [Qs 9c 8d]
Small Blind: checks 
Hero: checks 
*** TURN *** [Qs 9c 8d] [4h]
Small Blind: bets $71.50
Hero: calls $71.50
*** RIVER *** [Qs 9c 8d 4h] [6c]
Small Blind: bets $208.75
Hero: folds 
*** SHOW DOWN ***
Small Blind: shows [7h 8h] (a hand...)
Big Blind: shows [2s 4c] (a hand...)
Hero: shows [Jc Jd] (a hand...)
Dealer: shows [Kd 4d] (a hand...)
UTG+1: shows [3d Qh] (a hand...)
Uncalled bet ($208.75) returned to Small Blind
Small Blind collected $265 from pot
*** SUMMARY ***
Total pot $268.00 | Rake $3.00
Board [Qs 9c 8d 4h 6c]
Seat 1: Dealer folded
Seat 2: Small Blind collected ($265)
Seat 3: Big Blind folded
Seat 4: Hero folded
Seat 5: UTG+1 folded



PokerStars Hand #3958286180:  Hold'em No Limit ($2.50/$5) - 2020/06/09 14:09:41 ET
Table '21712312' 9-max Seat #1 is the button
Seat 1: Dealer ($500.00 in chips) 
Seat 2: Small Blind ($761.48 in chips) 
Seat 3: Hero ($619.50 in chips) 
Seat 4: UTG ($505.00 in chips) 
Small Blind: posts small blind $2.50
Hero: posts big blind $5
*** HOLE CARDS ***
Dealt to Hero [6s 6h]
UTG: folds 
Dealer: folds 
Small Blind: raises $5.00 to $10
Hero: calls $5
*** FLOP *** [4s 8d 3c]
Small Blind: bets $14.25
Hero: calls $14.25
*** TURN *** [4s 8d 3c] [Ad]
Small Blind: bets $23.04
Hero: calls $23.04
*** RIVER *** [4s 8d 3c Ad] [5d]
Small Blind: bets $45.79
Hero: folds 
*** SHOW DOWN ***
Small Blind: shows [4h As] (a hand...)
UTG: shows [7c 2d] (a hand...)
Dealer: shows [4d 2s] (a hand...)
Hero: shows [6s 6h] (a hand...)
Uncalled bet ($45.79) returned to Small Blind
Small Blind collected $91.58 from pot
*** SUMMARY ***
Total pot $94.58 | Rake $3.00
Board [4s 8d 3c Ad 5d]
Seat 1: Dealer folded
Seat 2: Small Blind collected ($91.58)
Seat 3: Hero folded
Seat 4: UTG folded



PokerStars Hand #3958285449:  Hold'em No Limit ($2.50/$5) - 2020/06/09 14:07:31 ET
Table '21712440' 9-max Seat #5 is the button
Seat 1: Small Blind ($508.00 in chips) 
Seat 2: Big Blind ($508.08 in chips) 
Seat 3: UTG ($376.55 in chips) 
Seat 4: Hero ($525.00 in chips) 
Seat 5: Dealer ($299.22 in chips) 
Small Blind: posts small blind $2.50
Big Blind: posts big blind $5
*** HOLE CARDS ***
Dealt to Hero [8h 8s]
UTG: folds 
Hero: raises $7.50 to $12.50
Dealer: folds 
Small Blind: calls $10
Big Blind: folds 
*** FLOP *** [4h 7s 6h]
Small Blind: bets $10
Hero: raises $28.25 to $38.25
Small Blind: calls $28.25
*** TURN *** [4h 7s 6h] [Js]
Small Blind: checks 
Hero: bets $77.63
Small Blind: calls $77.63
*** RIVER *** [4h 7s 6h Js] [Kh]
Small Blind: bets $154.38
Hero: calls $154.38
*** SHOW DOWN ***
Small Blind: shows [4s 3s] (a hand...)
Big Blind: shows [Ts 2c] (a hand...)
Hero: shows [8h 8s] (a hand...)
Dealer: shows [8c Th] (a hand...)
UTG: shows [3h 9h] (a hand...)
Hero collected $567.52 from pot
*** SUMMARY ***
Total pot $570.52 | Rake $3.00
Board [4h 7s 6h Js Kh]
Seat 1: Small Blind showed [4s 3s] and lost with...
Seat 2: Big Blind folded
Seat 3: UTG folded
Seat 4: Hero showed [8h 8s] and won ($567.52)
Seat 5: Dealer folded



PokerStars Hand #3958280139:  Hold'em No Limit ($2.50/$5) - 2020/06/09 13:51:27 ET
Table '21712440' 9-max Seat #6 is the button
Seat 1: Small Blind ($533.00 in chips) 
Seat 2: Big Blind ($146.21 in chips) 
Seat 3: UTG ($513.13 in chips) 
Seat 4: UTG+1 ($412.55 in chips) 
Seat 5: Hero ($497.70 in chips) 
Seat 6: Dealer ($324.60 in chips) 
Small Blind: posts small blind $2.50
Big Blind: posts big blind $5
*** HOLE CARDS ***
Dealt to Hero [Jh Kc]
UTG: folds 
UTG+1: folds 
Hero: raises $7.50 to $12.50
Dealer: calls $12.50
Small Blind: calls $10
Big Blind: calls $7.50
*** FLOP *** [Ts Ah 9d]
Small Blind: checks 
Big Blind: checks 
Hero: checks 
Dealer: checks 
*** TURN *** [Ts Ah 9d] [5c]
Small Blind: checks 
Big Blind: checks 
Hero: checks 
Dealer: checks 
*** RIVER *** [Ts Ah 9d 5c] [Td]
Small Blind: checks 
Big Blind: bets $23.98
Hero: folds 
Dealer: folds 
Small Blind: folds 
*** SHOW DOWN ***
Small Blind: shows [Qd 4d] (a hand...)
Big Blind: shows [6c 7s] (a hand...)
Hero: shows [Jh Kc] (a hand...)
Dealer: shows [Kd 2d] (a hand...)
UTG: shows [4s 2h] (a hand...)
UTG+1: shows [Ad 6s] (a hand...)
Uncalled bet ($23.98) returned to Big Blind
Big Blind collected $47.50 from pot
*** SUMMARY ***
Total pot $50.00 | Rake $2.50
Board [Ts Ah 9d 5c Td]
Seat 1: Small Blind folded
Seat 2: Big Blind collected ($47.50)
Seat 3: UTG folded
Seat 4: UTG+1 folded
Seat 5: Hero folded
Seat 6: Dealer folded



PokerStars Hand #3958278421:  Hold'em No Limit ($2.50/$5) - 2020/06/09 13:46:03 ET
Table '21712312' 9-max Seat #2 is the button
Seat 1: UTG+1 ($500.00 in chips) 
Seat 2: Dealer ($475.00 in chips) 
Seat 3: Small Blind ($495.00 in chips) 
Seat 4: Hero ($563.38 in chips) 
Seat 5: UTG ($492.50 in chips) 
Small Blind: posts small blind $2.50
Hero: posts big blind $5
*** HOLE CARDS ***
Dealt to Hero [Ah Qd]
UTG: folds 
UTG+1: folds 
Dealer: folds 
Small Blind: calls $2.50
Hero: raises $15 to $20
Small Blind: calls $15
*** FLOP *** [Tc Js Qs]
Small Blind: checks 
Hero: bets $25
Small Blind: calls $25
*** TURN *** [Tc Js Qs] [Ac]
Small Blind: checks 
Hero: checks 
*** RIVER *** [Tc Js Qs Ac] [2d]
Small Blind: bets $48.50
Hero: calls $48.50
*** SHOW DOWN ***
Small Blind: shows [3h Kh] (a hand...)
Hero: shows [Ah Qd] (a hand...)
Dealer: shows [7h 9h] (a hand...)
UTG: shows [3c 8h] (a hand...)
UTG+1: shows [5h 8c] (a hand...)
Small Blind collected $184 from pot
*** SUMMARY ***
Total pot $187.00 | Rake $3.00
Board [Tc Js Qs Ac 2d]
Seat 1: UTG+1 folded
Seat 2: Dealer folded
Seat 3: Small Blind showed [3h Kh] and won ($184)
Seat 4: Hero showed [Ah Qd] and lost with...
Seat 5: UTG folded



PokerStars Hand #3958276858:  Hold'em No Limit ($2.50/$5) - 2020/06/09 13:41:13 ET
Table '21712312' 9-max Seat #3 is the button
Seat 1: UTG ($505.00 in chips) 
Seat 2: UTG+1 ($492.50 in chips) 
Seat 3: Dealer ($490.00 in chips) 
Seat 4: Small Blind ($159.38 in chips) 
Seat 5: Hero ($516.50 in chips) 
Small Blind: posts small blind $2.50
Hero: posts big blind $5
*** HOLE CARDS ***
Dealt to Hero [Qh Ks]
UTG: folds 
UTG+1: folds 
Dealer: folds 
Small Blind: raises $11.02 to $16.02
Hero: calls $11.02
*** FLOP *** [Ac Js Kc]
Small Blind: bets $17.73
Hero: calls $17.73
*** TURN *** [Ac Js Kc] [5d]
Small Blind: checks 
Hero: checks 
*** RIVER *** [Ac Js Kc 5d] [7d]
Small Blind: bets $5
Hero: calls $5
*** SHOW DOWN ***
Small Blind: shows [9s Jd] (a hand...)
Hero: shows [Qh Ks] (a hand...)
Dealer: shows [5h 9h] (a hand...)
UTG: shows [3h Ad] (a hand...)
UTG+1: shows [8h 2c] (a hand...)
Hero collected $74.50 from pot
*** SUMMARY ***
Total pot $77.50 | Rake $3.00
Board [Ac Js Kc 5d 7d]
Seat 1: UTG folded
Seat 2: UTG+1 folded
Seat 3: Dealer folded
Seat 4: Small Blind showed [9s Jd] and lost with...
Seat 5: Hero showed [Qh Ks] and won ($74.50)



PokerStars Hand #3958237227:  Hold'em No Limit ($2.50/$5) - 2020/06/09 11:19:15 ET
Table '21707514' 9-max Seat #5 is the button
Seat 1: Big Blind ($897.95 in chips) 
Seat 2: UTG ($493.85 in chips) 
Seat 3: UTG+1 ($506.00 in chips) 
Seat 4: UTG+2 ($511.50 in chips) 
Seat 5: Hero ($519.33 in chips) 
Seat 6: Small Blind ($517.50 in chips) 
Small Blind: posts small blind $2.50
Big Blind: posts big blind $5
*** HOLE CARDS ***
Dealt to Hero [Kd Ah]
UTG: folds 
UTG+1: raises $10 to $15
UTG+2: folds 
Hero: raises $35 to $50
Small Blind: folds 
Big Blind: folds 
UTG+1: calls $35
*** FLOP *** [8d Kh 5s]
UTG+1: checks 
Hero: bets $31.05
UTG+1: raises $44.95 to $76
Hero: calls $44.95
*** TURN *** [8d Kh 5s] [Jh]
UTG+1: bets $95
Hero: calls $95
*** RIVER *** [8d Kh 5s Jh] [Qd]
UTG+1: bets $285 and is all-in
Hero: folds 
*** SHOW DOWN ***
Small Blind: shows [7c 8c] (a hand...)
Big Blind: shows [5h 2c] (a hand...)
Hero: shows [Kd Ah] (a hand...)
UTG+2: shows [3d 8h] (a hand...)
UTG: shows [Jc 2h] (a hand...)
UTG+1: shows [3h 3c] (a hand...)
Uncalled bet ($285.00) returned to UTG+1
UTG+1 collected $445.50 from pot
*** SUMMARY ***
Total pot $449.50 | Rake $4.00
Board [8d Kh 5s Jh Qd]
Seat 1: Big Blind folded
Seat 2: UTG folded
Seat 3: UTG+1 collected ($445.50)
Seat 4: UTG+2 folded
Seat 5: Hero folded
Seat 6: Small Blind folded



PokerStars Hand #3958235814:  Hold'em No Limit ($2.50/$5) - 2020/06/09 11:12:57 ET
Table '21711501' 9-max Seat #6 is the button
Seat 1: Small Blind ($574.61 in chips) 
Seat 2: Hero ($552.88 in chips) 
Seat 3: UTG ($471.40 in chips) 
Seat 4: UTG+1 ($408.45 in chips) 
Seat 5: UTG+2 ($474.18 in chips) 
Seat 6: Dealer ($470.00 in chips) 
Small Blind: posts small blind $2.50
Hero: posts big blind $5
*** HOLE CARDS ***
Dealt to Hero [2c Qd]
UTG: folds 
UTG+1: folds 
UTG+2: calls $5
Dealer: folds 
Small Blind: calls $2.50
Hero: checks 
*** FLOP *** [9c 6s Qs]
Small Blind: bets $7.13
Hero: calls $7.13
UTG+2: folds 
*** TURN *** [9c 6s Qs] [9d]
Small Blind: bets $13.90
Hero: calls $13.90
*** RIVER *** [9c 6s Qs 9d] [8c]
Small Blind: bets $40.66
Hero: calls $40.66
*** SHOW DOWN ***
Small Blind: shows [Td Js] (a hand...)
Hero: shows [2c Qd] (a hand...)
UTG+2: shows [Ad 7h] (a hand...)
Dealer: shows [3h Tc] (a hand...)
UTG: shows [2s 9s] (a hand...)
UTG+1: shows [7d 5s] (a hand...)
Small Blind collected $134.38 from pot
*** SUMMARY ***
Total pot $138.38 | Rake $4.00
Board [9c 6s Qs 9d 8c]
Seat 1: Small Blind showed [Td Js] and won ($134.38)
Seat 2: Hero showed [2c Qd] and lost with...
Seat 3: UTG folded
Seat 4: UTG+1 folded
Seat 5: UTG+2 folded
Seat 6: Dealer folded



PokerStars Hand #3958234205:  Hold'em No Limit ($2.50/$5) - 2020/06/09 11:05:27 ET
Table '21711501' 9-max Seat #5 is the button
Seat 1: Small Blind ($509.75 in chips) 
Seat 2: Hero ($587.88 in chips) 
Seat 3: UTG ($369.50 in chips) 
Seat 4: UTG+1 ($513.13 in chips) 
Seat 5: Dealer ($485.00 in chips) 
Small Blind: posts small blind $2.50
Hero: posts big blind $5
*** HOLE CARDS ***
Dealt to Hero [5c 9c]
UTG: calls $5
UTG+1: folds 
Dealer: folds 
Small Blind: calls $2.50
Hero: checks 
*** FLOP *** [6c 5s Jc]
Small Blind: checks 
Hero: checks 
UTG: bets $10
Small Blind: folds 
Hero: calls $10
*** TURN *** [6c 5s Jc] [6s]
Hero: checks 
UTG: bets $10
Hero: calls $10
*** RIVER *** [6c 5s Jc 6s] [Ts]
Hero: checks 
UTG: bets $25
Hero: folds 
*** SHOW DOWN ***
Small Blind: shows [Tc 6d] (a hand...)
Hero: shows [5c 9c] (a hand...)
Dealer: shows [5d 8d] (a hand...)
UTG: shows [2h Kc] (a hand...)
UTG+1: shows [9s 3h] (a hand...)
Uncalled bet ($25) returned to UTG
UTG collected $52.25 from pot
*** SUMMARY ***
Total pot $55.00 | Rake $2.75
Board [6c 5s Jc 6s Ts]
Seat 1: Small Blind folded
Seat 2: Hero folded
Seat 3: UTG collected ($52.25)
Seat 4: UTG+1 folded
Seat 5: Dealer folded



PokerStars Hand #3958232105:  Hold'em No Limit ($2.50/$5) - 2020/06/09 10:55:33 ET
Table '21711501' 9-max Seat #3 is the button
Seat 1: Small Blind ($535.00 in chips) 
Seat 2: Hero ($500.00 in chips) 
Seat 3: Dealer ($275.50 in chips) 
Small Blind: posts small blind $2.50
Hero: posts big blind $5
*** HOLE CARDS ***
Dealt to Hero [8c 5c]
Dealer: folds 
Small Blind: raises $10.00 to $15
Hero: calls $10
*** FLOP *** [2h Tc 9h]
Small Blind: bets $10
Hero: raises $24.25 to $34.25
Small Blind: calls $24.25
*** TURN *** [2h Tc 9h] [Ks]
Small Blind: checks 
Hero: checks 
*** RIVER *** [2h Tc 9h Ks] [3s]
Small Blind: bets $69
Hero: folds 
*** SHOW DOWN ***
Small Blind: shows [4h 6h] (a hand...)
Dealer: shows [6s 9c] (a hand...)
Hero: shows [8c 5c] (a hand...)
Uncalled bet ($69.00) returned to Small Blind
Small Blind collected $96.50 from pot
*** SUMMARY ***
Total pot $98.50 | Rake $2.00
Board [2h Tc 9h Ks 3s]
Seat 1: Small Blind collected ($96.50)
Seat 2: Hero folded
Seat 3: Dealer folded



PokerStars Hand #3957974587:  Hold'em No Limit ($2.50/$5) - 2020/06/08 21:13:39 ET
Table '21707505' 9-max Seat #2 is the button
Seat 1: Hero ($500.00 in chips) 
Seat 2: Dealer ($517.50 in chips) 
Dealer: posts small blind $2.50
Hero: posts big blind $5
*** HOLE CARDS ***
Dealt to Hero [3c Kc]
Dealer: raises $7.00 to $12
Hero: calls $7
*** FLOP *** [8c 4s Ks]
Hero: checks 
Dealer: bets $10
Hero: calls $10
*** TURN *** [8c 4s Ks] [Js]
Hero: checks 
Dealer: checks 
*** RIVER *** [8c 4s Ks Js] [Qs]
Hero: checks 
Dealer: bets $32.25
Hero: folds 
*** SHOW DOWN ***
Dealer: shows [7s 9h] (a hand...)
Hero: shows [3c Kc] (a hand...)
Uncalled bet ($32.25) returned to Dealer
Dealer collected $43 from pot
*** SUMMARY ***
Total pot $44.00 | Rake $1.00
Board [8c 4s Ks Js Qs]
Seat 1: Hero folded
Seat 2: Dealer collected ($43)



PokerStars Hand #3956293431:  Hold'em No Limit ($2.50/$5) - 2020/06/05 14:39:14 ET
Table '21674366' 9-max Seat #3 is the button
Seat 1: Hero ($492.50 in chips) 
Seat 2: UTG+2 ($662.50 in chips) 
Seat 3: Dealer ($511.75 in chips) 
Seat 4: Small Blind ($495.00 in chips) 
Seat 5: Big Blind ($500.00 in chips) 
Seat 6: UTG ($557.39 in chips) 
Small Blind: posts small blind $2.50
Big Blind: posts big blind $5
*** HOLE CARDS ***
Dealt to Hero [As Qs]
UTG: folds 
Hero: raises $7.50 to $12.50
UTG+2: folds 
Dealer: folds 
Small Blind: folds 
Big Blind: calls $7.50
*** FLOP *** [2c Jd 5d]
Big Blind: checks 
Hero: bets $7.84
Big Blind: raises $26.36 to $34.20
Hero: calls $26.36
*** TURN *** [2c Jd 5d] [Ah]
Big Blind: bets $68.93
Hero: calls $68.93
*** RIVER *** [2c Jd 5d Ah] [7h]
Big Blind: bets $384.37 and is all-in
Hero: calls $376.87 and is all-in
*** SHOW DOWN ***
Small Blind: shows [Th 5h] (a hand...)
Big Blind: shows [3d 4d] (a hand...)
Hero: shows [As Qs] (a hand...)
Dealer: shows [6h 2s] (a hand...)
UTG+2: shows [Qh 9c] (a hand...)
UTG: shows [9d Ac] (a hand...)
Uncalled bet ($7.50) returned to Big Blind
Big Blind collected $983.50 from pot
*** SUMMARY ***
Total pot $987.50 | Rake $4.00
Board [2c Jd 5d Ah 7h]
Seat 1: Hero showed [As Qs] and lost with...
Seat 2: UTG+2 folded
Seat 3: Dealer folded
Seat 4: Small Blind folded
Seat 5: Big Blind showed [3d 4d] and won ($983.50)
Seat 6: UTG folded



PokerStars Hand #3956292586:  Hold'em No Limit ($2.50/$5) - 2020/06/05 14:36:46 ET
Table '21674015' 9-max Seat #2 is the button
Seat 1: UTG+2 ($632.88 in chips) 
Seat 2: Dealer ($749.35 in chips) 
Seat 3: Small Blind ($512.50 in chips) 
Seat 4: Big Blind ($585.03 in chips) 
Seat 5: Hero ($512.50 in chips) 
Seat 6: UTG+1 ($478.75 in chips) 
Small Blind: posts small blind $2.50
Big Blind: posts big blind $5
*** HOLE CARDS ***
Dealt to Hero [9d Kd]
Hero: raises $7.50 to $12.50
UTG+1: folds 
UTG+2: calls $12.50
Dealer: folds 
Small Blind: folds 
Big Blind: calls $7.50
*** FLOP *** [Th 2s 9h]
Big Blind: checks 
Hero: checks 
UTG+2: checks 
*** TURN *** [Th 2s 9h] [Qc]
Big Blind: checks 
Hero: checks 
UTG+2: checks 
*** RIVER *** [Th 2s 9h Qc] [Qs]
Big Blind: checks 
Hero: bets $22
UTG+2: raises $81.50 to $103.50
Big Blind: folds 
Hero: folds 
*** SHOW DOWN ***
Small Blind: shows [Kh 2d] (a hand...)
Big Blind: shows [6d 4h] (a hand...)
Hero: shows [9d Kd] (a hand...)
Dealer: shows [6s Jc] (a hand...)
UTG+2: shows [Qh Ac] (a hand...)
UTG+1: shows [Ks 5c] (a hand...)
Uncalled bet ($81.50) returned to UTG+2
UTG+2 collected $80 from pot
*** SUMMARY ***
Total pot $84.00 | Rake $4.00
Board [Th 2s 9h Qc Qs]
Seat 1: UTG+2 collected ($80)
Seat 2: Dealer folded
Seat 3: Small Blind folded
Seat 4: Big Blind folded
Seat 5: Hero folded
Seat 6: UTG+1 folded



PokerStars Hand #3955025114:  Hold'em No Limit ($2.50/$5) - 2020/06/02 22:26:17 ET
Table '21648085' 9-max Seat #4 is the button
Seat 1: Hero ($870.02 in chips) 
Seat 2: UTG+1 ($529.61 in chips) 
Seat 3: UTG+2 ($490.00 in chips) 
Seat 4: Dealer ($533.90 in chips) 
Seat 5: Small Blind ($607.37 in chips) 
Seat 6: Big Blind ($524.23 in chips) 
Small Blind: posts small blind $2.50
Big Blind: posts big blind $5
*** HOLE CARDS ***
Dealt to Hero [Ad Qd]
Hero: raises $7.50 to $12.50
UTG+1: folds 
UTG+2: folds 
Dealer: folds 
Small Blind: calls $10
Big Blind: folds 
*** FLOP *** [8h 5c 8c]
Small Blind: checks 
Hero: checks 
*** TURN *** [8h 5c 8c] [6s]
Small Blind: checks 
Hero: checks 
*** RIVER *** [8h 5c 8c 6s] [Th]
Small Blind: bets $14.25
Hero: folds 
*** SHOW DOWN ***
Small Blind: shows [Ah Td] (a hand...)
Big Blind: shows [Tc 4s] (a hand...)
Hero: shows [Ad Qd] (a hand...)
Dealer: shows [Qs 7h] (a hand...)
UTG+2: shows [3c 5d] (a hand...)
UTG+1: shows [2s 8s] (a hand...)
Uncalled bet ($14.25) returned to Small Blind
Small Blind collected $28.50 from pot
*** SUMMARY ***
Total pot $30.00 | Rake $1.50
Board [8h 5c 8c 6s Th]
Seat 1: Hero folded
Seat 2: UTG+1 folded
Seat 3: UTG+2 folded
Seat 4: Dealer folded
Seat 5: Small Blind collected ($28.50)
Seat 6: Big Blind folded



PokerStars Hand #3955022145:  Hold'em No Limit ($2.50/$5) - 2020/06/02 22:21:11 ET
Table '21647490' 9-max Seat #5 is the button
Seat 1: Big Blind ($415.51 in chips) 
Seat 2: UTG ($774.16 in chips) 
Seat 3: Hero ($660.02 in chips) 
Seat 4: UTG+2 ($753.28 in chips) 
Seat 5: Dealer ($173.11 in chips) 
Seat 6: Small Blind ($499.25 in chips) 
Small Blind: posts small blind $2.50
Big Blind: posts big blind $5
*** HOLE CARDS ***
Dealt to Hero [9c 9d]
UTG: folds 
Hero: raises $7.50 to $12.50
UTG+2: calls $12.50
Dealer: folds 
Small Blind: calls $10
Big Blind: calls $7.50
*** FLOP *** [6c 2c 4c]
Small Blind: checks 
Big Blind: checks 
Hero: checks 
UTG+2: checks 
*** TURN *** [6c 2c 4c] [3d]
Small Blind: checks 
Big Blind: checks 
Hero: checks 
UTG+2: checks 
*** RIVER *** [6c 2c 4c 3d] [4d]
Small Blind: checks 
Big Blind: bets $30
Hero: calls $30
UTG+2: folds 
Small Blind: folds 
*** SHOW DOWN ***
Small Blind: shows [8h Ah] (a hand...)
Big Blind: shows [8d Kd] (a hand...)
Hero: shows [9c 9d] (a hand...)
Dealer: shows [7d Kc] (a hand...)
UTG+2: shows [Td 9s] (a hand...)
UTG: shows [7s Jh] (a hand...)
Hero collected $106 from pot
*** SUMMARY ***
Total pot $110.00 | Rake $4.00
Board [6c 2c 4c 3d 4d]
Seat 1: Big Blind showed [8d Kd] and lost with...
Seat 2: UTG folded
Seat 3: Hero showed [9c 9d] and won ($106)
Seat 4: UTG+2 folded
Seat 5: Dealer folded
Seat 6: Small Blind folded



PokerStars Hand #3955018140:  Hold'em No Limit ($2.50/$5) - 2020/06/02 22:14:20 ET
Table '21647490' 9-max Seat #6 is the button
Seat 1: Small Blind ($374.01 in chips) 
Seat 2: Big Blind ($667.55 in chips) 
Seat 3: Hero ($710.77 in chips) 
Seat 4: UTG+1 ($851.39 in chips) 
Seat 5: UTG+2 ($180.61 in chips) 
Seat 6: Dealer ($502.50 in chips) 
Small Blind: posts small blind $2.50
Big Blind: posts big blind $5
*** HOLE CARDS ***
Dealt to Hero [Ac Ts]
Hero: raises $7.50 to $12.50
UTG+1: folds 
UTG+2: folds 
Dealer: folds 
Small Blind: calls $10
Big Blind: folds 
*** FLOP *** [6h 8s 2h]
Small Blind: checks 
Hero: checks 
*** TURN *** [6h 8s 2h] [5d]
Small Blind: checks 
Hero: checks 
*** RIVER *** [6h 8s 2h 5d] [3s]
Small Blind: bets $20
Hero: calls $20
*** SHOW DOWN ***
Small Blind: shows [4d Jd] (a hand...)
Big Blind: shows [Js 2d] (a hand...)
Hero: shows [Ac Ts] (a hand...)
UTG+2: shows [4h Tc] (a hand...)
Dealer: shows [7c Kh] (a hand...)
UTG+1: shows [Jc 3d] (a hand...)
Small Blind collected $66.50 from pot
*** SUMMARY ***
Total pot $70.00 | Rake $3.50
Board [6h 8s 2h 5d 3s]
Seat 1: Small Blind showed [4d Jd] and won ($66.50)
Seat 2: Big Blind folded
Seat 3: Hero showed [Ac Ts] and lost with...
Seat 4: UTG+1 folded
Seat 5: UTG+2 folded
Seat 6: Dealer folded



PokerStars Hand #3955017508:  Hold'em No Limit ($2.50/$5) - 2020/06/02 22:13:15 ET
Table '21647609' 9-max Seat #1 is the button
Seat 1: Dealer ($500.00 in chips) 
Seat 2: Small Blind ($331.28 in chips) 
Seat 3: Hero ($437.96 in chips) 
Seat 4: UTG ($485.82 in chips) 
Seat 5: UTG+1 ($528.16 in chips) 
Seat 6: UTG+2 ($323.83 in chips) 
Small Blind: posts small blind $2.50
Hero: posts big blind $5
*** HOLE CARDS ***
Dealt to Hero [Ks 8h]
UTG: folds 
UTG+1: folds 
UTG+2: folds 
Dealer: folds 
Small Blind: calls $2.50
Hero: checks 
*** FLOP *** [3h 7d 6h]
Small Blind: checks 
Hero: checks 
*** TURN *** [3h 7d 6h] [3c]
Small Blind: checks 
Hero: checks 
*** RIVER *** [3h 7d 6h 3c] [7s]
Small Blind: bets $5
Hero: calls $5
*** SHOW DOWN ***
Small Blind: shows [9h Kc] (a hand...)
Hero: shows [Ks 8h] (a hand...)
Dealer: shows [4c 5s] (a hand...)
UTG+2: shows [Kd 2d] (a hand...)
UTG: shows [2s Qd] (a hand...)
UTG+1: shows [8s 7c] (a hand...)
Small Blind collected $9.50 from pot
Hero collected $9.50 from pot
*** SUMMARY ***
Total pot $20.00 | Rake $1.00
Board [3h 7d 6h 3c 7s]
Seat 1: Dealer folded
Seat 2: Small Blind showed [9h Kc] and won ($9.50)
Seat 3: Hero showed [Ks 8h] and won ($9.50)
Seat 4: UTG folded
Seat 5: UTG+1 folded
Seat 6: UTG+2 folded



PokerStars Hand #3955014477:  Hold'em No Limit ($2.50/$5) - 2020/06/02 22:07:56 ET
Table '21648085' 9-max Seat #2 is the button
Seat 1: Hero ($866.89 in chips) 
Seat 2: Dealer ($595.55 in chips) 
Seat 3: Small Blind ($817.39 in chips) 
Seat 4: Big Blind ($477.50 in chips) 
Seat 5: UTG ($426.79 in chips) 
Seat 6: UTG+1 ($512.73 in chips) 
Small Blind: posts small blind $2.50
Big Blind: posts big blind $5
*** HOLE CARDS ***
Dealt to Hero [7h 8h]
UTG: raises $10 to $15
UTG+1: folds 
Hero: raises $30 to $45
Dealer: folds 
Small Blind: folds 
Big Blind: folds 
UTG: calls $30
*** FLOP *** [9d Ah Kh]
UTG: checks 
Hero: bets $55
UTG: calls $55
*** TURN *** [9d Ah Kh] [4s]
UTG: checks 
Hero: checks 
*** RIVER *** [9d Ah Kh 4s] [Js]
UTG: bets $101.75
Hero: folds 
*** SHOW DOWN ***
Small Blind: shows [Qc 6s] (a hand...)
Big Blind: shows [5s Kd] (a hand...)
Hero: shows [7h 8h] (a hand...)
Dealer: shows [5c 6d] (a hand...)
UTG: shows [Qs Ac] (a hand...)
UTG+1: shows [7d Jc] (a hand...)
Uncalled bet ($101.75) returned to UTG
UTG collected $203.50 from pot
*** SUMMARY ***
Total pot $207.50 | Rake $4.00
Board [9d Ah Kh 4s Js]
Seat 1: Hero folded
Seat 2: Dealer folded
Seat 3: Small Blind folded
Seat 4: Big Blind folded
Seat 5: UTG collected ($203.50)
Seat 6: UTG+1 folded



PokerStars Hand #3955011747:  Hold'em No Limit ($2.50/$5) - 2020/06/02 22:03:08 ET
Table '21647490' 9-max Seat #1 is the button
Seat 1: Hero ($790.77 in chips) 
Seat 2: Small Blind ($923.06 in chips) 
Seat 3: Big Blind ($172.00 in chips) 
Seat 4: UTG ($497.50 in chips) 
Small Blind: posts small blind $2.50
Big Blind: posts big blind $5
*** HOLE CARDS ***
Dealt to Hero [5c 5s]
UTG: folds 
Hero: raises $7.50 to $12.50
Small Blind: folds 
Big Blind: calls $7.50
*** FLOP *** [4s Ad 6c]
Big Blind: bets $15
Hero: raises $15 to $30
Big Blind: calls $15
*** TURN *** [4s Ad 6c] [Qh]
Big Blind: checks 
Hero: checks 
*** RIVER *** [4s Ad 6c Qh] [7d]
Big Blind: bets $5
Hero: calls $5
*** SHOW DOWN ***
Small Blind: shows [5h 2c] (a hand...)
UTG: shows [9s Qc] (a hand...)
Big Blind: shows [6d Kh] (a hand...)
Hero: shows [5c 5s] (a hand...)
Big Blind collected $94.50 from pot
*** SUMMARY ***
Total pot $97.50 | Rake $3.00
Board [4s Ad 6c Qh 7d]
Seat 1: Hero showed [5c 5s] and lost with...
Seat 2: Small Blind folded
Seat 3: Big Blind showed [6d Kh] and won ($94.50)
Seat 4: UTG folded



PokerStars Hand #3955008833:  Hold'em No Limit ($2.50/$5) - 2020/06/02 21:57:59 ET
Table '21647609' 9-max Seat #3 is the button
Seat 1: UTG+1 ($542.59 in chips) 
Seat 2: UTG+2 ($189.00 in chips) 
Seat 3: Hero ($514.87 in chips) 
Seat 4: Small Blind ($359.86 in chips) 
Seat 5: Big Blind ($523.61 in chips) 
Seat 6: UTG ($700.77 in chips) 
Small Blind: posts small blind $2.50
Big Blind: posts big blind $5
*** HOLE CARDS ***
Dealt to Hero [7h 7d]
UTG: folds 
UTG+1: folds 
UTG+2: folds 
Hero: raises $7.50 to $12.50
Small Blind: calls $10
Big Blind: folds 
*** FLOP *** [4c 4d 8d]
Small Blind: checks 
Hero: checks 
*** TURN *** [4c 4d 8d] [Th]
Small Blind: checks 
Hero: bets $14.25
Small Blind: calls $14.25
*** RIVER *** [4c 4d 8d Th] [2h]
Small Blind: bets $55.58
Hero: calls $55.58
*** SHOW DOWN ***
Small Blind: shows [2s 2d] (a hand...)
Big Blind: shows [6h Qd] (a hand...)
Hero: shows [7h 7d] (a hand...)
UTG+2: shows [Jc 4h] (a hand...)
UTG: shows [3c Ad] (a hand...)
UTG+1: shows [Kd 7c] (a hand...)
Small Blind collected $165.66 from pot
*** SUMMARY ***
Total pot $169.66 | Rake $4.00
Board [4c 4d 8d Th 2h]
Seat 1: UTG+1 folded
Seat 2: UTG+2 folded
Seat 3: Hero showed [7h 7d] and lost with...
Seat 4: Small Blind showed [2s 2d] and won ($165.66)
Seat 5: Big Blind folded
Seat 6: UTG folded



PokerStars Hand #3954993963:  Hold'em No Limit ($2.50/$5) - 2020/06/02 21:31:44 ET
Table '21647490' 9-max Seat #1 is the button
Seat 1: Dealer ($272.89 in chips) 
Seat 2: Small Blind ($666.52 in chips) 
Seat 3: Hero ($787.83 in chips) 
Seat 4: UTG ($141.24 in chips) 
Seat 5: UTG+1 ($500.00 in chips) 
Seat 6: UTG+2 ($394.88 in chips) 
Small Blind: posts small blind $2.50
Hero: posts big blind $5
*** HOLE CARDS ***
Dealt to Hero [3h 3d]
UTG: folds 
UTG+1: folds 
UTG+2: raises $20 to $25
Dealer: folds 
Small Blind: folds 
Hero: calls $20
*** FLOP *** [4s Qd 4c]
Hero: checks 
UTG+2: checks 
*** TURN *** [4s Qd 4c] [Th]
Hero: checks 
UTG+2: checks 
*** RIVER *** [4s Qd 4c Th] [Ah]
Hero: checks 
UTG+2: bets $49.88
Hero: folds 
*** SHOW DOWN ***
Small Blind: shows [Qh Tc] (a hand...)
Hero: shows [3h 3d] (a hand...)
Dealer: shows [Kc 4d] (a hand...)
UTG+2: shows [Qs Qc] (a hand...)
UTG: shows [Js 2c] (a hand...)
UTG+1: shows [2d Ks] (a hand...)
Uncalled bet ($49.88) returned to UTG+2
UTG+2 collected $49.88 from pot
*** SUMMARY ***
Total pot $52.50 | Rake $2.62
Board [4s Qd 4c Th Ah]
Seat 1: Dealer folded
Seat 2: Small Blind folded
Seat 3: Hero folded
Seat 4: UTG folded
Seat 5: UTG+1 folded
Seat 6: UTG+2 collected ($49.88)



PokerStars Hand #3954988635:  Hold'em No Limit ($2.50/$5) - 2020/06/02 21:21:48 ET
Table '21648085' 9-max Seat #2 is the button
Seat 1: Hero ($232.50 in chips) 
Seat 2: Dealer ($789.88 in chips) 
Dealer: posts small blind $2.50
Hero: posts big blind $5
*** HOLE CARDS ***
Dealt to Hero [Jh Th]
Dealer: raises $8.00 to $13
Hero: raises $29 to $42
Dealer: calls $29
*** FLOP *** [8s 3d 8c]
Hero: bets $41.50
Dealer: calls $41.50
*** TURN *** [8s 3d 8c] [4c]
Hero: checks 
Dealer: checks 
*** RIVER *** [8s 3d 8c 4c] [4h]
Hero: checks 
Dealer: bets $706.38 and is all-in
Hero: folds 
*** SHOW DOWN ***
Dealer: shows [8h 9h] (a hand...)
Hero: shows [Jh Th] (a hand...)
Uncalled bet ($706.38) returned to Dealer
Dealer collected $166 from pot
*** SUMMARY ***
Total pot $167.00 | Rake $1.00
Board [8s 3d 8c 4c 4h]
Seat 1: Hero folded
Seat 2: Dealer collected ($166)



PokerStars Hand #3954985805:  Hold'em No Limit ($2.50/$5) - 2020/06/02 21:16:36 ET
Table '21647609' 9-max Seat #4 is the button
Seat 1: Small Blind ($502.50 in chips) 
Seat 2: Hero ($500.00 in chips) 
Seat 3: UTG ($529.91 in chips) 
Seat 4: Dealer ($753.75 in chips) 
Small Blind: posts small blind $2.50
Hero: posts big blind $5
*** HOLE CARDS ***
Dealt to Hero [7s Js]
UTG: raises $5 to $10
Dealer: calls $10
Small Blind: folds 
Hero: calls $5
*** FLOP *** [4d 3c 7c]
Hero: checks 
UTG: checks 
Dealer: checks 
*** TURN *** [4d 3c 7c] [8d]
Hero: bets $20
UTG: calls $20
Dealer: calls $20
*** RIVER *** [4d 3c 7c 8d] [8s]
Hero: checks 
UTG: bets $89.50
Dealer: folds 
Hero: folds 
*** SHOW DOWN ***
Small Blind: shows [2c 8c] (a hand...)
UTG: shows [Jd Jc] (a hand...)
Dealer: shows [6h 6c] (a hand...)
Hero: shows [7s Js] (a hand...)
Uncalled bet ($89.50) returned to UTG
UTG collected $89.50 from pot
*** SUMMARY ***
Total pot $92.50 | Rake $3.00
Board [4d 3c 7c 8d 8s]
Seat 1: Small Blind folded
Seat 2: Hero folded
Seat 3: UTG collected ($89.50)
Seat 4: Dealer folded



PokerStars Hand #3954805164:  Hold'em No Limit ($2.50/$5) - 2020/06/02 14:06:00 ET
Table '21642782' 9-max Seat #6 is the button
Seat 1: Small Blind ($547.16 in chips) 
Seat 2: Hero ($735.58 in chips) 
Seat 3: UTG ($1001.83 in chips) 
Seat 4: UTG+1 ($655.36 in chips) 
Seat 5: UTG+2 ($853.76 in chips) 
Seat 6: Dealer ($500.00 in chips) 
Small Blind: posts small blind $2.50
Hero: posts big blind $5
*** HOLE CARDS ***
Dealt to Hero [Qs Kc]
UTG: folds 
UTG+1: folds 
UTG+2: raises $7.50 to $12.50
Dealer: folds 
Small Blind: folds 
Hero: calls $7.50
*** FLOP *** [7c 4c Ah]
Hero: checks 
UTG+2: bets $5
Hero: calls $5
*** TURN *** [7c 4c Ah] [3h]
Hero: checks 
UTG+2: checks 
*** RIVER *** [7c 4c Ah 3h] [As]
Hero: checks 
UTG+2: bets $24.12
Hero: folds 
*** SHOW DOWN ***
Small Blind: shows [4h 7d] (a hand...)
Hero: shows [Qs Kc] (a hand...)
UTG+2: shows [Th 8h] (a hand...)
Dealer: shows [8c 3c] (a hand...)
UTG: shows [Qd 5c] (a hand...)
UTG+1: shows [Td 3s] (a hand...)
Uncalled bet ($24.12) returned to UTG+2
UTG+2 collected $35.63 from pot
*** SUMMARY ***
Total pot $37.50 | Rake $1.87
Board [7c 4c Ah 3h As]
Seat 1: Small Blind folded
Seat 2: Hero folded
Seat 3: UTG folded
Seat 4: UTG+1 folded
Seat 5: UTG+2 collected ($35.63)
Seat 6: Dealer folded



PokerStars Hand #3954804989:  Hold'em No Limit ($2.50/$5) - 2020/06/02 14:05:28 ET
Table '21644739' 9-max Seat #1 is the button
Seat 1: Dealer ($568.23 in chips) 
Seat 2: Hero ($502.50 in chips) 
Seat 3: Big Blind ($685.50 in chips) 
Seat 4: UTG ($500.00 in chips) 
Seat 5: UTG+1 ($500.00 in chips) 
Seat 6: UTG+2 ($661.31 in chips) 
Hero: posts small blind $2.50
Big Blind: posts big blind $5
*** HOLE CARDS ***
Dealt to Hero [9d 9c]
UTG: folds 
UTG+1: folds 
UTG+2: raises $7.50 to $12.50
Dealer: folds 
Hero: raises $42.50 to $55
Big Blind: folds 
UTG+2: calls $42.50
*** FLOP *** [5c 7d 2s]
Hero: checks 
UTG+2: checks 
*** TURN *** [5c 7d 2s] [Qd]
Hero: checks 
UTG+2: bets $60.50
Hero: calls $60.50
*** RIVER *** [5c 7d 2s Qd] [Ks]
Hero: checks 
UTG+2: bets $116
Hero: folds 
*** SHOW DOWN ***
Big Blind: shows [4c 5d] (a hand...)
Hero: shows [9d 9c] (a hand...)
Dealer: shows [3c 7s] (a hand...)
UTG+2: shows [Kc Tc] (a hand...)
UTG: shows [Qh 8h] (a hand...)
UTG+1: shows [Ad 5h] (a hand...)
Uncalled bet ($116.00) returned to UTG+2
UTG+2 collected $232 from pot
*** SUMMARY ***
Total pot $236.00 | Rake $4.00
Board [5c 7d 2s Qd Ks]
Seat 1: Dealer folded
Seat 2: Hero folded
Seat 3: Big Blind folded
Seat 4: UTG folded
Seat 5: UTG+1 folded
Seat 6: UTG+2 collected ($232)



PokerStars Hand #3954799646:  Hold'em No Limit ($2.50/$5) - 2020/06/02 13:47:53 ET
Table '21642782' 9-max Seat #5 is the button
Seat 1: Small Blind ($502.50 in chips) 
Seat 2: Hero ($767.08 in chips) 
Seat 3: UTG ($933.44 in chips) 
Seat 4: UTG+1 ($559.73 in chips) 
Seat 5: Dealer ($466.91 in chips) 
Small Blind: posts small blind $2.50
Hero: posts big blind $5
*** HOLE CARDS ***
Dealt to Hero [5c 6c]
UTG: calls $5
UTG+1: folds 
Dealer: raises $10 to $15
Small Blind: folds 
Hero: calls $10
UTG: calls $10
*** FLOP *** [7h 4s Ad]
Hero: checks 
UTG: checks 
Dealer: bets $15
Hero: calls $15
UTG: calls $15
*** TURN *** [7h 4s Ad] [7d]
Hero: checks 
UTG: checks 
Dealer: checks 
*** RIVER *** [7h 4s Ad 7d] [2d]
Hero: checks 
UTG: bets $67.13
Dealer: folds 
Hero: folds 
*** SHOW DOWN ***
Small Blind: shows [3s 4c] (a hand...)
Hero: shows [5c 6c] (a hand...)
Dealer: shows [Th 9h] (a hand...)
UTG: shows [7s 6s] (a hand...)
UTG+1: shows [8c As] (a hand...)
Uncalled bet ($67.13) returned to UTG
UTG collected $89.50 from pot
*** SUMMARY ***
Total pot $92.50 | Rake $3.00
Board [7h 4s Ad 7d 2d]
Seat 1: Small Blind folded
Seat 2: Hero folded
Seat 3: UTG collected ($89.50)
Seat 4: UTG+1 folded
Seat 5: Dealer folded



PokerStars Hand #3954792613:  Hold'em No Limit ($2.50/$5) - 2020/06/02 13:23:23 ET
Table '21641314' 9-max Seat #1 is the button
Seat 1: Dealer ($510.00 in chips) 
Seat 2: Small Blind ($1461.86 in chips) 
Seat 3: Big Blind ($690.45 in chips) 
Seat 4: UTG ($500.00 in chips) 
Seat 5: Hero ($636.98 in chips) 
Small Blind: posts small blind $2.50
Big Blind: posts big blind $5
*** HOLE CARDS ***
Dealt to Hero [6c 6s]
UTG: folds 
Hero: raises $7.50 to $12.50
Dealer: folds 
Small Blind: raises $40.00 to $52.50
Big Blind: folds 
Hero: calls $40
*** FLOP *** [Jd 2c Qc]
Small Blind: bets $53.50
Hero: calls $53.50
*** TURN *** [Jd 2c Qc] [4c]
Small Blind: checks 
Hero: checks 
*** RIVER *** [Jd 2c Qc 4c] [Th]
Small Blind: bets $107
Hero: folds 
*** SHOW DOWN ***
Small Blind: shows [Ac Qd] (a hand...)
Big Blind: shows [8s 2h] (a hand...)
Hero: shows [6c 6s] (a hand...)
Dealer: shows [2d Qh] (a hand...)
UTG: shows [7h Ts] (a hand...)
Uncalled bet ($107.00) returned to Small Blind
Small Blind collected $214 from pot
*** SUMMARY ***
Total pot $217.00 | Rake $3.00
Board [Jd 2c Qc 4c Th]
Seat 1: Dealer folded
Seat 2: Small Blind collected ($214)
Seat 3: Big Blind folded
Seat 4: UTG folded
Seat 5: Hero folded



PokerStars Hand #3954789548:  Hold'em No Limit ($2.50/$5) - 2020/06/02 13:12:32 ET
Table '21643502' 9-max Seat #1 is the button
Seat 1: Dealer ($823.22 in chips) 
Seat 2: Hero ($503.70 in chips) 
Seat 3: Big Blind ($551.88 in chips) 
Seat 4: UTG ($500.00 in chips) 
Seat 5: UTG+1 ($503.00 in chips) 
Seat 6: UTG+2 ($542.70 in chips) 
Hero: posts small blind $2.50
Big Blind: posts big blind $5
*** HOLE CARDS ***
Dealt to Hero [9h 9d]
UTG: folds 
UTG+1: folds 
UTG+2: folds 
Dealer: folds 
Hero: raises $10.00 to $15
Big Blind: raises $30 to $45
Hero: calls $30
*** FLOP *** [5c 3d 7h]
Hero: checks 
Big Blind: bets $28
Hero: calls $28
*** TURN *** [5c 3d 7h] [Jc]
Hero: checks 
Big Blind: bets $106.50
Hero: calls $106.50
*** RIVER *** [5c 3d 7h Jc] [Ac]
Hero: checks 
Big Blind: bets $372.38 and is all-in
Hero: folds 
*** SHOW DOWN ***
Big Blind: shows [Qs Kh] (a hand...)
Hero: shows [9h 9d] (a hand...)
Dealer: shows [6s 2h] (a hand...)
UTG+2: shows [5d Th] (a hand...)
UTG: shows [5h 4s] (a hand...)
UTG+1: shows [8c Qh] (a hand...)
Uncalled bet ($372.38) returned to Big Blind
Big Blind collected $355 from pot
*** SUMMARY ***
Total pot $359.00 | Rake $4.00
Board [5c 3d 7h Jc Ac]
Seat 1: Dealer folded
Seat 2: Hero folded
Seat 3: Big Blind collected ($355)
Seat 4: UTG folded
Seat 5: UTG+1 folded
Seat 6: UTG+2 folded



PokerStars Hand #3952733843:  Hold'em No Limit ($2.50/$5) - 2020/05/29 13:28:43 ET
Table '21604588' 9-max Seat #4 is the button
Seat 1: Hero ($560.05 in chips) 
Seat 2: Big Blind ($527.00 in chips) 
Seat 3: UTG ($1060.49 in chips) 
Seat 4: Dealer ($522.00 in chips) 
Hero: posts small blind $2.50
Big Blind: posts big blind $5
*** HOLE CARDS ***
Dealt to Hero [9c Jc]
UTG: folds 
Dealer: folds 
Hero: raises $10.00 to $15
Big Blind: calls $10
*** FLOP *** [Tc 4d 4h]
Hero: checks 
Big Blind: bets $20
Hero: raises $36.25 to $56.25
Big Blind: calls $36.25
*** TURN *** [Tc 4d 4h] [Jh]
Hero: checks 
Big Blind: bets $139.50
Hero: calls $139.50
*** RIVER *** [Tc 4d 4h Jh] [7d]
Hero: checks 
Big Blind: bets $316.25 and is all-in
Hero: calls $316.25
*** SHOW DOWN ***
UTG: shows [Ah 7c] (a hand...)
Dealer: shows [9d 2s] (a hand...)
Big Blind: shows [4c 5d] (a hand...)
Hero: shows [9c Jc] (a hand...)
Big Blind collected $1051 from pot
*** SUMMARY ***
Total pot $1054.00 | Rake $3.00
Board [Tc 4d 4h Jh 7d]
Seat 1: Hero showed [9c Jc] and lost with...
Seat 2: Big Blind showed [4c 5d] and won ($1051)
Seat 3: UTG folded
Seat 4: Dealer folded



PokerStars Hand #3952732963:  Hold'em No Limit ($2.50/$5) - 2020/05/29 13:26:03 ET
Table '21603542' 9-max Seat #4 is the button
Seat 1: Big Blind ($434.36 in chips) 
Seat 2: Hero ($522.50 in chips) 
Seat 3: UTG+1 ($515.22 in chips) 
Seat 4: Dealer ($1080.45 in chips) 
Seat 5: Small Blind ($734.31 in chips) 
Small Blind: posts small blind $2.50
Big Blind: posts big blind $5
*** HOLE CARDS ***
Dealt to Hero [7s 7h]
Hero: raises $7.50 to $12.50
UTG+1: folds 
Dealer: folds 
Small Blind: folds 
Big Blind: calls $7.50
*** FLOP *** [Js Ah As]
Big Blind: checks 
Hero: bets $7.84
Big Blind: calls $7.84
*** TURN *** [Js Ah As] [3c]
Big Blind: checks 
Hero: checks 
*** RIVER *** [Js Ah As 3c] [Jh]
Big Blind: bets $20.52
Hero: folds 
*** SHOW DOWN ***
Small Blind: shows [Qd 6d] (a hand...)
Big Blind: shows [Qs Jd] (a hand...)
Hero: shows [7s 7h] (a hand...)
Dealer: shows [Jc 3s] (a hand...)
UTG+1: shows [5h 9s] (a hand...)
Uncalled bet ($20.52) returned to Big Blind
Big Blind collected $41.03 from pot
*** SUMMARY ***
Total pot $43.18 | Rake $2.15
Board [Js Ah As 3c Jh]
Seat 1: Big Blind collected ($41.03)
Seat 2: Hero folded
Seat 3: UTG+1 folded
Seat 4: Dealer folded
Seat 5: Small Blind folded



PokerStars Hand #3952730545:  Hold'em No Limit ($2.50/$5) - 2020/05/29 13:19:00 ET
Table '21604135' 9-max Seat #6 is the button
Seat 1: Small Blind ($902.07 in chips) 
Seat 2: Big Blind ($442.12 in chips) 
Seat 3: Hero ($1097.51 in chips) 
Seat 4: UTG+1 ($1694.90 in chips) 
Seat 5: UTG+2 ($500.00 in chips) 
Seat 6: Dealer ($526.39 in chips) 
Small Blind: posts small blind $2.50
Big Blind: posts big blind $5
*** HOLE CARDS ***
Dealt to Hero [8s 8c]
Hero: raises $7.50 to $12.50
UTG+1: raises $27.50 to $40
UTG+2: folds 
Dealer: folds 
Small Blind: folds 
Big Blind: folds 
Hero: calls $27.50
*** FLOP *** [9s Td 5d]
Hero: checks 
UTG+1: checks 
*** TURN *** [9s Td 5d] [Kh]
Hero: checks 
UTG+1: checks 
*** RIVER *** [9s Td 5d Kh] [Tc]
Hero: checks 
UTG+1: bets $58.45
Hero: folds 
*** SHOW DOWN ***
Small Blind: shows [9d Ac] (a hand...)
Big Blind: shows [4s Th] (a hand...)
Hero: shows [8s 8c] (a hand...)
UTG+2: shows [3c 6s] (a hand...)
Dealer: shows [3h 9c] (a hand...)
UTG+1: shows [Ad Ah] (a hand...)
Uncalled bet ($58.45) returned to UTG+1
UTG+1 collected $83.50 from pot
*** SUMMARY ***
Total pot $87.50 | Rake $4.00
Board [9s Td 5d Kh Tc]
Seat 1: Small Blind folded
Seat 2: Big Blind folded
Seat 3: Hero folded
Seat 4: UTG+1 collected ($83.50)
Seat 5: UTG+2 folded
Seat 6: Dealer folded



PokerStars Hand #3952727538:  Hold'em No Limit ($2.50/$5) - 2020/05/29 13:10:01 ET
Table '21603542' 9-max Seat #1 is the button
Seat 1: Hero ($507.00 in chips) 
Seat 2: Small Blind ($500.00 in chips) 
Seat 3: Big Blind ($1064.63 in chips) 
Seat 4: UTG ($679.81 in chips) 
Seat 5: UTG+1 ($562.95 in chips) 
Small Blind: posts small blind $2.50
Big Blind: posts big blind $5
*** HOLE CARDS ***
Dealt to Hero [5s Ad]
UTG: folds 
UTG+1: folds 
Hero: raises $7.50 to $12.50
Small Blind: folds 
Big Blind: calls $7.50
*** FLOP *** [5h 6s 8d]
Big Blind: checks 
Hero: checks 
*** TURN *** [5h 6s 8d] [Qc]
Big Blind: bets $19.60
Hero: calls $19.60
*** RIVER *** [5h 6s 8d Qc] [Jc]
Big Blind: bets $47.78
Hero: folds 
*** SHOW DOWN ***
Small Blind: shows [4c 7h] (a hand...)
Big Blind: shows [Th Qs] (a hand...)
Hero: shows [5s Ad] (a hand...)
UTG: shows [3d 8c] (a hand...)
UTG+1: shows [4h Kd] (a hand...)
Uncalled bet ($47.78) returned to Big Blind
Big Blind collected $63.70 from pot
*** SUMMARY ***
Total pot $66.70 | Rake $3.00
Board [5h 6s 8d Qc Jc]
Seat 1: Hero folded
Seat 2: Small Blind folded
Seat 3: Big Blind collected ($63.70)
Seat 4: UTG folded
Seat 5: UTG+1 folded



PokerStars Hand #3952721976:  Hold'em No Limit ($2.50/$5) - 2020/05/29 12:53:46 ET
Table '21603979' 9-max Seat #1 is the button
Seat 1: Dealer ($500.00 in chips) 
Seat 2: Small Blind ($1295.69 in chips) 
Seat 3: Big Blind ($477.17 in chips) 
Seat 4: Hero ($679.39 in chips) 
Seat 5: UTG+1 ($565.63 in chips) 
Small Blind: posts small blind $2.50
Big Blind: posts big blind $5
*** HOLE CARDS ***
Dealt to Hero [Qc Kd]
Hero: raises $7.50 to $12.50
UTG+1: folds 
Dealer: folds 
Small Blind: folds 
Big Blind: raises $27.50 to $40
Hero: calls $27.50
*** FLOP *** [9c Jd 6c]
Big Blind: bets $26.31
Hero: calls $26.31
*** TURN *** [9c Jd 6c] [Ac]
Big Blind: bets $33.26
Hero: calls $33.26
*** RIVER *** [9c Jd 6c Ac] [5d]
Big Blind: bets $35
Hero: folds 
*** SHOW DOWN ***
Small Blind: shows [Qd 7s] (a hand...)
Big Blind: shows [Kh Kc] (a hand...)
Hero: shows [Qc Kd] (a hand...)
Dealer: shows [Ks 2s] (a hand...)
UTG+1: shows [8s Tc] (a hand...)
Uncalled bet ($35.00) returned to Big Blind
Big Blind collected $198.64 from pot
*** SUMMARY ***
Total pot $201.64 | Rake $3.00
Board [9c Jd 6c Ac 5d]
Seat 1: Dealer folded
Seat 2: Small Blind folded
Seat 3: Big Blind collected ($198.64)
Seat 4: Hero folded
Seat 5: UTG+1 folded



PokerStars Hand #3952721893:  Hold'em No Limit ($2.50/$5) - 2020/05/29 12:53:32 ET
Table '21603542' 9-max Seat #1 is the button
Seat 1: Hero ($834.26 in chips) 
Seat 2: Small Blind ($487.50 in chips) 
Seat 3: Big Blind ($789.31 in chips) 
Seat 4: UTG ($519.88 in chips) 
Small Blind: posts small blind $2.50
Big Blind: posts big blind $5
*** HOLE CARDS ***
Dealt to Hero [7c Kc]
UTG: folds 
Hero: raises $7.50 to $12.50
Small Blind: raises $40.00 to $52.50
Big Blind: folds 
Hero: calls $40
*** FLOP *** [3c 7h 2h]
Small Blind: bets $37.50
Hero: raises $46.00 to $83.50
Small Blind: calls $46
*** TURN *** [3c 7h 2h] [6s]
Small Blind: checks 
Hero: checks 
*** RIVER *** [3c 7h 2h 6s] [4c]
Small Blind: bets $351.50 and is all-in
Hero: calls $351.50
*** SHOW DOWN ***
Small Blind: shows [Ac As] (a hand...)
UTG: shows [6h 3s] (a hand...)
Big Blind: shows [7s Qs] (a hand...)
Hero: shows [7c Kc] (a hand...)
Small Blind collected $977 from pot
*** SUMMARY ***
Total pot $980.00 | Rake $3.00
Board [3c 7h 2h 6s 4c]
Seat 1: Hero showed [7c Kc] and lost with...
Seat 2: Small Blind showed [Ac As] and won ($977)
Seat 3: Big Blind folded
Seat 4: UTG folded



PokerStars Hand #3952721883:  Hold'em No Limit ($2.50/$5) - 2020/05/29 12:53:30 ET
Table '21603957' 9-max Seat #1 is the button
Seat 1: Dealer ($499.38 in chips) 
Seat 2: Small Blind ($483.50 in chips) 
Seat 3: Big Blind ($550.13 in chips) 
Seat 4: UTG ($454.56 in chips) 
Seat 5: UTG+1 ($1041.42 in chips) 
Seat 6: Hero ($1587.81 in chips) 
Small Blind: posts small blind $2.50
Big Blind: posts big blind $5
*** HOLE CARDS ***
Dealt to Hero [As Ks]
UTG: calls $5
UTG+1: folds 
Hero: raises $17.50 to $22.50
Dealer: folds 
Small Blind: folds 
Big Blind: folds 
UTG: calls $17.50
*** FLOP *** [8c Kh 8h]
UTG: checks 
Hero: bets $15
UTG: calls $15
*** TURN *** [8c Kh 8h] [Qd]
UTG: checks 
Hero: checks 
*** RIVER *** [8c Kh 8h Qd] [4c]
UTG: bets $58.88
Hero: calls $58.88
*** SHOW DOWN ***
Small Blind: shows [Qs 7h] (a hand...)
Big Blind: shows [9s 2c] (a hand...)
Hero: shows [As Ks] (a hand...)
Dealer: shows [8d 4d] (a hand...)
UTG: shows [2h 2d] (a hand...)
UTG+1: shows [Tc 4s] (a hand...)
Hero collected $196.26 from pot
*** SUMMARY ***
Total pot $200.26 | Rake $4.00
Board [8c Kh 8h Qd 4c]
Seat 1: Dealer folded
Seat 2: Small Blind folded
Seat 3: Big Blind folded
Seat 4: UTG showed [2h 2d] and lost with...
Seat 5: UTG+1 folded
Seat 6: Hero showed [As Ks] and won ($196.26)



PokerStars Hand #3952719800:  Hold'em No Limit ($2.50/$5) - 2020/05/29 12:47:33 ET
Table '21604135' 9-max Seat #1 is the button
Seat 1: Dealer ($960.53 in chips) 
Seat 2: Small Blind ($510.38 in chips) 
Seat 3: Hero ($646.00 in chips) 
Seat 4: UTG ($500.00 in chips) 
Seat 5: UTG+1 ($663.91 in chips) 
Seat 6: UTG+2 ($597.00 in chips) 
Small Blind: posts small blind $2.50
Hero: posts big blind $5
*** HOLE CARDS ***
Dealt to Hero [Ac 3d]
UTG: folds 
UTG+1: folds 
UTG+2: folds 
Dealer: folds 
Small Blind: raises $5.00 to $10
Hero: calls $5
*** FLOP *** [8c Jd 3s]
Small Blind: checks 
Hero: checks 
*** TURN *** [8c Jd 3s] [Kh]
Small Blind: bets $14.25
Hero: calls $14.25
*** RIVER *** [8c Jd 3s Kh] [6c]
Small Blind: bets $34.56
Hero: folds 
*** SHOW DOWN ***
Small Blind: shows [4d Kd] (a hand...)
Hero: shows [Ac 3d] (a hand...)
Dealer: shows [Qd 7s] (a hand...)
UTG+2: shows [5h Qc] (a hand...)
UTG: shows [5d 9c] (a hand...)
UTG+1: shows [2s 3c] (a hand...)
Uncalled bet ($34.56) returned to Small Blind
Small Blind collected $46.08 from pot
*** SUMMARY ***
Total pot $48.50 | Rake $2.42
Board [8c Jd 3s Kh 6c]
Seat 1: Dealer folded
Seat 2: Small Blind collected ($46.08)
Seat 3: Hero folded
Seat 4: UTG folded
Seat 5: UTG+1 folded
Seat 6: UTG+2 folded



PokerStars Hand #3952717654:  Hold'em No Limit ($2.50/$5) - 2020/05/29 12:41:10 ET
Table '21603542' 9-max Seat #4 is the button
Seat 1: Big Blind ($518.98 in chips) 
Seat 2: Hero ($903.76 in chips) 
Seat 3: UTG+1 ($492.50 in chips) 
Seat 4: Dealer ($498.26 in chips) 
Seat 5: Small Blind ($495.00 in chips) 
Small Blind: posts small blind $2.50
Big Blind: posts big blind $5
*** HOLE CARDS ***
Dealt to Hero [7d 7c]
Hero: raises $7.50 to $12.50
UTG+1: folds 
Dealer: folds 
Small Blind: raises $42.50 to $55
Big Blind: folds 
Hero: calls $42.50
*** FLOP *** [4h Kd 9s]
Small Blind: checks 
Hero: checks 
*** TURN *** [4h Kd 9s] [2d]
Small Blind: checks 
Hero: checks 
*** RIVER *** [4h Kd 9s 2d] [Jd]
Small Blind: bets $72
Hero: calls $72
*** SHOW DOWN ***
Small Blind: shows [Ks Kh] (a hand...)
Big Blind: shows [9d 4s] (a hand...)
Hero: shows [7d 7c] (a hand...)
Dealer: shows [2h 6s] (a hand...)
UTG+1: shows [Th Qd] (a hand...)
Small Blind collected $256 from pot
*** SUMMARY ***
Total pot $259.00 | Rake $3.00
Board [4h Kd 9s 2d Jd]
Seat 1: Big Blind folded
Seat 2: Hero showed [7d 7c] and lost with...
Seat 3: UTG+1 folded
Seat 4: Dealer folded
Seat 5: Small Blind showed [Ks Kh] and won ($256)



PokerStars Hand #3952715310:  Hold'em No Limit ($2.50/$5) - 2020/05/29 12:34:23 ET
Table '21604135' 9-max Seat #1 is the button
Seat 1: Dealer ($1013.03 in chips) 
Seat 2: Small Blind ($478.00 in chips) 
Seat 3: Hero ($500.00 in chips) 
Seat 4: UTG ($500.00 in chips) 
Seat 5: UTG+1 ($622.28 in chips) 
Small Blind: posts small blind $2.50
Hero: posts big blind $5
*** HOLE CARDS ***
Dealt to Hero [7d Td]
UTG: folds 
UTG+1: folds 
Dealer: folds 
Small Blind: raises $10.00 to $15
Hero: raises $30 to $45
Small Blind: calls $30
*** FLOP *** [6c Kh 6s]
Small Blind: checks 
Hero: bets $26.10
Small Blind: raises $64.60 to $90.70
Hero: raises $71.68 to $162.38
Small Blind: calls $71.68
*** TURN *** [6c Kh 6s] [9d]
Small Blind: checks 
Hero: checks 
*** RIVER *** [6c Kh 6s 9d] [2d]
Small Blind: bets $270.62 and is all-in
Hero: folds 
*** SHOW DOWN ***
Small Blind: shows [8c 7c] (a hand...)
Hero: shows [7d Td] (a hand...)
Dealer: shows [4h 9s] (a hand...)
UTG: shows [Ks 3c] (a hand...)
UTG+1: shows [2c Jc] (a hand...)
Uncalled bet ($270.62) returned to Small Blind
Small Blind collected $411.76 from pot
*** SUMMARY ***
Total pot $414.76 | Rake $3.00
Board [6c Kh 6s 9d 2d]
Seat 1: Dealer folded
Seat 2: Small Blind collected ($411.76)
Seat 3: Hero folded
Seat 4: UTG folded
Seat 5: UTG+1 folded



PokerStars Hand #3952713688:  Hold'em No Limit ($2.50/$5) - 2020/05/29 12:29:34 ET
Table '21603542' 9-max Seat #6 is the button
Seat 1: Small Blind ($565.48 in chips) 
Seat 2: Hero ($500.00 in chips) 
Seat 3: UTG ($963.15 in chips) 
Seat 4: UTG+1 ($492.50 in chips) 
Seat 5: UTG+2 ($720.53 in chips) 
Seat 6: Dealer ($1182.65 in chips) 
Small Blind: posts small blind $2.50
Hero: posts big blind $5
*** HOLE CARDS ***
Dealt to Hero [Kc As]
UTG: folds 
UTG+1: folds 
UTG+2: raises $7.50 to $12.50
Dealer: folds 
Small Blind: folds 
Hero: raises $45.00 to $57.50
UTG+2: calls $45
*** FLOP *** [3s 2d 2h]
Hero: bets $34.05
UTG+2: calls $34.05
*** TURN *** [3s 2d 2h] [5d]
Hero: checks 
UTG+2: checks 
*** RIVER *** [3s 2d 2h 5d] [3c]
Hero: checks 
UTG+2: bets $118
Hero: calls $118
*** SHOW DOWN ***
Small Blind: shows [4s Ah] (a hand...)
Hero: shows [Kc As] (a hand...)
UTG+2: shows [Kd Td] (a hand...)
Dealer: shows [3h Ks] (a hand...)
UTG: shows [9d Qs] (a hand...)
UTG+1: shows [9c 8h] (a hand...)
Hero collected $417.60 from pot
*** SUMMARY ***
Total pot $421.60 | Rake $4.00
Board [3s 2d 2h 5d 3c]
Seat 1: Small Blind folded
Seat 2: Hero showed [Kc As] and won ($417.60)
Seat 3: UTG folded
Seat 4: UTG+1 folded
Seat 5: UTG+2 showed [Kd Td] and lost with...
Seat 6: Dealer folded



PokerStars Hand #3952709653:  Hold'em No Limit ($2.50/$5) - 2020/05/29 12:16:59 ET
Table '21603979' 9-max Seat #3 is the button
Seat 1: UTG+1 ($830.73 in chips) 
Seat 2: UTG+2 ($626.60 in chips) 
Seat 3: Dealer ($274.72 in chips) 
Seat 4: Hero ($629.06 in chips) 
Seat 5: Big Blind ($563.54 in chips) 
Seat 6: UTG ($580.73 in chips) 
Hero: posts small blind $2.50
Big Blind: posts big blind $5
*** HOLE CARDS ***
Dealt to Hero [Ad Td]
UTG: folds 
UTG+1: folds 
UTG+2: folds 
Dealer: folds 
Hero: raises $10.00 to $15
Big Blind: calls $10
*** FLOP *** [Tc 3d Qs]
Hero: bets $8.55
Big Blind: calls $8.55
*** TURN *** [Tc 3d Qs] [9s]
Hero: checks 
Big Blind: checks 
*** RIVER *** [Tc 3d Qs 9s] [3c]
Hero: bets $13.42
Big Blind: raises $28.42 to $41.84
Hero: calls $28.42
*** SHOW DOWN ***
Big Blind: shows [6d 6c] (a hand...)
Hero: shows [Ad Td] (a hand...)
Dealer: shows [Qh 8d] (a hand...)
UTG+2: shows [4s 8s] (a hand...)
UTG: shows [Th 4h] (a hand...)
UTG+1: shows [Jc 7d] (a hand...)
Hero collected $126.78 from pot
*** SUMMARY ***
Total pot $130.78 | Rake $4.00
Board [Tc 3d Qs 9s 3c]
Seat 1: UTG+1 folded
Seat 2: UTG+2 folded
Seat 3: Dealer folded
Seat 4: Hero showed [Ad Td] and won ($126.78)
Seat 5: Big Blind showed [6d 6c] and lost with...
Seat 6: UTG folded



PokerStars Hand #3952709239:  Hold'em No Limit ($2.50/$5) - 2020/05/29 12:15:38 ET
Table '21603957' 9-max Seat #1 is the button
Seat 1: Dealer ($86.80 in chips) 
Seat 2: Small Blind ($495.00 in chips) 
Seat 3: Big Blind ($750.90 in chips) 
Seat 4: UTG ($569.61 in chips) 
Seat 5: UTG+1 ($976.62 in chips) 
Seat 6: Hero ($623.58 in chips) 
Small Blind: posts small blind $2.50
Big Blind: posts big blind $5
*** HOLE CARDS ***
Dealt to Hero [Kh Kc]
UTG: raises $10 to $15
UTG+1: folds 
Hero: raises $35 to $50
Dealer: folds 
Small Blind: folds 
Big Blind: folds 
UTG: calls $35
*** FLOP *** [Ts 7s 7c]
UTG: checks 
Hero: bets $62.10
UTG: calls $62.10
*** TURN *** [Ts 7s 7c] [9s]
UTG: bets $170.78
Hero: calls $170.78
*** RIVER *** [Ts 7s 7c 9s] [2c]
UTG: bets $286.73 and is all-in
Hero: calls $286.73
*** SHOW DOWN ***
Small Blind: shows [Ad Jh] (a hand...)
Big Blind: shows [6c 3h] (a hand...)
Hero: shows [Kh Kc] (a hand...)
Dealer: shows [Ah 6s] (a hand...)
UTG: shows [Kd Qs] (a hand...)
UTG+1: shows [8h Qd] (a hand...)
Hero collected $1142.72 from pot
*** SUMMARY ***
Total pot $1146.72 | Rake $4.00
Board [Ts 7s 7c 9s 2c]
Seat 1: Dealer folded
Seat 2: Small Blind folded
Seat 3: Big Blind folded
Seat 4: UTG showed [Kd Qs] and lost with...
Seat 5: UTG+1 folded
Seat 6: Hero showed [Kh Kc] and won ($1142.72)



PokerStars Hand #3952703124:  Hold'em No Limit ($2.50/$5) - 2020/05/29 11:54:15 ET
Table '21603542' 9-max Seat #5 is the button
Seat 1: Small Blind ($487.50 in chips) 
Seat 2: Hero ($500.00 in chips) 
Seat 3: UTG ($500.00 in chips) 
Seat 4: UTG+1 ($604.81 in chips) 
Seat 5: Dealer ($1021.56 in chips) 
Small Blind: posts small blind $2.50
Hero: posts big blind $5
*** HOLE CARDS ***
Dealt to Hero [Jd 9c]
UTG: folds 
UTG+1: folds 
Dealer: folds 
Small Blind: raises $10.00 to $15
Hero: calls $10
*** FLOP *** [Ah Qh 5c]
Small Blind: checks 
Hero: checks 
*** TURN *** [Ah Qh 5c] [Jc]
Small Blind: checks 
Hero: checks 
*** RIVER *** [Ah Qh 5c Jc] [Ks]
Small Blind: bets $14.25
Hero: folds 
*** SHOW DOWN ***
Small Blind: shows [Qd Td] (a hand...)
Hero: shows [Jd 9c] (a hand...)
Dealer: shows [5d 8s] (a hand...)
UTG: shows [7s Qc] (a hand...)
UTG+1: shows [3s 2c] (a hand...)
Uncalled bet ($14.25) returned to Small Blind
Small Blind collected $28.50 from pot
*** SUMMARY ***
Total pot $30.00 | Rake $1.50
Board [Ah Qh 5c Jc Ks]
Seat 1: Small Blind collected ($28.50)
Seat 2: Hero folded
Seat 3: UTG folded
Seat 4: UTG+1 folded
Seat 5: Dealer folded



PokerStars Hand #3952699283:  Hold'em No Limit ($2.50/$5) - 2020/05/29 11:39:18 ET
Table '21603542' 9-max Seat #3 is the button
Seat 1: UTG ($500.00 in chips) 
Seat 2: Hero ($511.46 in chips) 
Seat 3: Dealer ($834.20 in chips) 
Seat 4: Small Blind ($562.05 in chips) 
Seat 5: Big Blind ($500.00 in chips) 
Small Blind: posts small blind $2.50
Big Blind: posts big blind $5
*** HOLE CARDS ***
Dealt to Hero [Js 8s]
UTG: folds 
Hero: raises $7.50 to $12.50
Dealer: folds 
Small Blind: folds 
Big Blind: calls $7.50
*** FLOP *** [Jc 6h 7h]
Big Blind: checks 
Hero: checks 
*** TURN *** [Jc 6h 7h] [Td]
Big Blind: bets $39.20
Hero: calls $39.20
*** RIVER *** [Jc 6h 7h Td] [Ad]
Big Blind: bets $69.68
Hero: folds 
*** SHOW DOWN ***
Small Blind: shows [Th 3d] (a hand...)
Big Blind: shows [9c 8c] (a hand...)
Hero: shows [Js 8s] (a hand...)
Dealer: shows [6c 5d] (a hand...)
UTG: shows [6s 7c] (a hand...)
Uncalled bet ($69.68) returned to Big Blind
Big Blind collected $102.90 from pot
*** SUMMARY ***
Total pot $105.90 | Rake $3.00
Board [Jc 6h 7h Td Ad]
Seat 1: UTG folded
Seat 2: Hero folded
Seat 3: Dealer folded
Seat 4: Small Blind folded
Seat 5: Big Blind collected ($102.90)



PokerStars Hand #3952697916:  Hold'em No Limit ($2.50/$5) - 2020/05/29 11:33:26 ET
Table '21603957' 9-max Seat #2 is the button
Seat 1: Big Blind ($350.00 in chips) 
Seat 2: Dealer ($553.50 in chips) 
Seat 3: Hero ($495.00 in chips) 
Hero: posts small blind $2.50
Big Blind: posts big blind $5
*** HOLE CARDS ***
Dealt to Hero [8c As]
Dealer: folds 
Hero: raises $10.00 to $15
Big Blind: calls $10
*** FLOP *** [Tc 5c 3c]
Hero: checks 
Big Blind: bets $15
Hero: calls $15
*** TURN *** [Tc 5c 3c] [Qh]
Hero: checks 
Big Blind: checks 
*** RIVER *** [Tc 5c 3c Qh] [Ad]
Hero: checks 
Big Blind: bets $25
Hero: calls $25
*** SHOW DOWN ***
Dealer: shows [2d 3s] (a hand...)
Big Blind: shows [4d Kh] (a hand...)
Hero: shows [8c As] (a hand...)
Hero collected $108 from pot
*** SUMMARY ***
Total pot $110.00 | Rake $2.00
Board [Tc 5c 3c Qh Ad]
Seat 1: Big Blind showed [4d Kh] and lost with...
Seat 2: Dealer folded
Seat 3: Hero showed [8c As] and won ($108)



PokerStars Hand #3952511358:  Hold'em No Limit ($2.50/$5) - 2020/05/29 00:32:02 ET
Table '21599124' 9-max Seat #5 is the button
Seat 1: Hero ($500.00 in chips) 
Seat 2: UTG ($275.50 in chips) 
Seat 3: UTG+1 ($585.24 in chips) 
Seat 4: UTG+2 ($508.63 in chips) 
Seat 5: Dealer ($762.00 in chips) 
Seat 6: Small Blind ($495.00 in chips) 
Small Blind: posts small blind $2.50
Hero: posts big blind $5
*** HOLE CARDS ***
Dealt to Hero [9h Td]
UTG: folds 
UTG+1: folds 
UTG+2: raises $5 to $10
Dealer: folds 
Small Blind: folds 
Hero: calls $5
*** FLOP *** [Ad Jc 3d]
Hero: checks 
UTG+2: checks 
*** TURN *** [Ad Jc 3d] [9s]
Hero: checks 
UTG+2: checks 
*** RIVER *** [Ad Jc 3d 9s] [Kd]
Hero: checks 
UTG+2: bets $5.69
Hero: folds 
*** SHOW DOWN ***
Small Blind: shows [4c Ks] (a hand...)
Hero: shows [9h Td] (a hand...)
Dealer: shows [3c 4s] (a hand...)
UTG+2: shows [Kh 2h] (a hand...)
UTG: shows [5c 6c] (a hand...)
UTG+1: shows [Tc Jh] (a hand...)
Uncalled bet ($5.69) returned to UTG+2
UTG+2 collected $21.38 from pot
*** SUMMARY ***
Total pot $22.50 | Rake $1.12
Board [Ad Jc 3d 9s Kd]
Seat 1: Hero folded
Seat 2: UTG folded
Seat 3: UTG+1 folded
Seat 4: UTG+2 collected ($21.38)
Seat 5: Dealer folded
Seat 6: Small Blind folded



PokerStars Hand #3952509575:  Hold'em No Limit ($2.50/$5) - 2020/05/29 00:28:40 ET
Table '21599124' 9-max Seat #2 is the button
Seat 1: Hero ($490.00 in chips) 
Seat 2: Dealer ($227.50 in chips) 
Seat 3: Small Blind ($543.14 in chips) 
Seat 4: Big Blind ($516.13 in chips) 
Seat 5: UTG ($762.00 in chips) 
Small Blind: posts small blind $2.50
Big Blind: posts big blind $5
*** HOLE CARDS ***
Dealt to Hero [2c 2h]
UTG: folds 
Hero: raises $7.50 to $12.50
Dealer: folds 
Small Blind: raises $37.50 to $50
Big Blind: folds 
Hero: calls $37.50
*** FLOP *** [Js 8d 7c]
Small Blind: checks 
Hero: bets $30.60
Small Blind: calls $30.60
*** TURN *** [Js 8d 7c] [7s]
Small Blind: checks 
Hero: checks 
*** RIVER *** [Js 8d 7c 7s] [Qd]
Small Blind: bets $122.40
Hero: folds 
*** SHOW DOWN ***
Small Blind: shows [Kc Kh] (a hand...)
Big Blind: shows [9c Qc] (a hand...)
Hero: shows [2c 2h] (a hand...)
Dealer: shows [Th 6d] (a hand...)
UTG: shows [6c 3h] (a hand...)
Uncalled bet ($122.40) returned to Small Blind
Small Blind collected $163.20 from pot
*** SUMMARY ***
Total pot $166.20 | Rake $3.00
Board [Js 8d 7c 7s Qd]
Seat 1: Hero folded
Seat 2: Dealer folded
Seat 3: Small Blind collected ($163.20)
Seat 4: Big Blind folded
Seat 5: UTG folded



PokerStars Hand #3952498087:  Hold'em No Limit ($2.50/$5) - 2020/05/29 00:05:53 ET
Table '21598890' 9-max Seat #2 is the button
Seat 1: Hero ($492.50 in chips) 
Seat 2: Dealer ($530.00 in chips) 
Seat 3: Small Blind ($978.20 in chips) 
Seat 4: Big Blind ($612.15 in chips) 
Seat 5: UTG ($516.98 in chips) 
Small Blind: posts small blind $2.50
Big Blind: posts big blind $5
*** HOLE CARDS ***
Dealt to Hero [Tc Ts]
UTG: folds 
Hero: raises $7.50 to $12.50
Dealer: raises $27.50 to $40
Small Blind: folds 
Big Blind: folds 
Hero: calls $27.50
*** FLOP *** [8s Qs 8h]
Hero: checks 
Dealer: bets $25
Hero: calls $25
*** TURN *** [8s Qs 8h] [Qc]
Hero: checks 
Dealer: checks 
*** RIVER *** [8s Qs 8h Qc] [Ks]
Hero: checks 
Dealer: bets $67.25
Hero: calls $67.25
*** SHOW DOWN ***
Small Blind: shows [4c 2c] (a hand...)
Big Blind: shows [7s 3c] (a hand...)
Hero: shows [Tc Ts] (a hand...)
Dealer: shows [6d 5d] (a hand...)
UTG: shows [Qh 7c] (a hand...)
Hero collected $269 from pot
*** SUMMARY ***
Total pot $272.00 | Rake $3.00
Board [8s Qs 8h Qc Ks]
Seat 1: Hero showed [Tc Ts] and won ($269)
Seat 2: Dealer showed [6d 5d] and lost with...
Seat 3: Small Blind folded
Seat 4: Big Blind folded
Seat 5: UTG folded



PokerStars Hand #3952191916:  Hold'em No Limit ($2.50/$5) - 2020/05/28 13:08:07 ET
Table '21593706' 9-max Seat #1 is the button
Seat 1: Dealer ($492.50 in chips) 
Seat 2: Small Blind ($649.22 in chips) 
Seat 3: Big Blind ($155.79 in chips) 
Seat 4: Hero ($686.91 in chips) 
Small Blind: posts small blind $2.50
Big Blind: posts big blind $5
*** HOLE CARDS ***
Dealt to Hero [Kh Ks]
Hero: raises $7.50 to $12.50
Dealer: folds 
Small Blind: calls $10
Big Blind: calls $7.50
*** FLOP *** [Th 6h Tc]
Small Blind: checks 
Big Blind: checks 
Hero: checks 
*** TURN *** [Th 6h Tc] [9h]
Small Blind: checks 
Big Blind: bets $17.82
Hero: calls $17.82
Small Blind: folds 
*** RIVER *** [Th 6h Tc 9h] [Js]
Big Blind: bets $20.07
Hero: calls $20.07
*** SHOW DOWN ***
Small Blind: shows [Jc Qc] (a hand...)
Dealer: shows [2c Ad] (a hand...)
Big Blind: shows [8h 9s] (a hand...)
Hero: shows [Kh Ks] (a hand...)
Hero collected $110.28 from pot
*** SUMMARY ***
Total pot $113.28 | Rake $3.00
Board [Th 6h Tc 9h Js]
Seat 1: Dealer folded
Seat 2: Small Blind folded
Seat 3: Big Blind showed [8h 9s] and lost with...
Seat 4: Hero showed [Kh Ks] and won ($110.28)



PokerStars Hand #3952190172:  Hold'em No Limit ($2.50/$5) - 2020/05/28 13:02:19 ET
Table '21593253' 9-max Seat #5 is the button
Seat 1: Small Blind ($549.50 in chips) 
Seat 2: Big Blind ($380.60 in chips) 
Seat 3: UTG ($507.50 in chips) 
Seat 4: Hero ($882.59 in chips) 
Seat 5: Dealer ($500.00 in chips) 
Small Blind: posts small blind $2.50
Big Blind: posts big blind $5
*** HOLE CARDS ***
Dealt to Hero [Jd Jh]
UTG: folds 
Hero: raises $7.50 to $12.50
Dealer: folds 
Small Blind: folds 
Big Blind: calls $7.50
*** FLOP *** [Qs 2h 3d]
Big Blind: checks 
Hero: bets $7.84
Big Blind: calls $7.84
*** TURN *** [Qs 2h 3d] [3c]
Big Blind: checks 
Hero: checks 
*** RIVER *** [Qs 2h 3d 3c] [6h]
Big Blind: bets $30.77
Hero: calls $30.77
*** SHOW DOWN ***
Small Blind: shows [2d Tc] (a hand...)
Big Blind: shows [3s 5s] (a hand...)
Hero: shows [Jd Jh] (a hand...)
Dealer: shows [6s 2s] (a hand...)
UTG: shows [9d 3h] (a hand...)
Big Blind collected $101.72 from pot
*** SUMMARY ***
Total pot $104.72 | Rake $3.00
Board [Qs 2h 3d 3c 6h]
Seat 1: Small Blind folded
Seat 2: Big Blind showed [3s 5s] and won ($101.72)
Seat 3: UTG folded
Seat 4: Hero showed [Jd Jh] and lost with...
Seat 5: Dealer folded



PokerStars Hand #3952187731:  Hold'em No Limit ($2.50/$5) - 2020/05/28 12:54:07 ET
Table '21592707' 9-max Seat #5 is the button
Seat 1: Hero ($835.61 in chips) 
Seat 2: UTG ($553.23 in chips) 
Seat 3: UTG+1 ($156.88 in chips) 
Seat 4: UTG+2 ($500.00 in chips) 
Seat 5: Dealer ($1280.83 in chips) 
Seat 6: Small Blind ($507.48 in chips) 
Small Blind: posts small blind $2.50
Hero: posts big blind $5
*** HOLE CARDS ***
Dealt to Hero [9h Td]
UTG: folds 
UTG+1: raises $5 to $10
UTG+2: folds 
Dealer: folds 
Small Blind: folds 
Hero: calls $5
*** FLOP *** [Jd Ts 6d]
Hero: checks 
UTG+1: checks 
*** TURN *** [Jd Ts 6d] [Jc]
Hero: checks 
UTG+1: bets $16.04
Hero: calls $16.04
*** RIVER *** [Jd Ts 6d Jc] [8c]
Hero: checks 
UTG+1: bets $38.90
Hero: calls $38.90
*** SHOW DOWN ***
Small Blind: shows [5h 9s] (a hand...)
Hero: shows [9h Td] (a hand...)
Dealer: shows [7c 5d] (a hand...)
UTG+2: shows [Tc Qs] (a hand...)
UTG: shows [3s 3d] (a hand...)
UTG+1: shows [As 8h] (a hand...)
Hero collected $128.38 from pot
*** SUMMARY ***
Total pot $132.38 | Rake $4.00
Board [Jd Ts 6d Jc 8c]
Seat 1: Hero showed [9h Td] and won ($128.38)
Seat 2: UTG folded
Seat 3: UTG+1 showed [As 8h] and lost with...
Seat 4: UTG+2 folded
Seat 5: Dealer folded
Seat 6: Small Blind folded



PokerStars Hand #3952185806:  Hold'em No Limit ($2.50/$5) - 2020/05/28 12:47:35 ET
Table '21593856' 9-max Seat #1 is the button
Seat 1: Dealer ($636.30 in chips) 
Seat 2: Small Blind ($511.00 in chips) 
Seat 3: Big Blind ($492.50 in chips) 
Seat 4: Hero ($699.07 in chips) 
Small Blind: posts small blind $2.50
Big Blind: posts big blind $5
*** HOLE CARDS ***
Dealt to Hero [7c Ac]
Hero: raises $7.50 to $12.50
Dealer: folds 
Small Blind: folds 
Big Blind: calls $7.50
*** FLOP *** [Jd Js 9c]
Big Blind: checks 
Hero: bets $7.84
Big Blind: calls $7.84
*** TURN *** [Jd Js 9c] [3d]
Big Blind: checks 
Hero: checks 
*** RIVER *** [Jd Js 9c 3d] [3c]
Big Blind: bets $50
Hero: folds 
*** SHOW DOWN ***
Small Blind: shows [8h Kc] (a hand...)
Dealer: shows [Ts 3s] (a hand...)
Big Blind: shows [Jc 8c] (a hand...)
Hero: shows [7c Ac] (a hand...)
Uncalled bet ($50.00) returned to Big Blind
Big Blind collected $41.03 from pot
*** SUMMARY ***
Total pot $43.18 | Rake $2.15
Board [Jd Js 9c 3d 3c]
Seat 1: Dealer folded
Seat 2: Small Blind folded
Seat 3: Big Blind collected ($41.03)
Seat 4: Hero folded



PokerStars Hand #3952183575:  Hold'em No Limit ($2.50/$5) - 2020/05/28 12:39:53 ET
Table '21592707' 9-max Seat #6 is the button
Seat 1: Hero ($834.48 in chips) 
Seat 2: Big Blind ($500.07 in chips) 
Seat 3: UTG ($365.18 in chips) 
Seat 4: UTG+1 ($500.00 in chips) 
Seat 5: UTG+2 ($622.45 in chips) 
Seat 6: Dealer ($537.48 in chips) 
Hero: posts small blind $2.50
Big Blind: posts big blind $5
*** HOLE CARDS ***
Dealt to Hero [Ad 4c]
UTG: folds 
UTG+1: folds 
UTG+2: folds 
Dealer: calls $5
Hero: calls $2.50
Big Blind: checks 
*** FLOP *** [Ks 9h Th]
Hero: checks 
Big Blind: checks 
Dealer: checks 
*** TURN *** [Ks 9h Th] [3c]
Hero: checks 
Big Blind: checks 
Dealer: checks 
*** RIVER *** [Ks 9h Th 3c] [6d]
Hero: checks 
Big Blind: bets $10.69
Dealer: folds 
Hero: folds 
*** SHOW DOWN ***
Big Blind: shows [Ts 6s] (a hand...)
Hero: shows [Ad 4c] (a hand...)
UTG+2: shows [Tc 6c] (a hand...)
Dealer: shows [2d Jd] (a hand...)
UTG: shows [Kd 7d] (a hand...)
UTG+1: shows [5d Ac] (a hand...)
Uncalled bet ($10.69) returned to Big Blind
Big Blind collected $14.25 from pot
*** SUMMARY ***
Total pot $15.00 | Rake $0.75
Board [Ks 9h Th 3c 6d]
Seat 1: Hero folded
Seat 2: Big Blind collected ($14.25)
Seat 3: UTG folded
Seat 4: UTG+1 folded
Seat 5: UTG+2 folded
Seat 6: Dealer folded



PokerStars Hand #3952183511:  Hold'em No Limit ($2.50/$5) - 2020/05/28 12:39:42 ET
Table '21593856' 9-max Seat #6 is the button
Seat 1: Small Blind ($594.10 in chips) 
Seat 2: Big Blind ($500.00 in chips) 
Seat 3: UTG ($645.78 in chips) 
Seat 4: UTG+1 ($462.00 in chips) 
Seat 5: UTG+2 ($496.72 in chips) 
Seat 6: Hero ($848.37 in chips) 
Small Blind: posts small blind $2.50
Big Blind: posts big blind $5
*** HOLE CARDS ***
Dealt to Hero [Ts Tc]
UTG: folds 
UTG+1: folds 
UTG+2: folds 
Hero: raises $7.50 to $12.50
Small Blind: folds 
Big Blind: calls $7.50
*** FLOP *** [4h 7h 3c]
Big Blind: checks 
Hero: bets $20
Big Blind: raises $38.07 to $58.07
Hero: calls $38.07
*** TURN *** [4h 7h 3c] [7s]
Big Blind: bets $99.73
Hero: calls $99.73
*** RIVER *** [4h 7h 3c 7s] [6s]
Big Blind: bets $329.70 and is all-in
Hero: folds 
*** SHOW DOWN ***
Small Blind: shows [9c Ad] (a hand...)
Big Blind: shows [6h Ah] (a hand...)
Hero: shows [Ts Tc] (a hand...)
UTG+2: shows [Qs 6c] (a hand...)
UTG: shows [2s Kc] (a hand...)
UTG+1: shows [3d 7d] (a hand...)
Uncalled bet ($329.70) returned to Big Blind
Big Blind collected $339.10 from pot
*** SUMMARY ***
Total pot $343.10 | Rake $4.00
Board [4h 7h 3c 7s 6s]
Seat 1: Small Blind folded
Seat 2: Big Blind collected ($339.10)
Seat 3: UTG folded
Seat 4: UTG+1 folded
Seat 5: UTG+2 folded
Seat 6: Hero folded



PokerStars Hand #3952180160:  Hold'em No Limit ($2.50/$5) - 2020/05/28 12:28:02 ET
Table '21593706' 9-max Seat #4 is the button
Seat 1: UTG ($500.00 in chips) 
Seat 2: UTG+1 ($718.81 in chips) 
Seat 3: UTG+2 ($568.30 in chips) 
Seat 4: Dealer ($892.77 in chips) 
Seat 5: Hero ($600.00 in chips) 
Seat 6: Big Blind ($748.23 in chips) 
Hero: posts small blind $2.50
Big Blind: posts big blind $5
*** HOLE CARDS ***
Dealt to Hero [Kc 2c]
UTG: folds 
UTG+1: folds 
UTG+2: folds 
Dealer: folds 
Hero: raises $10.00 to $15
Big Blind: calls $10
*** FLOP *** [Ad Ks 8d]
Hero: checks 
Big Blind: checks 
*** TURN *** [Ad Ks 8d] [7s]
Hero: checks 
Big Blind: bets $21.38
Hero: calls $21.38
*** RIVER *** [Ad Ks 8d 7s] [3d]
Hero: checks 
Big Blind: bets $41.85
Hero: folds 
*** SHOW DOWN ***
Big Blind: shows [Qd 6h] (a hand...)
Hero: shows [Kc 2c] (a hand...)
Dealer: shows [Kd 5c] (a hand...)
UTG+2: shows [3h 6c] (a hand...)
UTG: shows [3c Qh] (a hand...)
UTG+1: shows [Qs 7d] (a hand...)
Uncalled bet ($41.85) returned to Big Blind
Big Blind collected $69.13 from pot
*** SUMMARY ***
Total pot $72.76 | Rake $3.63
Board [Ad Ks 8d 7s 3d]
Seat 1: UTG folded
Seat 2: UTG+1 folded
Seat 3: UTG+2 folded
Seat 4: Dealer folded
Seat 5: Hero folded
Seat 6: Big Blind collected ($69.13)



PokerStars Hand #3952179098:  Hold'em No Limit ($2.50/$5) - 2020/05/28 12:24:11 ET
Table '21593778' 9-max Seat #2 is the button
Seat 1: Hero ($647.17 in chips) 
Seat 2: Dealer ($631.53 in chips) 
Dealer: posts small blind $2.50
Hero: posts big blind $5
*** HOLE CARDS ***
Dealt to Hero [7c Js]
Dealer: raises $5.00 to $10
Hero: calls $5
*** FLOP *** [2d 6d 7d]
Hero: checks 
Dealer: checks 
*** TURN *** [2d 6d 7d] [Ac]
Hero: checks 
Dealer: bets $13
Hero: calls $13
*** RIVER *** [2d 6d 7d Ac] [Jc]
Hero: checks 
Dealer: bets $30
Hero: calls $30
*** SHOW DOWN ***
Dealer: shows [9s Ah] (a hand...)
Hero: shows [7c Js] (a hand...)
Hero collected $105 from pot
*** SUMMARY ***
Total pot $106.00 | Rake $1.00
Board [2d 6d 7d Ac Jc]
Seat 1: Hero showed [7c Js] and won ($105)
Seat 2: Dealer showed [9s Ah] and lost with...



PokerStars Hand #3952178759:  Hold'em No Limit ($2.50/$5) - 2020/05/28 12:22:57 ET
Table '21593778' 9-max Seat #1 is the button
Seat 1: Hero ($715.17 in chips) 
Seat 2: Big Blind ($564.53 in chips) 
Hero: posts small blind $2.50
Big Blind: posts big blind $5
*** HOLE CARDS ***
Dealt to Hero [8c Qh]
Hero: raises $7.50 to $12.50
Big Blind: calls $7.50
*** FLOP *** [Tc Qs 2d]
Big Blind: checks 
Hero: checks 
*** TURN *** [Tc Qs 2d] [8s]
Big Blind: bets $17
Hero: calls $17
*** RIVER *** [Tc Qs 2d 8s] [Ad]
Big Blind: bets $38.50
Hero: calls $38.50
*** SHOW DOWN ***
Big Blind: shows [Kc Jd] (a hand...)
Hero: shows [8c Qh] (a hand...)
Big Blind collected $135 from pot
*** SUMMARY ***
Total pot $136.00 | Rake $1.00
Board [Tc Qs 2d 8s Ad]
Seat 1: Hero showed [8c Qh] and lost with...
Seat 2: Big Blind showed [Kc Jd] and won ($135)



PokerStars Hand #3952173241:  Hold'em No Limit ($2.50/$5) - 2020/05/28 12:02:58 ET
Table '21593856' 9-max Seat #2 is the button
Seat 1: Big Blind ($497.50 in chips) 
Seat 2: Dealer ($961.36 in chips) 
Seat 3: Hero ($916.11 in chips) 
Hero: posts small blind $2.50
Big Blind: posts big blind $5
*** HOLE CARDS ***
Dealt to Hero [4d 4h]
Dealer: folds 
Hero: raises $10.00 to $15
Big Blind: raises $30 to $45
Hero: calls $30
*** FLOP *** [2h Kc 6h]
Hero: checks 
Big Blind: bets $29
Hero: calls $29
*** TURN *** [2h Kc 6h] [7h]
Hero: checks 
Big Blind: checks 
*** RIVER *** [2h Kc 6h 7h] [3c]
Hero: checks 
Big Blind: bets $423.50 and is all-in
Hero: folds 
*** SHOW DOWN ***
Dealer: shows [2c 4s] (a hand...)
Big Blind: shows [Kd 7c] (a hand...)
Hero: shows [4d 4h] (a hand...)
Uncalled bet ($423.50) returned to Big Blind
Big Blind collected $146 from pot
*** SUMMARY ***
Total pot $148.00 | Rake $2.00
Board [2h Kc 6h 7h 3c]
Seat 1: Big Blind collected ($146)
Seat 2: Dealer folded
Seat 3: Hero folded



PokerStars Hand #3952172774:  Hold'em No Limit ($2.50/$5) - 2020/05/28 12:01:22 ET
Table '21592707' 9-max Seat #6 is the button
Seat 1: Hero ($600.93 in chips) 
Seat 2: Big Blind ($532.28 in chips) 
Seat 3: UTG ($275.88 in chips) 
Seat 4: UTG+1 ($492.50 in chips) 
Seat 5: UTG+2 ($823.63 in chips) 
Seat 6: Dealer ($536.00 in chips) 
Hero: posts small blind $2.50
Big Blind: posts big blind $5
*** HOLE CARDS ***
Dealt to Hero [9s 9h]
UTG: folds 
UTG+1: folds 
UTG+2: folds 
Dealer: folds 
Hero: raises $10.00 to $15
Big Blind: raises $35 to $50
Hero: calls $35
*** FLOP *** [Qc As 5c]
Hero: checks 
Big Blind: bets $35
Hero: calls $35
*** TURN *** [Qc As 5c] [2d]
Hero: checks 
Big Blind: checks 
*** RIVER *** [Qc As 5c 2d] [3d]
Hero: checks 
Big Blind: bets $110
Hero: calls $110
*** SHOW DOWN ***
Big Blind: shows [Ah Js] (a hand...)
Hero: shows [9s 9h] (a hand...)
UTG+2: shows [4s 3h] (a hand...)
Dealer: shows [7s 8c] (a hand...)
UTG: shows [5d 4c] (a hand...)
UTG+1: shows [8h 5s] (a hand...)
Big Blind collected $386 from pot
*** SUMMARY ***
Total pot $390.00 | Rake $4.00
Board [Qc As 5c 2d 3d]
Seat 1: Hero showed [9s 9h] and lost with...
Seat 2: Big Blind showed [Ah Js] and won ($386)
Seat 3: UTG folded
Seat 4: UTG+1 folded
Seat 5: UTG+2 folded
Seat 6: Dealer folded



PokerStars Hand #3952170451:  Hold'em No Limit ($2.50/$5) - 2020/05/28 11:53:38 ET
Table '21592707' 9-max Seat #4 is the button
Seat 1: Hero ($501.13 in chips) 
Seat 2: UTG ($500.00 in chips) 
Seat 3: UTG+1 ($596.01 in chips) 
Seat 4: Dealer ($515.00 in chips) 
Seat 5: Small Blind ($546.00 in chips) 
Small Blind: posts small blind $2.50
Hero: posts big blind $5
*** HOLE CARDS ***
Dealt to Hero [Td 9h]
UTG: folds 
UTG+1: folds 
Dealer: raises $7.50 to $12.50
Small Blind: folds 
Hero: calls $7.50
*** FLOP *** [7d 5s Th]
Hero: checks 
Dealer: bets $8.07
Hero: calls $8.07
*** TURN *** [7d 5s Th] [Kc]
Hero: checks 
Dealer: bets $31.10
Hero: calls $31.10
*** RIVER *** [7d 5s Th Kc] [5c]
Hero: checks 
Dealer: bets $77.13
Hero: calls $77.13
*** SHOW DOWN ***
Small Blind: shows [2c 3h] (a hand...)
Hero: shows [Td 9h] (a hand...)
Dealer: shows [8d Qd] (a hand...)
UTG: shows [Jc Ts] (a hand...)
UTG+1: shows [Jd 8s] (a hand...)
Hero collected $257.10 from pot
*** SUMMARY ***
Total pot $260.10 | Rake $3.00
Board [7d 5s Th Kc 5c]
Seat 1: Hero showed [Td 9h] and won ($257.10)
Seat 2: UTG folded
Seat 3: UTG+1 folded
Seat 4: Dealer showed [8d Qd] and lost with...
Seat 5: Small Blind folded



PokerStars Hand #3951938799:  Hold'em No Limit ($2.50/$5) - 2020/05/27 23:33:55 ET
Table '21589841' 9-max Seat #3 is the button
Seat 1: UTG ($494.75 in chips) 
Seat 2: UTG+1 ($500.00 in chips) 
Seat 3: Dealer ($523.50 in chips) 
Seat 4: Hero ($537.02 in chips) 
Seat 5: Big Blind ($500.00 in chips) 
Hero: posts small blind $2.50
Big Blind: posts big blind $5
*** HOLE CARDS ***
Dealt to Hero [8s 8d]
UTG: raises $5 to $10
UTG+1: folds 
Dealer: calls $10
Hero: calls $7.50
Big Blind: folds 
*** FLOP *** [4c 2s 5h]
Hero: checks 
UTG: checks 
Dealer: bets $24.94
Hero: calls $24.94
UTG: folds 
*** TURN *** [4c 2s 5h] [4d]
Hero: checks 
Dealer: bets $55
Hero: calls $55
*** RIVER *** [4c 2s 5h 4d] [Jd]
Hero: checks 
Dealer: bets $126.64
Hero: calls $126.64
*** SHOW DOWN ***
Big Blind: shows [8c 2d] (a hand...)
Hero: shows [8s 8d] (a hand...)
Dealer: shows [Tc Td] (a hand...)
UTG: shows [9c 9h] (a hand...)
UTG+1: shows [Jh 4s] (a hand...)
Dealer collected $445.16 from pot
*** SUMMARY ***
Total pot $448.16 | Rake $3.00
Board [4c 2s 5h 4d Jd]
Seat 1: UTG folded
Seat 2: UTG+1 folded
Seat 3: Dealer showed [Tc Td] and won ($445.16)
Seat 4: Hero showed [8s 8d] and lost with...
Seat 5: Big Blind folded



PokerStars Hand #3951937705:  Hold'em No Limit ($2.50/$5) - 2020/05/27 23:32:01 ET
Table '21588390' 9-max Seat #3 is the button
Seat 1: UTG+1 ($628.08 in chips) 
Seat 2: UTG+2 ($450.00 in chips) 
Seat 3: Hero ($495.50 in chips) 
Seat 4: Small Blind ($140.00 in chips) 
Seat 5: Big Blind ($495.73 in chips) 
Seat 6: UTG ($493.00 in chips) 
Small Blind: posts small blind $2.50
Big Blind: posts big blind $5
UTG+2: posts big blind $5
*** HOLE CARDS ***
Dealt to Hero [Th Qs]
UTG: folds 
UTG+1: folds 
UTG+2: raises $5 to $10
Hero: raises $30 to $40
Small Blind: folds 
Big Blind: folds 
UTG+2: raises $30 to $70
Hero: calls $30
*** FLOP *** [3h Tc Ks]
UTG+2: checks 
Hero: checks 
*** TURN *** [3h Tc Ks] [Td]
UTG+2: checks 
Hero: bets $92.14
UTG+2: raises $92.14 to $184.28
Hero: calls $92.14
*** RIVER *** [3h Tc Ks Td] [8d]
UTG+2: bets $195.72 and is all-in
Hero: calls $195.72
*** SHOW DOWN ***
Small Blind: shows [2c 6d] (a hand...)
Big Blind: shows [9h Kc] (a hand...)
Hero: shows [Th Qs] (a hand...)
UTG+2: shows [Ac As] (a hand...)
UTG: shows [Jd 5c] (a hand...)
UTG+1: shows [6h 3d] (a hand...)
Hero collected $903.50 from pot
*** SUMMARY ***
Total pot $907.50 | Rake $4.00
Board [3h Tc Ks Td 8d]
Seat 1: UTG+1 folded
Seat 2: UTG+2 showed [Ac As] and lost with...
Seat 3: Hero showed [Th Qs] and won ($903.50)
Seat 4: Small Blind folded
Seat 5: Big Blind folded
Seat 6: UTG folded



PokerStars Hand #3951928357:  Hold'em No Limit ($2.50/$5) - 2020/05/27 23:16:00 ET
Table '21588390' 9-max Seat #6 is the button
Seat 1: Small Blind ($495.00 in chips) 
Seat 2: Big Blind ($1226.78 in chips) 
Seat 3: Hero ($475.00 in chips) 
Seat 4: UTG+1 ($644.04 in chips) 
Seat 5: UTG+2 ($553.23 in chips) 
Seat 6: Dealer ($485.00 in chips) 
Small Blind: posts small blind $2.50
Big Blind: posts big blind $5
*** HOLE CARDS ***
Dealt to Hero [8d Ad]
Hero: raises $7.50 to $12.50
UTG+1: folds 
UTG+2: folds 
Dealer: folds 
Small Blind: calls $10
Big Blind: raises $7.50 to $20
Hero: calls $7.50
Small Blind: calls $7.50
*** FLOP *** [5s 7d 9d]
Small Blind: checks 
Big Blind: bets $23.97
Hero: raises $52.47 to $76.44
Small Blind: folds 
Big Blind: calls $52.47
*** TURN *** [5s 7d 9d] [Ah]
Big Blind: checks 
Hero: bets $83.55
Big Blind: calls $83.55
*** RIVER *** [5s 7d 9d Ah] [6h]
Big Blind: bets $297.03
Hero: calls $295.01 and is all-in
*** SHOW DOWN ***
Small Blind: shows [Ts Jc] (a hand...)
Big Blind: shows [Qc 8c] (a hand...)
Hero: shows [8d Ad] (a hand...)
UTG+2: shows [6s 9h] (a hand...)
Dealer: shows [2c 8s] (a hand...)
UTG+1: shows [Qd 6d] (a hand...)
Uncalled bet ($2.02) returned to Big Blind
Big Blind collected $483 from pot
Hero collected $483 from pot
*** SUMMARY ***
Total pot $970.00 | Rake $4.00
Board [5s 7d 9d Ah 6h]
Seat 1: Small Blind folded
Seat 2: Big Blind showed [Qc 8c] and won ($483)
Seat 3: Hero showed [8d Ad] and won ($483)
Seat 4: UTG+1 folded
Seat 5: UTG+2 folded
Seat 6: Dealer folded



PokerStars Hand #3951927711:  Hold'em No Limit ($2.50/$5) - 2020/05/27 23:14:55 ET
Table '21588390' 9-max Seat #5 is the button
Seat 1: Big Blind ($500.00 in chips) 
Seat 2: UTG ($1199.40 in chips) 
Seat 3: Hero ($497.50 in chips) 
Seat 4: UTG+2 ($644.04 in chips) 
Seat 5: Dealer ($553.23 in chips) 
Seat 6: Small Blind ($487.50 in chips) 
Small Blind: posts small blind $2.50
Big Blind: posts big blind $5
*** HOLE CARDS ***
Dealt to Hero [Kd Tc]
UTG: calls $5
Hero: raises $17.50 to $22.50
UTG+2: folds 
Dealer: folds 
Small Blind: folds 
Big Blind: folds 
UTG: calls $17.50
*** FLOP *** [4h 5h Ad]
UTG: checks 
Hero: checks 
*** TURN *** [4h 5h Ad] [2c]
UTG: checks 
Hero: checks 
*** RIVER *** [4h 5h Ad 2c] [5c]
UTG: bets $42.73
Hero: folds 
*** SHOW DOWN ***
Small Blind: shows [3s 8d] (a hand...)
Big Blind: shows [8c 2s] (a hand...)
Hero: shows [Kd Tc] (a hand...)
Dealer: shows [3c 5s] (a hand...)
UTG+2: shows [9d Qc] (a hand...)
UTG: shows [Kc 4c] (a hand...)
Uncalled bet ($42.73) returned to UTG
UTG collected $49.88 from pot
*** SUMMARY ***
Total pot $52.50 | Rake $2.62
Board [4h 5h Ad 2c 5c]
Seat 1: Big Blind folded
Seat 2: UTG collected ($49.88)
Seat 3: Hero folded
Seat 4: UTG+2 folded
Seat 5: Dealer folded
Seat 6: Small Blind folded



PokerStars Hand #3951924782:  Hold'em No Limit ($2.50/$5) - 2020/05/27 23:10:01 ET
Table '21588390' 9-max
Seat 1: Small Blind ($1030.16 in chips) 
Seat 2: Hero ($500.00 in chips) 
Seat 3: UTG ($626.73 in chips) 
Seat 4: UTG+1 ($492.50 in chips) 
Small Blind: posts small blind $2.50
Hero: posts big blind $5
*** HOLE CARDS ***
Dealt to Hero [Ts 7s]
UTG: folds 
UTG+1: folds 
Small Blind: calls $2.50
Hero: raises $15 to $20
Small Blind: calls $15
*** FLOP *** [5d 8c 9c]
Small Blind: checks 
Hero: bets $30
Small Blind: calls $30
*** TURN *** [5d 8c 9c] [7c]
Small Blind: checks 
Hero: checks 
*** RIVER *** [5d 8c 9c 7c] [2d]
Small Blind: bets $102.06
Hero: folds 
*** SHOW DOWN ***
UTG+1: shows [5s 3d] (a hand...)
Small Blind: shows [Ah 5c] (a hand...)
UTG: shows [6c 8h] (a hand...)
Hero: shows [Ts 7s] (a hand...)
Uncalled bet ($102.06) returned to Small Blind
Small Blind collected $97 from pot
*** SUMMARY ***
Total pot $100.00 | Rake $3.00
Board [5d 8c 9c 7c 2d]
Seat 1: Small Blind collected ($97)
Seat 2: Hero folded
Seat 3: UTG folded
Seat 4: UTG+1 folded



PokerStars Hand #3951923753:  Hold'em No Limit ($2.50/$5) - 2020/05/27 23:08:17 ET
Table '21589786' 9-max Seat #1 is the button
Seat 1: Dealer ($497.50 in chips) 
Seat 2: Hero ($586.50 in chips) 
Seat 3: Big Blind ($512.50 in chips) 
Hero: posts small blind $2.50
Big Blind: posts big blind $5
*** HOLE CARDS ***
Dealt to Hero [8c Qc]
Dealer: folds 
Hero: raises $10.00 to $15
Big Blind: calls $10
*** FLOP *** [6c Qs 6s]
Hero: checks 
Big Blind: checks 
*** TURN *** [6c Qs 6s] [Jh]
Hero: checks 
Big Blind: bets $19.25
Hero: calls $19.25
*** RIVER *** [6c Qs 6s Jh] [5h]
Hero: checks 
Big Blind: bets $38.25
Hero: calls $38.25
*** SHOW DOWN ***
Dealer: shows [2c Jd] (a hand...)
Big Blind: shows [Qh 3h] (a hand...)
Hero: shows [8c Qc] (a hand...)
Hero collected $71.50 from pot
Big Blind collected $71.50 from pot
*** SUMMARY ***
Total pot $145.00 | Rake $2.00
Board [6c Qs 6s Jh 5h]
Seat 1: Dealer folded
Seat 2: Hero showed [8c Qc] and won ($71.50)
Seat 3: Big Blind showed [Qh 3h] and won ($71.50)



PokerStars Hand #3951633204:  Hold'em No Limit ($2.50/$5) - 2020/05/27 12:53:17 ET
Table '21583585' 9-max Seat #3 is the button
Seat 1: Hero ($500.00 in chips) 
Seat 2: UTG+1 ($506.87 in chips) 
Seat 3: Dealer ($671.06 in chips) 
Seat 4: Small Blind ($500.00 in chips) 
Seat 5: Big Blind ($949.50 in chips) 
Small Blind: posts small blind $2.50
Big Blind: posts big blind $5
*** HOLE CARDS ***
Dealt to Hero [6d Ad]
Hero: raises $7.50 to $12.50
UTG+1: folds 
Dealer: calls $12.50
Small Blind: folds 
Big Blind: folds 
*** FLOP *** [5d Jh Th]
Hero: checks 
Dealer: checks 
*** TURN *** [5d Jh Th] [Ks]
Hero: bets $20
Dealer: calls $20
*** RIVER *** [5d Jh Th Ks] [Kc]
Hero: checks 
Dealer: bets $52.13
Hero: folds 
*** SHOW DOWN ***
Small Blind: shows [2s 3c] (a hand...)
Big Blind: shows [7h 2c] (a hand...)
Hero: shows [6d Ad] (a hand...)
Dealer: shows [2d Kd] (a hand...)
UTG+1: shows [4h 5c] (a hand...)
Uncalled bet ($52.13) returned to Dealer
Dealer collected $69.50 from pot
*** SUMMARY ***
Total pot $72.50 | Rake $3.00
Board [5d Jh Th Ks Kc]
Seat 1: Hero folded
Seat 2: UTG+1 folded
Seat 3: Dealer collected ($69.50)
Seat 4: Small Blind folded
Seat 5: Big Blind folded



PokerStars Hand #3951059894:  Hold'em No Limit ($2.50/$5) - 2020/05/26 12:10:06 ET
Table '21574969' 9-max Seat #2 is the button
Seat 1: Hero ($973.50 in chips) 
Seat 2: Dealer ($500.00 in chips) 
Seat 3: Small Blind ($1092.56 in chips) 
Seat 4: Big Blind ($467.66 in chips) 
Seat 5: UTG ($398.07 in chips) 
Seat 6: UTG+1 ($517.94 in chips) 
Small Blind: posts small blind $2.50
Big Blind: posts big blind $5
*** HOLE CARDS ***
Dealt to Hero [Qd Qh]
UTG: folds 
UTG+1: folds 
Hero: raises $7.50 to $12.50
Dealer: folds 
Small Blind: raises $42.50 to $55
Big Blind: folds 
Hero: calls $42.50
*** FLOP *** [Jc Kh 9s]
Small Blind: bets $35.50
Hero: calls $35.50
*** TURN *** [Jc Kh 9s] [7d]
Small Blind: bets $136.50
Hero: calls $136.50
*** RIVER *** [Jc Kh 9s 7d] [Th]
Small Blind: checks 
Hero: bets $343.27
Small Blind: raises $522.29 to $865.56 and is all-in
Hero: folds 
*** SHOW DOWN ***
Small Blind: shows [Ac Qs] (a hand...)
Big Blind: shows [Jd 4h] (a hand...)
Hero: shows [Qd Qh] (a hand...)
Dealer: shows [3d Ks] (a hand...)
UTG: shows [Td 5s] (a hand...)
UTG+1: shows [5c 7c] (a hand...)
Uncalled bet ($522.29) returned to Small Blind
Small Blind collected $1141.54 from pot
*** SUMMARY ***
Total pot $1145.54 | Rake $4.00
Board [Jc Kh 9s 7d Th]
Seat 1: Hero folded
Seat 2: Dealer folded
Seat 3: Small Blind collected ($1141.54)
Seat 4: Big Blind folded
Seat 5: UTG folded
Seat 6: UTG+1 folded



PokerStars Hand #3951059764:  Hold'em No Limit ($2.50/$5) - 2020/05/26 12:09:36 ET
Table '21575186' 9-max
Seat 1: UTG ($490.00 in chips) 
Seat 2: UTG+1 ($531.00 in chips) 
Seat 3: UTG+2 ($508.50 in chips) 
Seat 4: Small Blind ($536.00 in chips) 
Seat 5: Hero ($646.68 in chips) 
Small Blind: posts small blind $2.50
Hero: posts big blind $5
*** HOLE CARDS ***
Dealt to Hero [As Th]
UTG: folds 
UTG+1: raises $7.50 to $12.50
UTG+2: folds 
Small Blind: folds 
Hero: calls $7.50
*** FLOP *** [8h 9h Jc]
Hero: checks 
UTG+1: checks 
*** TURN *** [8h 9h Jc] [Tc]
Hero: checks 
UTG+1: checks 
*** RIVER *** [8h 9h Jc Tc] [Ks]
Hero: checks 
UTG+1: bets $13.07
Hero: calls $13.07
*** SHOW DOWN ***
Small Blind: shows [Qd 9d] (a hand...)
Hero: shows [As Th] (a hand...)
UTG+2: shows [8s 5h] (a hand...)
UTG: shows [8c 4s] (a hand...)
UTG+1: shows [6s 5s] (a hand...)
Hero collected $50.96 from pot
*** SUMMARY ***
Total pot $53.64 | Rake $2.68
Board [8h 9h Jc Tc Ks]
Seat 1: UTG folded
Seat 2: UTG+1 showed [6s 5s] and lost with...
Seat 3: UTG+2 folded
Seat 4: Small Blind folded
Seat 5: Hero showed [As Th] and won ($50.96)



PokerStars Hand #3951059409:  Hold'em No Limit ($2.50/$5) - 2020/05/26 12:08:01 ET
Table '21571687' 9-max Seat #1 is the button
Seat 1: Dealer ($527.85 in chips) 
Seat 2: Small Blind ($806.39 in chips) 
Seat 3: Hero ($528.63 in chips) 
Seat 4: UTG ($381.45 in chips) 
Seat 5: UTG+1 ($500.00 in chips) 
Seat 6: UTG+2 ($961.32 in chips) 
Small Blind: posts small blind $2.50
Hero: posts big blind $5
*** HOLE CARDS ***
Dealt to Hero [5h 5s]
UTG: folds 
UTG+1: folds 
UTG+2: folds 
Dealer: calls $5
Small Blind: folds 
Hero: checks 
*** FLOP *** [8d 6s 4c]
Hero: checks 
Dealer: bets $10
Hero: calls $10
*** TURN *** [8d 6s 4c] [Qh]
Hero: checks 
Dealer: checks 
*** RIVER *** [8d 6s 4c Qh] [As]
Hero: checks 
Dealer: bets $20
Hero: folds 
*** SHOW DOWN ***
Small Blind: shows [2d Js] (a hand...)
Hero: shows [5h 5s] (a hand...)
Dealer: shows [Kd 5d] (a hand...)
UTG+2: shows [3c Tc] (a hand...)
UTG: shows [Jh 9c] (a hand...)
UTG+1: shows [Qc 8c] (a hand...)
Uncalled bet ($20) returned to Dealer
Dealer collected $30.88 from pot
*** SUMMARY ***
Total pot $32.50 | Rake $1.62
Board [8d 6s 4c Qh As]
Seat 1: Dealer collected ($30.88)
Seat 2: Small Blind folded
Seat 3: Hero folded
Seat 4: UTG folded
Seat 5: UTG+1 folded
Seat 6: UTG+2 folded



PokerStars Hand #3951058540:  Hold'em No Limit ($2.50/$5) - 2020/05/26 12:04:50 ET
Table '21573697' 9-max Seat #2 is the button
Seat 1: UTG+2 ($539.38 in chips) 
Seat 2: Hero ($497.50 in chips) 
Seat 3: Small Blind ($367.96 in chips) 
Seat 4: Big Blind ($567.50 in chips) 
Seat 5: UTG ($507.50 in chips) 
Seat 6: UTG+1 ($540.05 in chips) 
Small Blind: posts small blind $2.50
Big Blind: posts big blind $5
*** HOLE CARDS ***
Dealt to Hero [Jh Ah]
UTG: folds 
UTG+1: folds 
UTG+2: raises $7.50 to $12.50
Hero: calls $12.50
Small Blind: calls $10
Big Blind: folds 
*** FLOP *** [Qh Qc Td]
Small Blind: checks 
UTG+2: checks 
Hero: bets $13.32
Small Blind: calls $13.32
UTG+2: folds 
*** TURN *** [Qh Qc Td] [5d]
Small Blind: checks 
Hero: bets $49.27
Small Blind: calls $49.27
*** RIVER *** [Qh Qc Td 5d] [7s]
Small Blind: bets $86.84
Hero: folds 
*** SHOW DOWN ***
Small Blind: shows [Qs Qd] (a hand...)
Big Blind: shows [Ad 9c] (a hand...)
Hero: shows [Jh Ah] (a hand...)
UTG+2: shows [3s Ks] (a hand...)
UTG: shows [Ac 6s] (a hand...)
UTG+1: shows [8s Th] (a hand...)
Uncalled bet ($86.84) returned to Small Blind
Small Blind collected $163.68 from pot
*** SUMMARY ***
Total pot $167.68 | Rake $4.00
Board [Qh Qc Td 5d 7s]
Seat 1: UTG+2 folded
Seat 2: Hero folded
Seat 3: Small Blind collected ($163.68)
Seat 4: Big Blind folded
Seat 5: UTG folded
Seat 6: UTG+1 folded



PokerStars Hand #3951055903:  Hold'em No Limit ($2.50/$5) - 2020/05/26 11:55:13 ET
Table '21571687' 9-max Seat #2 is the button
Seat 1: UTG+1 ($500.00 in chips) 
Seat 2: Dealer ($587.93 in chips) 
Seat 3: Hero ($501.50 in chips) 
Seat 4: Big Blind ($484.20 in chips) 
Seat 5: UTG ($908.74 in chips) 
Hero: posts small blind $2.50
Big Blind: posts big blind $5
*** HOLE CARDS ***
Dealt to Hero [9s 9d]
UTG: folds 
UTG+1: folds 
Dealer: raises $7.50 to $12.50
Hero: raises $42.50 to $55
Big Blind: folds 
Dealer: calls $42.50
*** FLOP *** [4h 3c Ts]
Hero: checks 
Dealer: bets $36.98
Hero: calls $36.98
*** TURN *** [4h 3c Ts] [Qh]
Hero: checks 
Dealer: bets $129.48
Hero: calls $129.48
*** RIVER *** [4h 3c Ts Qh] [Ks]
Hero: checks 
Dealer: bets $366.47 and is all-in
Hero: folds 
*** SHOW DOWN ***
Big Blind: shows [Ac 3s] (a hand...)
Hero: shows [9s 9d] (a hand...)
Dealer: shows [4d 4c] (a hand...)
UTG: shows [7h 2h] (a hand...)
UTG+1: shows [Jd 2d] (a hand...)
Uncalled bet ($366.47) returned to Dealer
Dealer collected $444.92 from pot
*** SUMMARY ***
Total pot $447.92 | Rake $3.00
Board [4h 3c Ts Qh Ks]
Seat 1: UTG+1 folded
Seat 2: Dealer collected ($444.92)
Seat 3: Hero folded
Seat 4: Big Blind folded
Seat 5: UTG folded



PokerStars Hand #3951054454:  Hold'em No Limit ($2.50/$5) - 2020/05/26 11:49:44 ET
Table '21574969' 9-max
Seat 1: Hero ($497.50 in chips) 
Seat 2: Small Blind ($989.18 in chips) 
Seat 3: Big Blind ($369.27 in chips) 
Seat 4: UTG ($908.94 in chips) 
Seat 5: UTG+1 ($201.51 in chips) 
Small Blind: posts small blind $2.50
Big Blind: posts big blind $5
*** HOLE CARDS ***
Dealt to Hero [As Ts]
UTG: folds 
UTG+1: folds 
Hero: raises $7.50 to $12.50
Small Blind: folds 
Big Blind: calls $7.50
*** FLOP *** [6h 4c Ks]
Big Blind: checks 
Hero: bets $7.84
Big Blind: raises $7.84 to $15.68
Hero: calls $7.84
*** TURN *** [6h 4c Ks] [Kc]
Big Blind: checks 
Hero: bets $13.98
Big Blind: calls $13.98
*** RIVER *** [6h 4c Ks Kc] [Ad]
Big Blind: bets $83.82
Hero: calls $83.82
*** SHOW DOWN ***
Small Blind: shows [Js 5h] (a hand...)
Big Blind: shows [6d 6s] (a hand...)
Hero: shows [As Ts] (a hand...)
UTG: shows [5c Qh] (a hand...)
UTG+1: shows [4d 3d] (a hand...)
Big Blind collected $251.46 from pot
*** SUMMARY ***
Total pot $254.46 | Rake $3.00
Board [6h 4c Ks Kc Ad]
Seat 1: Hero showed [As Ts] and lost with...
Seat 2: Small Blind folded
Seat 3: Big Blind showed [6d 6s] and won ($251.46)
Seat 4: UTG folded
Seat 5: UTG+1 folded



PokerStars Hand #3948773156:  Hold'em No Limit ($2.50/$5) - 2020/05/22 15:03:46 ET
Table '21536814' 9-max Seat #1 is the button
Seat 1: Hero ($530.31 in chips) 
Seat 2: Small Blind ($333.87 in chips) 
Seat 3: Big Blind ($533.63 in chips) 
Seat 4: UTG ($500.00 in chips) 
Seat 5: UTG+1 ($500.00 in chips) 
Seat 6: UTG+2 ($500.00 in chips) 
Small Blind: posts small blind $2.50
Big Blind: posts big blind $5
*** HOLE CARDS ***
Dealt to Hero [Tc Jd]
UTG: raises $7.50 to $12.50
UTG+1: folds 
UTG+2: folds 
Hero: calls $12.50
Small Blind: calls $10
Big Blind: folds 
*** FLOP *** [As Js Ac]
Small Blind: checks 
UTG: checks 
Hero: checks 
*** TURN *** [As Js Ac] [3s]
Small Blind: bets $10
UTG: folds 
Hero: calls $10
*** RIVER *** [As Js Ac 3s] [Ts]
Small Blind: bets $79.38
Hero: folds 
*** SHOW DOWN ***
Small Blind: shows [Jc Ad] (a hand...)
Big Blind: shows [6s 9h] (a hand...)
Hero: shows [Tc Jd] (a hand...)
UTG+2: shows [4d 6d] (a hand...)
UTG: shows [8d 8h] (a hand...)
UTG+1: shows [7c 7h] (a hand...)
Uncalled bet ($79.38) returned to Small Blind
Small Blind collected $59.38 from pot
*** SUMMARY ***
Total pot $62.50 | Rake $3.12
Board [As Js Ac 3s Ts]
Seat 1: Hero folded
Seat 2: Small Blind collected ($59.38)
Seat 3: Big Blind folded
Seat 4: UTG folded
Seat 5: UTG+1 folded
Seat 6: UTG+2 folded



PokerStars Hand #3948769592:  Hold'em No Limit ($2.50/$5) - 2020/05/22 14:55:25 ET
Table '21534579' 9-max Seat #2 is the button
Seat 1: Hero ($751.59 in chips) 
Seat 2: Dealer ($1713.29 in chips) 
Seat 3: Small Blind ($582.37 in chips) 
Seat 4: Big Blind ($873.81 in chips) 
Seat 5: UTG ($554.13 in chips) 
Small Blind: posts small blind $2.50
Big Blind: posts big blind $5
*** HOLE CARDS ***
Dealt to Hero [Jh 8h]
UTG: folds 
Hero: raises $7.50 to $12.50
Dealer: folds 
Small Blind: calls $10
Big Blind: folds 
*** FLOP *** [2s Qs 3s]
Small Blind: checks 
Hero: bets $20
Small Blind: calls $20
*** TURN *** [2s Qs 3s] [Tc]
Small Blind: checks 
Hero: checks 
*** RIVER *** [2s Qs 3s Tc] [Kc]
Small Blind: bets $25
Hero: folds 
*** SHOW DOWN ***
Small Blind: shows [As 9c] (a hand...)
Big Blind: shows [4s Kh] (a hand...)
Hero: shows [Jh 8h] (a hand...)
Dealer: shows [3c Kd] (a hand...)
UTG: shows [8c 3d] (a hand...)
Uncalled bet ($25.00) returned to Small Blind
Small Blind collected $67 from pot
*** SUMMARY ***
Total pot $70.00 | Rake $3.00
Board [2s Qs 3s Tc Kc]
Seat 1: Hero folded
Seat 2: Dealer folded
Seat 3: Small Blind collected ($67)
Seat 4: Big Blind folded
Seat 5: UTG folded



PokerStars Hand #3948767269:  Hold'em No Limit ($2.50/$5) - 2020/05/22 14:49:57 ET
Table '21533308' 9-max Seat #6 is the button
Seat 1: Small Blind ($525.21 in chips) 
Seat 2: Hero ($559.01 in chips) 
Seat 3: UTG ($1690.40 in chips) 
Seat 4: UTG+1 ($2900.54 in chips) 
Seat 5: UTG+2 ($492.50 in chips) 
Seat 6: Dealer ($492.50 in chips) 
Small Blind: posts small blind $2.50
Hero: posts big blind $5
*** HOLE CARDS ***
Dealt to Hero [7d Ah]
UTG: folds 
UTG+1: raises $5 to $10
UTG+2: folds 
Dealer: folds 
Small Blind: calls $7.50
Hero: calls $5
*** FLOP *** [9s 2c Ac]
Small Blind: checks 
Hero: checks 
UTG+1: checks 
*** TURN *** [9s 2c Ac] [2h]
Small Blind: bets $9.25
Hero: calls $9.25
UTG+1: folds 
*** RIVER *** [9s 2c Ac 2h] [6c]
Small Blind: bets $46.08
Hero: folds 
*** SHOW DOWN ***
Small Blind: shows [8s 8h] (a hand...)
Hero: shows [7d Ah] (a hand...)
UTG+2: shows [Kd Th] (a hand...)
Dealer: shows [Kc Jd] (a hand...)
UTG: shows [3c 6d] (a hand...)
UTG+1: shows [Kh Tc] (a hand...)
Uncalled bet ($46.08) returned to Small Blind
Small Blind collected $46.08 from pot
*** SUMMARY ***
Total pot $48.50 | Rake $2.42
Board [9s 2c Ac 2h 6c]
Seat 1: Small Blind collected ($46.08)
Seat 2: Hero folded
Seat 3: UTG folded
Seat 4: UTG+1 folded
Seat 5: UTG+2 folded
Seat 6: Dealer folded



PokerStars Hand #3948764686:  Hold'em No Limit ($2.50/$5) - 2020/05/22 14:43:44 ET
Table '21533308' 9-max Seat #4 is the button
Seat 1: UTG ($537.71 in chips) 
Seat 2: Hero ($564.01 in chips) 
Seat 3: UTG+2 ($1651.52 in chips) 
Seat 4: Dealer ($2901.66 in chips) 
Seat 5: Small Blind ($461.00 in chips) 
Seat 6: Big Blind ($500.00 in chips) 
Small Blind: posts small blind $2.50
Big Blind: posts big blind $5
*** HOLE CARDS ***
Dealt to Hero [7s 7c]
UTG: folds 
Hero: raises $7.50 to $12.50
UTG+2: calls $12.50
Dealer: calls $12.50
Small Blind: folds 
Big Blind: folds 
*** FLOP *** [Js Ad 3s]
Hero: checks 
UTG+2: checks 
Dealer: checks 
*** TURN *** [Js Ad 3s] [4s]
Hero: checks 
UTG+2: checks 
Dealer: checks 
*** RIVER *** [Js Ad 3s 4s] [Kd]
Hero: checks 
UTG+2: bets $42.75
Dealer: folds 
Hero: folds 
*** SHOW DOWN ***
Small Blind: shows [8d 9c] (a hand...)
Big Blind: shows [3d 9h] (a hand...)
Hero: shows [7s 7c] (a hand...)
Dealer: shows [4h 7h] (a hand...)
UTG+2: shows [Qd Th] (a hand...)
UTG: shows [Qs 6s] (a hand...)
Uncalled bet ($42.75) returned to UTG+2
UTG+2 collected $42.75 from pot
*** SUMMARY ***
Total pot $45.00 | Rake $2.25
Board [Js Ad 3s 4s Kd]
Seat 1: UTG folded
Seat 2: Hero folded
Seat 3: UTG+2 collected ($42.75)
Seat 4: Dealer folded
Seat 5: Small Blind folded
Seat 6: Big Blind folded



PokerStars Hand #3948762282:  Hold'em No Limit ($2.50/$5) - 2020/05/22 14:37:55 ET
Table '21536657' 9-max Seat #2 is the button
Seat 1: UTG ($500.00 in chips) 
Seat 2: Hero ($548.50 in chips) 
Seat 3: Small Blind ($523.83 in chips) 
Seat 4: Big Blind ($531.90 in chips) 
Small Blind: posts small blind $2.50
Big Blind: posts big blind $5
*** HOLE CARDS ***
Dealt to Hero [Jc As]
UTG: folds 
Hero: raises $7.50 to $12.50
Small Blind: folds 
Big Blind: calls $7.50
*** FLOP *** [5s Th Qd]
Big Blind: checks 
Hero: checks 
*** TURN *** [5s Th Qd] [6s]
Big Blind: checks 
Hero: checks 
*** RIVER *** [5s Th Qd 6s] [7h]
Big Blind: bets $20.34
Hero: folds 
*** SHOW DOWN ***
Small Blind: shows [4c Qc] (a hand...)
UTG: shows [2s 9h] (a hand...)
Big Blind: shows [Kd 9c] (a hand...)
Hero: shows [Jc As] (a hand...)
Uncalled bet ($20.34) returned to Big Blind
Big Blind collected $26.13 from pot
*** SUMMARY ***
Total pot $27.50 | Rake $1.37
Board [5s Th Qd 6s 7h]
Seat 1: UTG folded
Seat 2: Hero folded
Seat 3: Small Blind folded
Seat 4: Big Blind collected ($26.13)



PokerStars Hand #3948755430:  Hold'em No Limit ($2.50/$5) - 2020/05/22 14:21:30 ET
Table '21536594' 9-max Seat #6 is the button
Seat 1: Small Blind ($272.50 in chips) 
Seat 2: Hero ($500.00 in chips) 
Seat 3: UTG ($507.50 in chips) 
Seat 4: UTG+1 ($561.00 in chips) 
Seat 5: UTG+2 ($150.00 in chips) 
Seat 6: Dealer ($520.38 in chips) 
Small Blind: posts small blind $2.50
Hero: posts big blind $5
*** HOLE CARDS ***
Dealt to Hero [2h 7d]
UTG: folds 
UTG+1: folds 
UTG+2: folds 
Dealer: folds 
Small Blind: calls $2.50
Hero: checks 
*** FLOP *** [Kc 9s 8c]
Small Blind: checks 
Hero: checks 
*** TURN *** [Kc 9s 8c] [2d]
Small Blind: checks 
Hero: checks 
*** RIVER *** [Kc 9s 8c 2d] [Qd]
Small Blind: bets $10
Hero: folds 
*** SHOW DOWN ***
Small Blind: shows [Qs 4s] (a hand...)
Hero: shows [2h 7d] (a hand...)
UTG+2: shows [2c 3d] (a hand...)
Dealer: shows [9d 4h] (a hand...)
UTG: shows [3h 4c] (a hand...)
UTG+1: shows [6h 2s] (a hand...)
Uncalled bet ($10.00) returned to Small Blind
Small Blind collected $9.50 from pot
*** SUMMARY ***
Total pot $10.00 | Rake $0.50
Board [Kc 9s 8c 2d Qd]
Seat 1: Small Blind collected ($9.50)
Seat 2: Hero folded
Seat 3: UTG folded
Seat 4: UTG+1 folded
Seat 5: UTG+2 folded
Seat 6: Dealer folded



PokerStars Hand #3948753185:  Hold'em No Limit ($2.50/$5) - 2020/05/22 14:16:05 ET
Table '21536657' 9-max Seat #1 is the button
Seat 1: Hero ($500.00 in chips) 
Seat 2: Big Blind ($500.00 in chips) 
Hero: posts small blind $2.50
Big Blind: posts big blind $5
*** HOLE CARDS ***
Dealt to Hero [Qh Kc]
Hero: raises $7.50 to $12.50
Big Blind: calls $7.50
*** FLOP *** [7h 2s 9c]
Big Blind: checks 
Hero: bets $7.20
Big Blind: calls $7.20
*** TURN *** [7h 2s 9c] [4s]
Big Blind: checks 
Hero: checks 
*** RIVER *** [7h 2s 9c 4s] [8s]
Big Blind: bets $19.20
Hero: folds 
*** SHOW DOWN ***
Big Blind: shows [Ts 6d] (a hand...)
Hero: shows [Qh Kc] (a hand...)
Uncalled bet ($19.20) returned to Big Blind
Big Blind collected $38.40 from pot
*** SUMMARY ***
Total pot $39.40 | Rake $1.00
Board [7h 2s 9c 4s 8s]
Seat 1: Hero folded
Seat 2: Big Blind collected ($38.40)



PokerStars Hand #3948738361:  Hold'em No Limit ($2.50/$5) - 2020/05/22 13:38:39 ET
Table '21533308' 9-max Seat #6 is the button
Seat 1: Small Blind ($516.28 in chips) 
Seat 2: Hero ($480.00 in chips) 
Seat 3: UTG ($1297.94 in chips) 
Seat 4: UTG+1 ($2303.30 in chips) 
Seat 5: UTG+2 ($668.48 in chips) 
Seat 6: Dealer ($167.50 in chips) 
Small Blind: posts small blind $2.50
Hero: posts big blind $5
*** HOLE CARDS ***
Dealt to Hero [Kh 8s]
UTG: folds 
UTG+1: calls $5
UTG+2: folds 
Dealer: folds 
Small Blind: folds 
Hero: checks 
*** FLOP *** [5s 7d As]
Hero: checks 
UTG+1: checks 
*** TURN *** [5s 7d As] [Qh]
Hero: checks 
UTG+1: checks 
*** RIVER *** [5s 7d As Qh] [Js]
Hero: checks 
UTG+1: bets $10
Hero: folds 
*** SHOW DOWN ***
Small Blind: shows [2c 9d] (a hand...)
Hero: shows [Kh 8s] (a hand...)
UTG+2: shows [3c Jh] (a hand...)
Dealer: shows [6d Qc] (a hand...)
UTG: shows [Ks 2s] (a hand...)
UTG+1: shows [6s 3s] (a hand...)
Uncalled bet ($10) returned to UTG+1
UTG+1 collected $11.88 from pot
*** SUMMARY ***
Total pot $12.50 | Rake $0.62
Board [5s 7d As Qh Js]
Seat 1: Small Blind folded
Seat 2: Hero folded
Seat 3: UTG folded
Seat 4: UTG+1 collected ($11.88)
Seat 5: UTG+2 folded
Seat 6: Dealer folded



PokerStars Hand #3948734349:  Hold'em No Limit ($2.50/$5) - 2020/05/22 13:27:39 ET
Table '21535841' 9-max Seat #2 is the button
Seat 1: UTG+1 ($923.65 in chips) 
Seat 2: Hero ($1276.87 in chips) 
Seat 3: Small Blind ($797.63 in chips) 
Seat 4: Big Blind ($514.77 in chips) 
Seat 5: UTG ($505.78 in chips) 
Small Blind: posts small blind $2.50
Big Blind: posts big blind $5
*** HOLE CARDS ***
Dealt to Hero [Qs Qd]
UTG: folds 
UTG+1: raises $10 to $15
Hero: raises $30 to $45
Small Blind: folds 
Big Blind: folds 
UTG+1: calls $30
*** FLOP *** [7d 7c Js]
UTG+1: checks 
Hero: bets $30
UTG+1: calls $30
*** TURN *** [7d 7c Js] [Jc]
UTG+1: checks 
Hero: checks 
*** RIVER *** [7d 7c Js Jc] [4d]
UTG+1: bets $115.88
Hero: calls $115.88
*** SHOW DOWN ***
Small Blind: shows [5c 8h] (a hand...)
Big Blind: shows [Th 6s] (a hand...)
Hero: shows [Qs Qd] (a hand...)
UTG: shows [6h Ad] (a hand...)
UTG+1: shows [Ac Kh] (a hand...)
Hero collected $386.26 from pot
*** SUMMARY ***
Total pot $389.26 | Rake $3.00
Board [7d 7c Js Jc 4d]
Seat 1: UTG+1 showed [Ac Kh] and lost with...
Seat 2: Hero showed [Qs Qd] and won ($386.26)
Seat 3: Small Blind folded
Seat 4: Big Blind folded
Seat 5: UTG folded



PokerStars Hand #3948732380:  Hold'em No Limit ($2.50/$5) - 2020/05/22 13:22:05 ET
Table '21535032' 9-max Seat #3 is the button
Seat 1: Hero ($520.00 in chips) 
Seat 2: UTG+1 ($1219.29 in chips) 
Seat 3: Dealer ($611.11 in chips) 
Seat 4: Small Blind ($860.38 in chips) 
Seat 5: Big Blind ($506.32 in chips) 
Small Blind: posts small blind $2.50
Big Blind: posts big blind $5
*** HOLE CARDS ***
Dealt to Hero [Kh As]
Hero: raises $7.50 to $12.50
UTG+1: folds 
Dealer: folds 
Small Blind: folds 
Big Blind: raises $37.50 to $50
Hero: raises $70.00 to $120
Big Blind: calls $70
*** FLOP *** [9c Jh 5d]
Big Blind: checks 
Hero: bets $63.87
Big Blind: calls $63.87
*** TURN *** [9c Jh 5d] [Td]
Big Blind: checks 
Hero: checks 
*** RIVER *** [9c Jh 5d Td] [Jd]
Big Blind: bets $112
Hero: folds 
*** SHOW DOWN ***
Small Blind: shows [4s Qh] (a hand...)
Big Blind: shows [Qc Qd] (a hand...)
Hero: shows [Kh As] (a hand...)
Dealer: shows [4d Jc] (a hand...)
UTG+1: shows [Ac 5h] (a hand...)
Uncalled bet ($112.00) returned to Big Blind
Big Blind collected $367.24 from pot
*** SUMMARY ***
Total pot $370.24 | Rake $3.00
Board [9c Jh 5d Td Jd]
Seat 1: Hero folded
Seat 2: UTG+1 folded
Seat 3: Dealer folded
Seat 4: Small Blind folded
Seat 5: Big Blind collected ($367.24)



PokerStars Hand #3948729812:  Hold'em No Limit ($2.50/$5) - 2020/05/22 13:14:32 ET
Table '21535841' 9-max Seat #1 is the button
Seat 1: Dealer ($510.88 in chips) 
Seat 2: Small Blind ($1144.30 in chips) 
Seat 3: Hero ($519.61 in chips) 
Seat 4: UTG ($560.27 in chips) 
Seat 5: UTG+1 ($467.47 in chips) 
Small Blind: posts small blind $2.50
Hero: posts big blind $5
*** HOLE CARDS ***
Dealt to Hero [9h 9s]
UTG: folds 
UTG+1: folds 
Dealer: raises $5 to $10
Small Blind: calls $7.50
Hero: raises $50 to $60
Dealer: calls $50
Small Blind: folds 
*** FLOP *** [3h 9d Jh]
Hero: bets $38.10
Dealer: calls $38.10
*** TURN *** [3h 9d Jh] [9c]
Hero: checks 
Dealer: bets $67.06
Hero: calls $67.06
*** RIVER *** [3h 9d Jh 9c] [4s]
Hero: checks 
Dealer: bets $345.72 and is all-in
Hero: calls $345.72
*** SHOW DOWN ***
Small Blind: shows [2c 6c] (a hand...)
Hero: shows [9h 9s] (a hand...)
Dealer: shows [3d 3c] (a hand...)
UTG: shows [Ts 5s] (a hand...)
UTG+1: shows [8c 4c] (a hand...)
Hero collected $1028.76 from pot
*** SUMMARY ***
Total pot $1031.76 | Rake $3.00
Board [3h 9d Jh 9c 4s]
Seat 1: Dealer showed [3d 3c] and lost with...
Seat 2: Small Blind folded
Seat 3: Hero showed [9h 9s] and won ($1028.76)
Seat 4: UTG folded
Seat 5: UTG+1 folded



PokerStars Hand #3948728313:  Hold'em No Limit ($2.50/$5) - 2020/05/22 13:10:17 ET
Table '21535228' 9-max Seat #4 is the button
Seat 1: Big Blind ($500.00 in chips) 
Seat 2: UTG ($334.00 in chips) 
Seat 3: UTG+1 ($497.50 in chips) 
Seat 4: Hero ($492.50 in chips) 
Big Blind: posts big blind $5
*** HOLE CARDS ***
Dealt to Hero [Js Td]
UTG: calls $5
UTG+1: folds 
Hero: raises $15 to $20
Big Blind: folds 
UTG: calls $15
*** FLOP *** [8s Jc 8c]
UTG: bets $5
Hero: raises $26.38 to $31.38
UTG: calls $26.38
*** TURN *** [8s Jc 8c] [2s]
UTG: bets $35
Hero: calls $35
*** RIVER *** [8s Jc 8c 2s] [4d]
UTG: bets $55
Hero: calls $55
*** SHOW DOWN ***
Hero: shows [Js Td] (a hand...)
UTG: shows [Qh 5c] (a hand...)
Big Blind: shows [Kh 7s] (a hand...)
UTG+1: shows [Tc 6s] (a hand...)
Hero collected $284.76 from pot
*** SUMMARY ***
Total pot $287.76 | Rake $3.00
Board [8s Jc 8c 2s 4d]
Seat 1: Big Blind folded
Seat 2: UTG showed [Qh 5c] and lost with...
Seat 3: UTG+1 folded
Seat 4: Hero showed [Js Td] and won ($284.76)



PokerStars Hand #3948727533:  Hold'em No Limit ($2.50/$5) - 2020/05/22 13:08:04 ET
Table '21535032' 9-max Seat #1 is the button
Seat 1: Hero ($492.50 in chips) 
Seat 2: Small Blind ($1205.41 in chips) 
Seat 3: Big Blind ($500.00 in chips) 
Seat 4: UTG ($922.00 in chips) 
Seat 5: UTG+1 ($500.00 in chips) 
Small Blind: posts small blind $2.50
Big Blind: posts big blind $5
*** HOLE CARDS ***
Dealt to Hero [Js Jd]
UTG: folds 
UTG+1: folds 
Hero: raises $7.50 to $12.50
Small Blind: folds 
Big Blind: calls $7.50
*** FLOP *** [5c 5d Qd]
Big Blind: checks 
Hero: bets $7.84
Big Blind: calls $7.84
*** TURN *** [5c 5d Qd] [Ad]
Big Blind: checks 
Hero: checks 
*** RIVER *** [5c 5d Qd Ad] [Qs]
Big Blind: bets $32.31
Hero: calls $32.31
*** SHOW DOWN ***
Small Blind: shows [Kd 9h] (a hand...)
Big Blind: shows [5h Th] (a hand...)
Hero: shows [Js Jd] (a hand...)
UTG: shows [7c Ks] (a hand...)
UTG+1: shows [Jh 3h] (a hand...)
Big Blind collected $104.80 from pot
*** SUMMARY ***
Total pot $107.80 | Rake $3.00
Board [5c 5d Qd Ad Qs]
Seat 1: Hero showed [Js Jd] and lost with...
Seat 2: Small Blind folded
Seat 3: Big Blind showed [5h Th] and won ($104.80)
Seat 4: UTG folded
Seat 5: UTG+1 folded



PokerStars Hand #3948167713:  Hold'em No Limit ($2.50/$5) - 2020/05/21 14:25:00 ET
Table '21524041' 9-max Seat #3 is the button
Seat 1: UTG+1 ($500.00 in chips) 
Seat 2: UTG+2 ($500.00 in chips) 
Seat 3: Dealer ($602.31 in chips) 
Seat 4: Small Blind ($652.30 in chips) 
Seat 5: Big Blind ($500.00 in chips) 
Seat 6: Hero ($641.17 in chips) 
Small Blind: posts small blind $2.50
Big Blind: posts big blind $5
*** HOLE CARDS ***
Dealt to Hero [As Qs]
Hero: raises $10 to $15
UTG+1: folds 
UTG+2: folds 
Dealer: folds 
Small Blind: raises $35.00 to $50
Big Blind: folds 
Hero: calls $35
*** FLOP *** [Kc 5h 3s]
Small Blind: bets $65
Hero: calls $65
*** TURN *** [Kc 5h 3s] [6s]
Small Blind: checks 
Hero: checks 
*** RIVER *** [Kc 5h 3s 6s] [Tc]
Small Blind: bets $170
Hero: folds 
*** SHOW DOWN ***
Small Blind: shows [Qd Ac] (a hand...)
Big Blind: shows [7d 8s] (a hand...)
Hero: shows [As Qs] (a hand...)
Dealer: shows [Jc 5d] (a hand...)
UTG+2: shows [Ah 6c] (a hand...)
UTG+1: shows [6h 3d] (a hand...)
Uncalled bet ($170.00) returned to Small Blind
Small Blind collected $231 from pot
*** SUMMARY ***
Total pot $235.00 | Rake $4.00
Board [Kc 5h 3s 6s Tc]
Seat 1: UTG+1 folded
Seat 2: UTG+2 folded
Seat 3: Dealer folded
Seat 4: Small Blind collected ($231)
Seat 5: Big Blind folded
Seat 6: Hero folded



PokerStars Hand #3948166460:  Hold'em No Limit ($2.50/$5) - 2020/05/21 14:21:49 ET
Table '21525146' 9-max Seat #1 is the button
Seat 1: Dealer ($797.97 in chips) 
Seat 2: Small Blind ($1026.40 in chips) 
Seat 3: Big Blind ($533.26 in chips) 
Seat 4: Hero ($493.50 in chips) 
Seat 5: UTG+1 ($600.78 in chips) 
Small Blind: posts small blind $2.50
Big Blind: posts big blind $5
*** HOLE CARDS ***
Dealt to Hero [9s As]
Hero: raises $7.50 to $12.50
UTG+1: folds 
Dealer: folds 
Small Blind: folds 
Big Blind: calls $7.50
*** FLOP *** [2h Kd 5c]
Big Blind: checks 
Hero: bets $7.84
Big Blind: calls $7.84
*** TURN *** [2h Kd 5c] [3h]
Big Blind: checks 
Hero: checks 
*** RIVER *** [2h Kd 5c 3h] [2d]
Big Blind: bets $13.23
Hero: folds 
*** SHOW DOWN ***
Small Blind: shows [3d 4h] (a hand...)
Big Blind: shows [6d 5d] (a hand...)
Hero: shows [9s As] (a hand...)
Dealer: shows [3c Jh] (a hand...)
UTG+1: shows [Ac 4d] (a hand...)
Uncalled bet ($13.23) returned to Big Blind
Big Blind collected $41.03 from pot
*** SUMMARY ***
Total pot $43.18 | Rake $2.15
Board [2h Kd 5c 3h 2d]
Seat 1: Dealer folded
Seat 2: Small Blind folded
Seat 3: Big Blind collected ($41.03)
Seat 4: Hero folded
Seat 5: UTG+1 folded



PokerStars Hand #3948165859:  Hold'em No Limit ($2.50/$5) - 2020/05/21 14:20:15 ET
Table '21525146' 9-max Seat #5 is the button
Seat 1: Small Blind ($796.97 in chips) 
Seat 2: Big Blind ($1031.40 in chips) 
Seat 3: UTG ($533.26 in chips) 
Seat 4: Hero ($492.50 in chips) 
Seat 5: Dealer ($600.78 in chips) 
Small Blind: posts small blind $2.50
Big Blind: posts big blind $5
*** HOLE CARDS ***
Dealt to Hero [4h Ah]
UTG: folds 
Hero: raises $7.50 to $12.50
Dealer: folds 
Small Blind: calls $10
Big Blind: folds 
*** FLOP *** [8d 3s 3d]
Small Blind: checks 
Hero: checks 
*** TURN *** [8d 3s 3d] [As]
Small Blind: checks 
Hero: checks 
*** RIVER *** [8d 3s 3d As] [Kc]
Small Blind: checks 
Hero: bets $5
Small Blind: raises $35 to $40
Hero: calls $35
*** SHOW DOWN ***
Small Blind: shows [Ac 4c] (a hand...)
Big Blind: shows [Qc 5s] (a hand...)
Hero: shows [4h Ah] (a hand...)
Dealer: shows [2h 6c] (a hand...)
UTG: shows [Qh 5c] (a hand...)
Small Blind collected $53.50 from pot
Hero collected $53.50 from pot
*** SUMMARY ***
Total pot $110.00 | Rake $3.00
Board [8d 3s 3d As Kc]
Seat 1: Small Blind showed [Ac 4c] and won ($53.50)
Seat 2: Big Blind folded
Seat 3: UTG folded
Seat 4: Hero showed [4h Ah] and won ($53.50)
Seat 5: Dealer folded



PokerStars Hand #3948162316:  Hold'em No Limit ($2.50/$5) - 2020/05/21 14:11:08 ET
Table '21525880' 9-max Seat #3 is the button
Seat 1: UTG+1 ($500.00 in chips) 
Seat 2: UTG+2 ($700.51 in chips) 
Seat 3: Dealer ($1321.98 in chips) 
Seat 4: Small Blind ($522.64 in chips) 
Seat 5: Hero ($500.00 in chips) 
Seat 6: UTG ($477.21 in chips) 
Small Blind: posts small blind $2.50
Hero: posts big blind $5
*** HOLE CARDS ***
Dealt to Hero [8s Qd]
UTG: folds 
UTG+1: folds 
UTG+2: folds 
Dealer: folds 
Small Blind: raises $10.00 to $15
Hero: calls $10
*** FLOP *** [9s Ks Tc]
Small Blind: checks 
Hero: checks 
*** TURN *** [9s Ks Tc] [3c]
Small Blind: checks 
Hero: checks 
*** RIVER *** [9s Ks Tc 3c] [5c]
Small Blind: bets $11.75
Hero: folds 
*** SHOW DOWN ***
Small Blind: shows [Js Td] (a hand...)
Hero: shows [8s Qd] (a hand...)
Dealer: shows [Kc 4h] (a hand...)
UTG+2: shows [9d 4s] (a hand...)
UTG: shows [7h 4c] (a hand...)
UTG+1: shows [Jd 7s] (a hand...)
Uncalled bet ($11.75) returned to Small Blind
Small Blind collected $28.50 from pot
*** SUMMARY ***
Total pot $30.00 | Rake $1.50
Board [9s Ks Tc 3c 5c]
Seat 1: UTG+1 folded
Seat 2: UTG+2 folded
Seat 3: Dealer folded
Seat 4: Small Blind collected ($28.50)
Seat 5: Hero folded
Seat 6: UTG folded



PokerStars Hand #3948161059:  Hold'em No Limit ($2.50/$5) - 2020/05/21 14:07:40 ET
Table '21525146' 9-max Seat #2 is the button
Seat 1: UTG+2 ($852.97 in chips) 
Seat 2: Dealer ($979.69 in chips) 
Seat 3: Small Blind ($500.00 in chips) 
Seat 4: Hero ($537.00 in chips) 
Seat 5: UTG ($557.56 in chips) 
Seat 6: UTG+1 ($500.00 in chips) 
Small Blind: posts small blind $2.50
Hero: posts big blind $5
*** HOLE CARDS ***
Dealt to Hero [Ah 8d]
UTG: folds 
UTG+1: folds 
UTG+2: folds 
Dealer: raises $7.50 to $12.50
Small Blind: folds 
Hero: calls $7.50
*** FLOP *** [3d Jd 2c]
Hero: checks 
Dealer: bets $8
Hero: calls $8
*** TURN *** [3d Jd 2c] [Th]
Hero: checks 
Dealer: checks 
*** RIVER *** [3d Jd 2c Th] [4s]
Hero: checks 
Dealer: bets $81.99
Hero: calls $81.99
*** SHOW DOWN ***
Small Blind: shows [Ad 6d] (a hand...)
Hero: shows [Ah 8d] (a hand...)
Dealer: shows [Kh As] (a hand...)
UTG+2: shows [5s Jh] (a hand...)
UTG: shows [7c 3s] (a hand...)
UTG+1: shows [Qs 2s] (a hand...)
Dealer collected $203.48 from pot
*** SUMMARY ***
Total pot $207.48 | Rake $4.00
Board [3d Jd 2c Th 4s]
Seat 1: UTG+2 folded
Seat 2: Dealer showed [Kh As] and won ($203.48)
Seat 3: Small Blind folded
Seat 4: Hero showed [Ah 8d] and lost with...
Seat 5: UTG folded
Seat 6: UTG+1 folded



PokerStars Hand #3948155303:  Hold'em No Limit ($2.50/$5) - 2020/05/21 13:52:55 ET
Table '21524041' 9-max Seat #4 is the button
Seat 1: UTG ($512.26 in chips) 
Seat 2: UTG+1 ($3646.43 in chips) 
Seat 3: UTG+2 ($500.00 in chips) 
Seat 4: Dealer ($505.23 in chips) 
Seat 5: Small Blind ($495.00 in chips) 
Seat 6: Hero ($721.00 in chips) 
Small Blind: posts small blind $2.50
Hero: posts big blind $5
*** HOLE CARDS ***
Dealt to Hero [5d 4d]
UTG: raises $7.50 to $12.50
UTG+1: folds 
UTG+2: folds 
Dealer: folds 
Small Blind: folds 
Hero: calls $7.50
*** FLOP *** [7d Ad 4s]
Hero: checks 
UTG: bets $13.07
Hero: calls $13.07
*** TURN *** [7d Ad 4s] [Ah]
Hero: checks 
UTG: checks 
*** RIVER *** [7d Ad 4s Ah] [8s]
Hero: checks 
UTG: bets $30.48
Hero: folds 
*** SHOW DOWN ***
Small Blind: shows [8c 7h] (a hand...)
Hero: shows [5d 4d] (a hand...)
Dealer: shows [6h 2s] (a hand...)
UTG+2: shows [3d 2h] (a hand...)
UTG: shows [9s Ts] (a hand...)
UTG+1: shows [4h 3h] (a hand...)
Uncalled bet ($30.48) returned to UTG
UTG collected $50.96 from pot
*** SUMMARY ***
Total pot $53.64 | Rake $2.68
Board [7d Ad 4s Ah 8s]
Seat 1: UTG collected ($50.96)
Seat 2: UTG+1 folded
Seat 3: UTG+2 folded
Seat 4: Dealer folded
Seat 5: Small Blind folded
Seat 6: Hero folded



PokerStars Hand #3948121338:  Hold'em No Limit ($2.50/$5) - 2020/05/21 12:15:07 ET
Table '21525688' 9-max Seat #1 is the button
Seat 1: Dealer ($672.03 in chips) 
Seat 2: Small Blind ($514.47 in chips) 
Seat 3: Hero ($510.43 in chips) 
Seat 4: UTG ($487.50 in chips) 
Seat 5: UTG+1 ($731.06 in chips) 
Seat 6: UTG+2 ($652.61 in chips) 
Small Blind: posts small blind $2.50
Hero: posts big blind $5
*** HOLE CARDS ***
Dealt to Hero [4c Jc]
UTG: folds 
UTG+1: folds 
UTG+2: folds 
Dealer: folds 
Small Blind: raises $10.00 to $15
Hero: calls $10
*** FLOP *** [Jh Kd Ah]
Small Blind: checks 
Hero: checks 
*** TURN *** [Jh Kd Ah] [9s]
Small Blind: bets $10
Hero: calls $10
*** RIVER *** [Jh Kd Ah 9s] [7s]
Small Blind: bets $35.63
Hero: folds 
*** SHOW DOWN ***
Small Blind: shows [6s Ts] (a hand...)
Hero: shows [4c Jc] (a hand...)
Dealer: shows [3d 8h] (a hand...)
UTG+2: shows [4d Jd] (a hand...)
UTG: shows [2h 2d] (a hand...)
UTG+1: shows [Td 5h] (a hand...)
Uncalled bet ($35.63) returned to Small Blind
Small Blind collected $47.50 from pot
*** SUMMARY ***
Total pot $50.00 | Rake $2.50
Board [Jh Kd Ah 9s 7s]
Seat 1: Dealer folded
Seat 2: Small Blind collected ($47.50)
Seat 3: Hero folded
Seat 4: UTG folded
Seat 5: UTG+1 folded
Seat 6: UTG+2 folded



PokerStars Hand #3948119333:  Hold'em No Limit ($2.50/$5) - 2020/05/21 12:08:38 ET
Table '21524041' 9-max Seat #3 is the button
Seat 1: UTG+1 ($719.71 in chips) 
Seat 2: UTG+2 ($227.37 in chips) 
Seat 3: Dealer ($695.14 in chips) 
Seat 4: Hero ($1090.75 in chips) 
Seat 5: Big Blind ($1232.47 in chips) 
Seat 6: UTG ($500.00 in chips) 
Hero: posts small blind $2.50
Big Blind: posts big blind $5
*** HOLE CARDS ***
Dealt to Hero [Kh Kc]
UTG: folds 
UTG+1: calls $5
UTG+2: folds 
Dealer: raises $17.50 to $22.50
Hero: raises $57.50 to $80
Big Blind: folds 
UTG+1: folds 
Dealer: calls $57.50
*** FLOP *** [Js 7d 6c]
Hero: bets $91.23
Dealer: calls $91.23
*** TURN *** [Js 7d 6c] [Jc]
Hero: checks 
Dealer: bets $159.23
Hero: calls $159.23
*** RIVER *** [Js 7d 6c Jc] [5s]
Hero: checks 
Dealer: bets $364.68 and is all-in
Hero: calls $364.68
*** SHOW DOWN ***
Big Blind: shows [Ks 7c] (a hand...)
Hero: shows [Kh Kc] (a hand...)
Dealer: shows [Td Jh] (a hand...)
UTG+2: shows [Tc 8h] (a hand...)
UTG: shows [2d Ah] (a hand...)
UTG+1: shows [9s 2s] (a hand...)
Dealer collected $1396.28 from pot
*** SUMMARY ***
Total pot $1400.28 | Rake $4.00
Board [Js 7d 6c Jc 5s]
Seat 1: UTG+1 folded
Seat 2: UTG+2 folded
Seat 3: Dealer showed [Td Jh] and won ($1396.28)
Seat 4: Hero showed [Kh Kc] and lost with...
Seat 5: Big Blind folded
Seat 6: UTG folded



PokerStars Hand #3948114355:  Hold'em No Limit ($2.50/$5) - 2020/05/21 11:52:13 ET
Table '21524041' 9-max Seat #2 is the button
Seat 1: UTG+2 ($152.18 in chips) 
Seat 2: Dealer ($321.00 in chips) 
Seat 3: Small Blind ($833.65 in chips) 
Seat 4: Hero ($984.50 in chips) 
Seat 5: UTG ($1215.97 in chips) 
Seat 6: UTG+1 ($500.00 in chips) 
Small Blind: posts small blind $2.50
Hero: posts big blind $5
*** HOLE CARDS ***
Dealt to Hero [Ac 9s]
UTG: folds 
UTG+1: folds 
UTG+2: calls $5
Dealer: folds 
Small Blind: folds 
Hero: checks 
*** FLOP *** [2d 8d Jc]
Hero: checks 
UTG+2: checks 
*** TURN *** [2d 8d Jc] [Qh]
Hero: checks 
UTG+2: bets $11.88
Hero: calls $11.88
*** RIVER *** [2d 8d Jc Qh] [8h]
Hero: checks 
UTG+2: bets $53.98
Hero: folds 
*** SHOW DOWN ***
Small Blind: shows [Qd 2c] (a hand...)
Hero: shows [Ac 9s] (a hand...)
Dealer: shows [5h 9h] (a hand...)
UTG+2: shows [Kh Kc] (a hand...)
UTG: shows [5d 9d] (a hand...)
UTG+1: shows [2s Ts] (a hand...)
Uncalled bet ($53.98) returned to UTG+2
UTG+2 collected $34.45 from pot
*** SUMMARY ***
Total pot $36.26 | Rake $1.81
Board [2d 8d Jc Qh 8h]
Seat 1: UTG+2 collected ($34.45)
Seat 2: Dealer folded
Seat 3: Small Blind folded
Seat 4: Hero folded
Seat 5: UTG folded
Seat 6: UTG+1 folded



PokerStars Hand #3948111420:  Hold'em No Limit ($2.50/$5) - 2020/05/21 11:42:17 ET
Table '21524041' 9-max Seat #4 is the button
Seat 1: Small Blind ($791.76 in chips) 
Seat 2: Hero ($500.00 in chips) 
Seat 3: UTG ($1086.16 in chips) 
Seat 4: Dealer ($752.25 in chips) 
Small Blind: posts small blind $2.50
Hero: posts big blind $5
*** HOLE CARDS ***
Dealt to Hero [9h 9s]
UTG: folds 
Dealer: raises $7.50 to $12.50
Small Blind: folds 
Hero: raises $45.00 to $57.50
Dealer: calls $45
*** FLOP *** [2s 9d 4h]
Hero: checks 
Dealer: bets $40
Hero: calls $40
*** TURN *** [2s 9d 4h] [3h]
Hero: checks 
Dealer: bets $102.25
Hero: calls $102.25
*** RIVER *** [2s 9d 4h 3h] [9c]
Hero: checks 
Dealer: bets $547.14
Hero: calls $300.25 and is all-in
*** SHOW DOWN ***
Small Blind: shows [Ah 3d] (a hand...)
UTG: shows [Jd 2c] (a hand...)
Dealer: shows [Js Jh] (a hand...)
Hero: shows [9h 9s] (a hand...)
Uncalled bet ($246.89) returned to Dealer
Hero collected $999.50 from pot
*** SUMMARY ***
Total pot $1002.50 | Rake $3.00
Board [2s 9d 4h 3h 9c]
Seat 1: Small Blind folded
Seat 2: Hero showed [9h 9s] and won ($999.50)
Seat 3: UTG folded
Seat 4: Dealer showed [Js Jh] and lost with...



PokerStars Hand #3948111013:  Hold'em No Limit ($2.50/$5) - 2020/05/21 11:40:53 ET
Table '21524041' 9-max Seat #3 is the button
Seat 1: Big Blind ($709.76 in chips) 
Seat 2: Hero ($502.50 in chips) 
Seat 3: Dealer ($1127.41 in chips) 
Seat 4: Small Blind ($754.75 in chips) 
Small Blind: posts small blind $2.50
Big Blind: posts big blind $5
*** HOLE CARDS ***
Dealt to Hero [4h 4d]
Hero: raises $7.50 to $12.50
Dealer: raises $28.75 to $41.25
Small Blind: folds 
Big Blind: calls $36.25
Hero: calls $28.75
*** FLOP *** [3s Tc Jh]
Big Blind: checks 
Hero: checks 
Dealer: checks 
*** TURN *** [3s Tc Jh] [2c]
Big Blind: checks 
Hero: checks 
Dealer: checks 
*** RIVER *** [3s Tc Jh 2c] [7s]
Big Blind: bets $92.44
Hero: folds 
Dealer: folds 
*** SHOW DOWN ***
Small Blind: shows [Kh 9c] (a hand...)
Dealer: shows [4s As] (a hand...)
Big Blind: shows [7c 7d] (a hand...)
Hero: shows [4h 4d] (a hand...)
Uncalled bet ($92.44) returned to Big Blind
Big Blind collected $123.25 from pot
*** SUMMARY ***
Total pot $126.25 | Rake $3.00
Board [3s Tc Jh 2c 7s]
Seat 1: Big Blind collected ($123.25)
Seat 2: Hero folded
Seat 3: Dealer folded
Seat 4: Small Blind folded



PokerStars Hand #3947567054:  Hold'em No Limit ($2.50/$5) - 2020/05/20 13:22:53 ET
Table '21515416' 9-max Seat #3 is the button
Seat 1: Hero ($533.53 in chips) 
Seat 2: UTG+1 ($512.50 in chips) 
Seat 3: Dealer ($623.13 in chips) 
Seat 4: Small Blind ($500.84 in chips) 
Seat 5: Big Blind ($616.89 in chips) 
Small Blind: posts small blind $2.50
Big Blind: posts big blind $5
*** HOLE CARDS ***
Dealt to Hero [Tc Ac]
Hero: raises $7.50 to $12.50
UTG+1: folds 
Dealer: folds 
Small Blind: folds 
Big Blind: raises $37.50 to $50
Hero: calls $37.50
*** FLOP *** [4d 7c 5s]
Big Blind: checks 
Hero: checks 
*** TURN *** [4d 7c 5s] [6s]
Big Blind: checks 
Hero: checks 
*** RIVER *** [4d 7c 5s 6s] [Kc]
Big Blind: bets $150
Hero: folds 
*** SHOW DOWN ***
Small Blind: shows [2d Ts] (a hand...)
Big Blind: shows [8d Ad] (a hand...)
Hero: shows [Tc Ac] (a hand...)
Dealer: shows [3h 7d] (a hand...)
UTG+1: shows [Kd 5c] (a hand...)
Uncalled bet ($150.00) returned to Big Blind
Big Blind collected $99.50 from pot
*** SUMMARY ***
Total pot $102.50 | Rake $3.00
Board [4d 7c 5s 6s Kc]
Seat 1: Hero folded
Seat 2: UTG+1 folded
Seat 3: Dealer folded
Seat 4: Small Blind folded
Seat 5: Big Blind collected ($99.50)



PokerStars Hand #3947565500:  Hold'em No Limit ($2.50/$5) - 2020/05/20 13:18:41 ET
Table '21515416' 9-max Seat #5 is the button
Seat 1: Hero ($613.63 in chips) 
Seat 2: UTG ($500.00 in chips) 
Seat 3: UTG+1 ($512.50 in chips) 
Seat 4: UTG+2 ($614.38 in chips) 
Seat 5: Dealer ($498.34 in chips) 
Seat 6: Small Blind ($553.29 in chips) 
Small Blind: posts small blind $2.50
Hero: posts big blind $5
*** HOLE CARDS ***
Dealt to Hero [7h 6s]
UTG: folds 
UTG+1: folds 
UTG+2: folds 
Dealer: folds 
Small Blind: raises $10.00 to $15
Hero: calls $10
*** FLOP *** [Kh 7c 3s]
Small Blind: bets $10
Hero: raises $24.25 to $34.25
Small Blind: calls $24.25
*** TURN *** [Kh 7c 3s] [Kd]
Small Blind: checks 
Hero: bets $28.35
Small Blind: calls $28.35
*** RIVER *** [Kh 7c 3s Kd] [8h]
Small Blind: bets $51.76
Hero: folds 
*** SHOW DOWN ***
Small Blind: shows [Th Tc] (a hand...)
Hero: shows [7h 6s] (a hand...)
Dealer: shows [5c Ts] (a hand...)
UTG+2: shows [3h Qh] (a hand...)
UTG: shows [2s Jd] (a hand...)
UTG+1: shows [8c 7d] (a hand...)
Uncalled bet ($51.76) returned to Small Blind
Small Blind collected $151.20 from pot
*** SUMMARY ***
Total pot $155.20 | Rake $4.00
Board [Kh 7c 3s Kd 8h]
Seat 1: Hero folded
Seat 2: UTG folded
Seat 3: UTG+1 folded
Seat 4: UTG+2 folded
Seat 5: Dealer folded
Seat 6: Small Blind collected ($151.20)



PokerStars Hand #3947562336:  Hold'em No Limit ($2.50/$5) - 2020/05/20 13:09:35 ET
Table '21516086' 9-max Seat #1 is the button
Seat 1: Dealer ($492.50 in chips) 
Seat 2: Small Blind ($509.90 in chips) 
Seat 3: Big Blind ($939.21 in chips) 
Seat 4: UTG ($544.89 in chips) 
Seat 5: UTG+1 ($500.00 in chips) 
Seat 6: Hero ($677.04 in chips) 
Small Blind: posts small blind $2.50
Big Blind: posts big blind $5
*** HOLE CARDS ***
Dealt to Hero [Ah Jc]
UTG: folds 
UTG+1: raises $10 to $15
Hero: raises $35 to $50
Dealer: folds 
Small Blind: folds 
Big Blind: folds 
UTG+1: calls $35
*** FLOP *** [6d 7d 3d]
UTG+1: checks 
Hero: bets $31.05
UTG+1: calls $31.05
*** TURN *** [6d 7d 3d] [4c]
UTG+1: checks 
Hero: checks 
*** RIVER *** [6d 7d 3d 4c] [7c]
UTG+1: bets $225
Hero: folds 
*** SHOW DOWN ***
Small Blind: shows [4s As] (a hand...)
Big Blind: shows [4d 5d] (a hand...)
Hero: shows [Ah Jc] (a hand...)
Dealer: shows [4h 5h] (a hand...)
UTG: shows [2d Js] (a hand...)
UTG+1: shows [5c 5s] (a hand...)
Uncalled bet ($225.00) returned to UTG+1
UTG+1 collected $165.60 from pot
*** SUMMARY ***
Total pot $169.60 | Rake $4.00
Board [6d 7d 3d 4c 7c]
Seat 1: Dealer folded
Seat 2: Small Blind folded
Seat 3: Big Blind folded
Seat 4: UTG folded
Seat 5: UTG+1 collected ($165.60)
Seat 6: Hero folded



PokerStars Hand #3947558809:  Hold'em No Limit ($2.50/$5) - 2020/05/20 12:59:05 ET
Table '21515416' 9-max Seat #5 is the button
Seat 1: Hero ($500.00 in chips) 
Seat 2: UTG ($685.39 in chips) 
Seat 3: UTG+1 ($995.01 in chips) 
Seat 4: UTG+2 ($672.25 in chips) 
Seat 5: Dealer ($420.44 in chips) 
Seat 6: Small Blind ($610.84 in chips) 
Small Blind: posts small blind $2.50
Hero: posts big blind $5
*** HOLE CARDS ***
Dealt to Hero [Kh Td]
UTG: folds 
UTG+1: folds 
UTG+2: folds 
Dealer: folds 
Small Blind: raises $10.00 to $15
Hero: calls $10
*** FLOP *** [4s Ad 5s]
Small Blind: checks 
Hero: checks 
*** TURN *** [4s Ad 5s] [Qh]
Small Blind: checks 
Hero: checks 
*** RIVER *** [4s Ad 5s Qh] [Qs]
Small Blind: bets $10
Hero: folds 
*** SHOW DOWN ***
Small Blind: shows [Qc Jc] (a hand...)
Hero: shows [Kh Td] (a hand...)
Dealer: shows [6h 9s] (a hand...)
UTG+2: shows [Ts 6c] (a hand...)
UTG: shows [Jd 7s] (a hand...)
UTG+1: shows [5h Ks] (a hand...)
Uncalled bet ($10.00) returned to Small Blind
Small Blind collected $28.50 from pot
*** SUMMARY ***
Total pot $30.00 | Rake $1.50
Board [4s Ad 5s Qh Qs]
Seat 1: Hero folded
Seat 2: UTG folded
Seat 3: UTG+1 folded
Seat 4: UTG+2 folded
Seat 5: Dealer folded
Seat 6: Small Blind collected ($28.50)



PokerStars Hand #3947556523:  Hold'em No Limit ($2.50/$5) - 2020/05/20 12:52:17 ET
Table '21516086' 9-max Seat #6 is the button
Seat 1: Small Blind ($475.00 in chips) 
Seat 2: Big Blind ($534.90 in chips) 
Seat 3: UTG ($648.63 in chips) 
Seat 4: UTG+1 ($571.01 in chips) 
Seat 5: UTG+2 ($383.13 in chips) 
Seat 6: Hero ($510.00 in chips) 
Small Blind: posts small blind $2.50
Big Blind: posts big blind $5
*** HOLE CARDS ***
Dealt to Hero [Jd Ad]
UTG: raises $7.50 to $12.50
UTG+1: folds 
UTG+2: folds 
Hero: calls $12.50
Small Blind: folds 
Big Blind: folds 
*** FLOP *** [9h 8c 7c]
UTG: checks 
Hero: checks 
*** TURN *** [9h 8c 7c] [Ah]
UTG: checks 
Hero: bets $20
UTG: raises $70.88 to $90.88
Hero: calls $70.88
*** RIVER *** [9h 8c 7c Ah] [3h]
UTG: bets $147.70
Hero: calls $147.70
*** SHOW DOWN ***
Small Blind: shows [Ac 5d] (a hand...)
Big Blind: shows [2h Js] (a hand...)
Hero: shows [Jd Ad] (a hand...)
UTG+2: shows [Ks 8s] (a hand...)
UTG: shows [Th Jc] (a hand...)
UTG+1: shows [7d 6c] (a hand...)
UTG collected $505.66 from pot
*** SUMMARY ***
Total pot $509.66 | Rake $4.00
Board [9h 8c 7c Ah 3h]
Seat 1: Small Blind folded
Seat 2: Big Blind folded
Seat 3: UTG showed [Th Jc] and won ($505.66)
Seat 4: UTG+1 folded
Seat 5: UTG+2 folded
Seat 6: Hero showed [Jd Ad] and lost with...



PokerStars Hand #3947554707:  Hold'em No Limit ($2.50/$5) - 2020/05/20 12:46:49 ET
Table '21515416' 9-max Seat #2 is the button
Seat 1: Hero ($492.50 in chips) 
Seat 2: Dealer ($690.61 in chips) 
Seat 3: Small Blind ($483.05 in chips) 
Seat 4: Big Blind ($680.37 in chips) 
Seat 5: UTG ($266.08 in chips) 
Small Blind: posts small blind $2.50
Big Blind: posts big blind $5
*** HOLE CARDS ***
Dealt to Hero [Ac 9c]
UTG: calls $5
Hero: raises $17.50 to $22.50
Dealer: folds 
Small Blind: folds 
Big Blind: folds 
UTG: calls $17.50
*** FLOP *** [Ts Jc 4c]
UTG: checks 
Hero: checks 
*** TURN *** [Ts Jc 4c] [Js]
UTG: bets $24.94
Hero: calls $24.94
*** RIVER *** [Ts Jc 4c Js] [Ad]
UTG: bets $74.54
Hero: calls $74.54
*** SHOW DOWN ***
Small Blind: shows [8h Ks] (a hand...)
Big Blind: shows [7d As] (a hand...)
Hero: shows [Ac 9c] (a hand...)
Dealer: shows [2c Ah] (a hand...)
UTG: shows [Kc Qh] (a hand...)
UTG collected $248.46 from pot
*** SUMMARY ***
Total pot $251.46 | Rake $3.00
Board [Ts Jc 4c Js Ad]
Seat 1: Hero showed [Ac 9c] and lost with...
Seat 2: Dealer folded
Seat 3: Small Blind folded
Seat 4: Big Blind folded
Seat 5: UTG showed [Kc Qh] and won ($248.46)



PokerStars Hand #3947554612:  Hold'em No Limit ($2.50/$5) - 2020/05/20 12:46:33 ET
Table '21516086' 9-max Seat #6 is the button
Seat 1: Small Blind ($495.00 in chips) 
Seat 2: Big Blind ($525.13 in chips) 
Seat 3: UTG ($547.63 in chips) 
Seat 4: UTG+1 ($558.51 in chips) 
Seat 5: UTG+2 ($490.00 in chips) 
Seat 6: Hero ($763.00 in chips) 
Small Blind: posts small blind $2.50
Big Blind: posts big blind $5
*** HOLE CARDS ***
Dealt to Hero [Ts As]
UTG: folds 
UTG+1: folds 
UTG+2: folds 
Hero: raises $7.50 to $12.50
Small Blind: folds 
Big Blind: calls $7.50
*** FLOP *** [3d 2d Jd]
Big Blind: checks 
Hero: checks 
*** TURN *** [3d 2d Jd] [5d]
Big Blind: checks 
Hero: checks 
*** RIVER *** [3d 2d Jd 5d] [4c]
Big Blind: bets $9.60
Hero: calls $9.60
*** SHOW DOWN ***
Small Blind: shows [8h 9s] (a hand...)
Big Blind: shows [6d 6h] (a hand...)
Hero: shows [Ts As] (a hand...)
UTG+2: shows [Kd 2h] (a hand...)
UTG: shows [Qh 4h] (a hand...)
UTG+1: shows [4s 9c] (a hand...)
Big Blind collected $44.37 from pot
*** SUMMARY ***
Total pot $46.70 | Rake $2.33
Board [3d 2d Jd 5d 4c]
Seat 1: Small Blind folded
Seat 2: Big Blind showed [6d 6h] and won ($44.37)
Seat 3: UTG folded
Seat 4: UTG+1 folded
Seat 5: UTG+2 folded
Seat 6: Hero showed [Ts As] and lost with...



PokerStars Hand #3947549427:  Hold'em No Limit ($2.50/$5) - 2020/05/20 12:31:03 ET
Table '21516293' 9-max Seat #2 is the button
Seat 1: Big Blind ($507.30 in chips) 
Seat 2: Hero ($481.70 in chips) 
Hero: posts small blind $2.50
Big Blind: posts big blind $5
*** HOLE CARDS ***
Dealt to Hero [Jd As]
Hero: raises $7.50 to $12.50
Big Blind: calls $7.50
*** FLOP *** [7c 5s 4d]
Big Blind: checks 
Hero: checks 
*** TURN *** [7c 5s 4d] [Kd]
Big Blind: checks 
Hero: checks 
*** RIVER *** [7c 5s 4d Kd] [Ac]
Big Blind: checks 
Hero: bets $18
Big Blind: raises $83 to $101
Hero: folds 
*** SHOW DOWN ***
Big Blind: shows [Ad 5c] (a hand...)
Hero: shows [Jd As] (a hand...)
Uncalled bet ($83.00) returned to Big Blind
Big Blind collected $60 from pot
*** SUMMARY ***
Total pot $61.00 | Rake $1.00
Board [7c 5s 4d Kd Ac]
Seat 1: Big Blind collected ($60)
Seat 2: Hero folded



PokerStars Hand #3947534388:  Hold'em No Limit ($2.50/$5) - 2020/05/20 11:42:16 ET
Table '21515882' 9-max Seat #5 is the button
Seat 1: Big Blind ($587.78 in chips) 
Seat 2: UTG ($492.50 in chips) 
Seat 3: Hero ($511.13 in chips) 
Seat 4: UTG+2 ($993.97 in chips) 
Seat 5: Dealer ($544.88 in chips) 
Seat 6: Small Blind ($235.03 in chips) 
Small Blind: posts small blind $2.50
Big Blind: posts big blind $5
*** HOLE CARDS ***
Dealt to Hero [9s As]
UTG: folds 
Hero: raises $7.50 to $12.50
UTG+2: folds 
Dealer: folds 
Small Blind: folds 
Big Blind: calls $7.50
*** FLOP *** [Ad 9d Ts]
Big Blind: checks 
Hero: bets $20
Big Blind: calls $20
*** TURN *** [Ad 9d Ts] [5h]
Big Blind: checks 
Hero: bets $96.20
Big Blind: calls $96.20
*** RIVER *** [Ad 9d Ts 5h] [8h]
Big Blind: bets $459.08 and is all-in
Hero: calls $382.43 and is all-in
*** SHOW DOWN ***
Small Blind: shows [2c 7c] (a hand...)
Big Blind: shows [Qc Jd] (a hand...)
Hero: shows [9s As] (a hand...)
Dealer: shows [Kc 6c] (a hand...)
UTG+2: shows [Tc 2d] (a hand...)
UTG: shows [Qs 3c] (a hand...)
Uncalled bet ($76.65) returned to Big Blind
Big Blind collected $1020.76 from pot
*** SUMMARY ***
Total pot $1024.76 | Rake $4.00
Board [Ad 9d Ts 5h 8h]
Seat 1: Big Blind showed [Qc Jd] and won ($1020.76)
Seat 2: UTG folded
Seat 3: Hero showed [9s As] and lost with...
Seat 4: UTG+2 folded
Seat 5: Dealer folded
Seat 6: Small Blind folded



PokerStars Hand #3947529765:  Hold'em No Limit ($2.50/$5) - 2020/05/20 11:27:48 ET
Table '21515295' 9-max Seat #5 is the button
Seat 1: Small Blind ($533.14 in chips) 
Seat 2: Hero ($1060.50 in chips) 
Seat 3: UTG ($587.88 in chips) 
Seat 4: UTG+1 ($492.50 in chips) 
Seat 5: Dealer ($492.50 in chips) 
Small Blind: posts small blind $2.50
Hero: posts big blind $5
*** HOLE CARDS ***
Dealt to Hero [4c As]
UTG: folds 
UTG+1: folds 
Dealer: raises $7.50 to $12.50
Small Blind: folds 
Hero: calls $7.50
*** FLOP *** [Ac 5s Jh]
Hero: checks 
Dealer: bets $9
Hero: calls $9
*** TURN *** [Ac 5s Jh] [7d]
Hero: checks 
Dealer: checks 
*** RIVER *** [Ac 5s Jh 7d] [9h]
Hero: checks 
Dealer: bets $32.42
Hero: calls $32.42
*** SHOW DOWN ***
Small Blind: shows [6d 3s] (a hand...)
Hero: shows [4c As] (a hand...)
Dealer: shows [8s Ad] (a hand...)
UTG: shows [3c 2s] (a hand...)
UTG+1: shows [5d Ts] (a hand...)
Dealer collected $107.34 from pot
*** SUMMARY ***
Total pot $110.34 | Rake $3.00
Board [Ac 5s Jh 7d 9h]
Seat 1: Small Blind folded
Seat 2: Hero showed [4c As] and lost with...
Seat 3: UTG folded
Seat 4: UTG+1 folded
Seat 5: Dealer showed [8s Ad] and won ($107.34)



PokerStars Hand #3947522707:  Hold'em No Limit ($2.50/$5) - 2020/05/20 11:04:12 ET
Table '21515737' 9-max Seat #4 is the button
Seat 1: UTG ($485.69 in chips) 
Seat 2: UTG+1 ($515.87 in chips) 
Seat 3: Hero ($510.05 in chips) 
Seat 4: Dealer ($500.00 in chips) 
Seat 5: Small Blind ($577.51 in chips) 
Seat 6: Big Blind ($181.93 in chips) 
Small Blind: posts small blind $2.50
Big Blind: posts big blind $5
*** HOLE CARDS ***
Dealt to Hero [9c 7c]
UTG: folds 
UTG+1: folds 
Hero: raises $7.50 to $12.50
Dealer: folds 
Small Blind: folds 
Big Blind: calls $7.50
*** FLOP *** [9h Qs 8s]
Big Blind: checks 
Hero: checks 
*** TURN *** [9h Qs 8s] [Ks]
Big Blind: checks 
Hero: checks 
*** RIVER *** [9h Qs 8s Ks] [3h]
Big Blind: bets $15
Hero: folds 
*** SHOW DOWN ***
Small Blind: shows [Td 2c] (a hand...)
Big Blind: shows [6c 7s] (a hand...)
Hero: shows [9c 7c] (a hand...)
Dealer: shows [5h Qd] (a hand...)
UTG: shows [4h Jc] (a hand...)
UTG+1: shows [6h Js] (a hand...)
Uncalled bet ($15.00) returned to Big Blind
Big Blind collected $26.13 from pot
*** SUMMARY ***
Total pot $27.50 | Rake $1.37
Board [9h Qs 8s Ks 3h]
Seat 1: UTG folded
Seat 2: UTG+1 folded
Seat 3: Hero folded
Seat 4: Dealer folded
Seat 5: Small Blind folded
Seat 6: Big Blind collected ($26.13)



PokerStars Hand #3947521019:  Hold'em No Limit ($2.50/$5) - 2020/05/20 10:58:29 ET
Table '21515737' 9-max Seat #4 is the button
Seat 1: Big Blind ($492.50 in chips) 
Seat 2: UTG ($571.50 in chips) 
Seat 3: Hero ($507.50 in chips) 
Seat 4: Dealer ($505.00 in chips) 
Seat 5: Small Blind ($502.50 in chips) 
Small Blind: posts small blind $2.50
Big Blind: posts big blind $5
*** HOLE CARDS ***
Dealt to Hero [Ac 6c]
UTG: folds 
Hero: raises $7.50 to $12.50
Dealer: folds 
Small Blind: folds 
Big Blind: calls $7.50
*** FLOP *** [9c 3d Jh]
Big Blind: checks 
Hero: bets $7.84
Big Blind: calls $7.84
*** TURN *** [9c 3d Jh] [7d]
Big Blind: checks 
Hero: checks 
*** RIVER *** [9c 3d Jh 7d] [5h]
Big Blind: bets $30
Hero: folds 
*** SHOW DOWN ***
Small Blind: shows [8h 6s] (a hand...)
Big Blind: shows [3c 5c] (a hand...)
Hero: shows [Ac 6c] (a hand...)
Dealer: shows [9s Kc] (a hand...)
UTG: shows [2c Js] (a hand...)
Uncalled bet ($30.00) returned to Big Blind
Big Blind collected $41.03 from pot
*** SUMMARY ***
Total pot $43.18 | Rake $2.15
Board [9c 3d Jh 7d 5h]
Seat 1: Big Blind collected ($41.03)
Seat 2: UTG folded
Seat 3: Hero folded
Seat 4: Dealer folded
Seat 5: Small Blind folded



PokerStars Hand #3947519702:  Hold'em No Limit ($2.50/$5) - 2020/05/20 10:53:59 ET
Table '21514834' 9-max Seat #6 is the button
Seat 1: Small Blind ($382.00 in chips) 
Seat 2: Big Blind ($500.00 in chips) 
Seat 3: UTG ($507.50 in chips) 
Seat 4: UTG+1 ($570.88 in chips) 
Seat 5: UTG+2 ($150.00 in chips) 
Seat 6: Hero ($482.50 in chips) 
Small Blind: posts small blind $2.50
Big Blind: posts big blind $5
UTG+2: posts big blind $5
*** HOLE CARDS ***
Dealt to Hero [Qd 3d]
UTG: folds 
UTG+1: folds 
UTG+2: checks 
Hero: raises $15 to $20
Small Blind: folds 
Big Blind: folds 
UTG+2: calls $15
*** FLOP *** [Qh 3c 4h]
UTG+2: checks 
Hero: bets $15
UTG+2: calls $15
*** TURN *** [Qh 3c 4h] [9c]
UTG+2: checks 
Hero: bets $42.50
UTG+2: calls $42.50
*** RIVER *** [Qh 3c 4h 9c] [4s]
UTG+2: bets $72.50 and is all-in
Hero: calls $72.50
*** SHOW DOWN ***
Small Blind: shows [3h 2c] (a hand...)
Big Blind: shows [Jd 2h] (a hand...)
Hero: shows [Qd 3d] (a hand...)
UTG+2: shows [Kd Ts] (a hand...)
UTG: shows [Tc 5s] (a hand...)
UTG+1: shows [5d Ah] (a hand...)
Hero collected $303.50 from pot
*** SUMMARY ***
Total pot $307.50 | Rake $4.00
Board [Qh 3c 4h 9c 4s]
Seat 1: Small Blind folded
Seat 2: Big Blind folded
Seat 3: UTG folded
Seat 4: UTG+1 folded
Seat 5: UTG+2 showed [Kd Ts] and lost with...
Seat 6: Hero showed [Qd 3d] and won ($303.50)



PokerStars Hand #3947519343:  Hold'em No Limit ($2.50/$5) - 2020/05/20 10:52:49 ET
Table '21514834' 9-max Seat #4 is the button
Seat 1: Big Blind ($335.00 in chips) 
Seat 2: UTG ($498.63 in chips) 
Seat 3: UTG+1 ($507.50 in chips) 
Seat 4: Dealer ($570.88 in chips) 
Seat 5: Hero ($495.00 in chips) 
Hero: posts small blind $2.50
Big Blind: posts big blind $5
*** HOLE CARDS ***
Dealt to Hero [8s 8d]
UTG: raises $7.50 to $12.50
UTG+1: folds 
Dealer: folds 
Hero: calls $10
Big Blind: calls $7.50
*** FLOP *** [3h Js Ad]
Hero: checks 
Big Blind: checks 
UTG: checks 
*** TURN *** [3h Js Ad] [3s]
Hero: checks 
Big Blind: checks 
UTG: checks 
*** RIVER *** [3h Js Ad 3s] [Tc]
Hero: checks 
Big Blind: bets $25
UTG: calls $25
Hero: folds 
*** SHOW DOWN ***
Big Blind: shows [Ac Qc] (a hand...)
Hero: shows [8s 8d] (a hand...)
Dealer: shows [7h 9c] (a hand...)
UTG: shows [Th Jh] (a hand...)
UTG+1: shows [9h 4h] (a hand...)
Big Blind collected $84.50 from pot
*** SUMMARY ***
Total pot $87.50 | Rake $3.00
Board [3h Js Ad 3s Tc]
Seat 1: Big Blind showed [Ac Qc] and won ($84.50)
Seat 2: UTG showed [Th Jh] and lost with...
Seat 3: UTG+1 folded
Seat 4: Dealer folded
Seat 5: Hero folded



PokerStars Hand #3946971780:  Hold'em No Limit ($2.50/$5) - 2020/05/19 13:10:59 ET
Table '21505646' 9-max Seat #1 is the button
Seat 1: Dealer ($253.55 in chips) 
Seat 2: Small Blind ($695.62 in chips) 
Seat 3: Hero ($972.36 in chips) 
Seat 4: UTG ($415.96 in chips) 
Seat 5: UTG+1 ($489.00 in chips) 
Small Blind: posts small blind $2.50
Hero: posts big blind $5
*** HOLE CARDS ***
Dealt to Hero [5d 5h]
UTG: folds 
UTG+1: folds 
Dealer: calls $5
Small Blind: folds 
Hero: checks 
*** FLOP *** [Jd 9c Qs]
Hero: checks 
Dealer: checks 
*** TURN *** [Jd 9c Qs] [Ac]
Hero: checks 
Dealer: checks 
*** RIVER *** [Jd 9c Qs Ac] [Jc]
Hero: checks 
Dealer: bets $10
Hero: folds 
*** SHOW DOWN ***
Small Blind: shows [2s 6d] (a hand...)
Hero: shows [5d 5h] (a hand...)
Dealer: shows [8s As] (a hand...)
UTG: shows [4s 2c] (a hand...)
UTG+1: shows [Ks 6c] (a hand...)
Uncalled bet ($10) returned to Dealer
Dealer collected $11.88 from pot
*** SUMMARY ***
Total pot $12.50 | Rake $0.62
Board [Jd 9c Qs Ac Jc]
Seat 1: Dealer collected ($11.88)
Seat 2: Small Blind folded
Seat 3: Hero folded
Seat 4: UTG folded
Seat 5: UTG+1 folded



PokerStars Hand #3946968792:  Hold'em No Limit ($2.50/$5) - 2020/05/19 13:01:36 ET
Table '21505646' 9-max Seat #2 is the button
Seat 1: UTG ($619.85 in chips) 
Seat 2: Dealer ($714.80 in chips) 
Seat 3: Hero ($839.40 in chips) 
Seat 4: Big Blind ($458.96 in chips) 
Hero: posts small blind $2.50
Big Blind: posts big blind $5
*** HOLE CARDS ***
Dealt to Hero [Kh Js]
UTG: folds 
Dealer: raises $5 to $10
Hero: calls $7.50
Big Blind: calls $5
*** FLOP *** [Qs 9h 3h]
Hero: checks 
Big Blind: checks 
Dealer: checks 
*** TURN *** [Qs 9h 3h] [4d]
Hero: bets $20
Big Blind: folds 
Dealer: calls $20
*** RIVER *** [Qs 9h 3h 4d] [Ad]
Hero: checks 
Dealer: bets $52
Hero: folds 
*** SHOW DOWN ***
UTG: shows [6s Jh] (a hand...)
Dealer: shows [4c As] (a hand...)
Big Blind: shows [7s Ts] (a hand...)
Hero: shows [Kh Js] (a hand...)
Uncalled bet ($52.00) returned to Dealer
Dealer collected $67 from pot
*** SUMMARY ***
Total pot $70.00 | Rake $3.00
Board [Qs 9h 3h 4d Ad]
Seat 1: UTG folded
Seat 2: Dealer collected ($67)
Seat 3: Hero folded
Seat 4: Big Blind folded



PokerStars Hand #3946967665:  Hold'em No Limit ($2.50/$5) - 2020/05/19 12:58:00 ET
Table '21505982' 9-max Seat #5 is the button
Seat 1: Big Blind ($481.56 in chips) 
Seat 2: UTG ($493.00 in chips) 
Seat 3: Hero ($1075.91 in chips) 
Seat 4: UTG+2 ($458.93 in chips) 
Seat 5: Dealer ($374.00 in chips) 
Seat 6: Small Blind ($709.63 in chips) 
Small Blind: posts small blind $2.50
Big Blind: posts big blind $5
*** HOLE CARDS ***
Dealt to Hero [3c Ac]
UTG: folds 
Hero: raises $7.50 to $12.50
UTG+2: folds 
Dealer: folds 
Small Blind: folds 
Big Blind: calls $7.50
*** FLOP *** [Td Kd 5d]
Big Blind: checks 
Hero: bets $7.84
Big Blind: calls $7.84
*** TURN *** [Td Kd 5d] [7c]
Big Blind: checks 
Hero: checks 
*** RIVER *** [Td Kd 5d 7c] [2s]
Big Blind: bets $30.77
Hero: folds 
*** SHOW DOWN ***
Small Blind: shows [As 7d] (a hand...)
Big Blind: shows [9d Js] (a hand...)
Hero: shows [3c Ac] (a hand...)
Dealer: shows [Tc 3s] (a hand...)
UTG+2: shows [3d 4h] (a hand...)
UTG: shows [8d 6h] (a hand...)
Uncalled bet ($30.77) returned to Big Blind
Big Blind collected $41.03 from pot
*** SUMMARY ***
Total pot $43.18 | Rake $2.15
Board [Td Kd 5d 7c 2s]
Seat 1: Big Blind collected ($41.03)
Seat 2: UTG folded
Seat 3: Hero folded
Seat 4: UTG+2 folded
Seat 5: Dealer folded
Seat 6: Small Blind folded



PokerStars Hand #3946966099:  Hold'em No Limit ($2.50/$5) - 2020/05/19 12:52:51 ET
Table '21505646' 9-max Seat #1 is the button
Seat 1: Dealer ($181.85 in chips) 
Seat 2: Small Blind ($729.80 in chips) 
Seat 3: Hero ($626.53 in chips) 
Seat 4: UTG ($483.21 in chips) 
Seat 5: UTG+1 ($563.96 in chips) 
Small Blind: posts small blind $2.50
Hero: posts big blind $5
*** HOLE CARDS ***
Dealt to Hero [Kh 8h]
UTG: folds 
UTG+1: folds 
Dealer: calls $5
Small Blind: folds 
Hero: checks 
*** FLOP *** [Js 8c 6d]
Hero: checks 
Dealer: checks 
*** TURN *** [Js 8c 6d] [2d]
Hero: bets $8.91
Dealer: calls $8.91
*** RIVER *** [Js 8c 6d 2d] [4s]
Hero: checks 
Dealer: bets $21.61
Hero: calls $21.61
*** SHOW DOWN ***
Small Blind: shows [Jd 2c] (a hand...)
Hero: shows [Kh 8h] (a hand...)
Dealer: shows [3h 4d] (a hand...)
UTG: shows [Th 2h] (a hand...)
UTG+1: shows [9s 6c] (a hand...)
Hero collected $70.54 from pot
*** SUMMARY ***
Total pot $73.54 | Rake $3.00
Board [Js 8c 6d 2d 4s]
Seat 1: Dealer showed [3h 4d] and lost with...
Seat 2: Small Blind folded
Seat 3: Hero showed [Kh 8h] and won ($70.54)
Seat 4: UTG folded
Seat 5: UTG+1 folded



PokerStars Hand #3946957440:  Hold'em No Limit ($2.50/$5) - 2020/05/19 12:24:12 ET
Table '21505376' 9-max Seat #6 is the button
Seat 1: Small Blind ($482.50 in chips) 
Seat 2: Big Blind ($505.00 in chips) 
Seat 3: UTG ($971.47 in chips) 
Seat 4: UTG+1 ($940.52 in chips) 
Seat 5: UTG+2 ($516.00 in chips) 
Seat 6: Hero ($842.45 in chips) 
Small Blind: posts small blind $2.50
Big Blind: posts big blind $5
*** HOLE CARDS ***
Dealt to Hero [Kd Td]
UTG: folds 
UTG+1: raises $6.22 to $11.22
UTG+2: folds 
Hero: raises $31.28 to $42.50
Small Blind: folds 
Big Blind: folds 
UTG+1: calls $31.28
*** FLOP *** [Ah 6s 5h]
UTG+1: checks 
Hero: bets $54.69
UTG+1: calls $54.69
*** TURN *** [Ah 6s 5h] [Kh]
UTG+1: checks 
Hero: checks 
*** RIVER *** [Ah 6s 5h Kh] [9s]
UTG+1: bets $120
Hero: folds 
*** SHOW DOWN ***
Small Blind: shows [4d 8s] (a hand...)
Big Blind: shows [8d Tc] (a hand...)
Hero: shows [Kd Td] (a hand...)
UTG+2: shows [Jh 5s] (a hand...)
UTG: shows [9h 6d] (a hand...)
UTG+1: shows [As Kc] (a hand...)
Uncalled bet ($120.00) returned to UTG+1
UTG+1 collected $197.88 from pot
*** SUMMARY ***
Total pot $201.88 | Rake $4.00
Board [Ah 6s 5h Kh 9s]
Seat 1: Small Blind folded
Seat 2: Big Blind folded
Seat 3: UTG folded
Seat 4: UTG+1 collected ($197.88)
Seat 5: UTG+2 folded
Seat 6: Hero folded



PokerStars Hand #3946948992:  Hold'em No Limit ($2.50/$5) - 2020/05/19 11:53:44 ET
Table '21505376' 9-max Seat #2 is the button
Seat 1: UTG+1 ($500.00 in chips) 
Seat 2: Dealer ($1341.98 in chips) 
Seat 3: Small Blind ($534.75 in chips) 
Seat 4: Big Blind ($612.96 in chips) 
Seat 5: Hero ($543.83 in chips) 
Small Blind: posts small blind $2.50
Big Blind: posts big blind $5
*** HOLE CARDS ***
Dealt to Hero [Kh Ac]
Hero: raises $7.50 to $12.50
UTG+1: folds 
Dealer: calls $12.50
Small Blind: folds 
Big Blind: folds 
*** FLOP *** [9h Js Th]
Hero: checks 
Dealer: bets $15.44
Hero: calls $15.44
*** TURN *** [9h Js Th] [4c]
Hero: checks 
Dealer: checks 
*** RIVER *** [9h Js Th 4c] [2h]
Hero: checks 
Dealer: bets $30.19
Hero: calls $30.19
*** SHOW DOWN ***
Small Blind: shows [Qh 8c] (a hand...)
Big Blind: shows [7h 2d] (a hand...)
Hero: shows [Kh Ac] (a hand...)
Dealer: shows [6h 7d] (a hand...)
UTG+1: shows [5c 4d] (a hand...)
Hero collected $120.76 from pot
*** SUMMARY ***
Total pot $123.76 | Rake $3.00
Board [9h Js Th 4c 2h]
Seat 1: UTG+1 folded
Seat 2: Dealer showed [6h 7d] and lost with...
Seat 3: Small Blind folded
Seat 4: Big Blind folded
Seat 5: Hero showed [Kh Ac] and won ($120.76)



PokerStars Hand #3946947396:  Hold'em No Limit ($2.50/$5) - 2020/05/19 11:47:39 ET
Table '21505982' 9-max Seat #1 is the button
Seat 1: Dealer ($634.77 in chips) 
Seat 2: Small Blind ($896.56 in chips) 
Seat 3: Hero ($653.98 in chips) 
Seat 4: UTG ($300.00 in chips) 
Seat 5: UTG+1 ($500.00 in chips) 
Seat 6: UTG+2 ($636.45 in chips) 
Small Blind: posts small blind $2.50
Hero: posts big blind $5
UTG: posts big blind $5
*** HOLE CARDS ***
Dealt to Hero [Qh Kh]
UTG: checks 
UTG+1: folds 
UTG+2: folds 
Dealer: folds 
Small Blind: raises $15.00 to $20
Hero: calls $15
UTG: folds 
*** FLOP *** [Ac Kd 7c]
Small Blind: bets $15
Hero: calls $15
*** TURN *** [Ac Kd 7c] [2c]
Small Blind: checks 
Hero: checks 
*** RIVER *** [Ac Kd 7c 2c] [5d]
Small Blind: bets $25
Hero: calls $25
*** SHOW DOWN ***
Small Blind: shows [3h Ah] (a hand...)
Hero: shows [Qh Kh] (a hand...)
Dealer: shows [6s 3d] (a hand...)
UTG+2: shows [Qc 9h] (a hand...)
UTG: shows [7d 4s] (a hand...)
UTG+1: shows [4h Ad] (a hand...)
Small Blind collected $121 from pot
*** SUMMARY ***
Total pot $125.00 | Rake $4.00
Board [Ac Kd 7c 2c 5d]
Seat 1: Dealer folded
Seat 2: Small Blind showed [3h Ah] and won ($121)
Seat 3: Hero showed [Qh Kh] and lost with...
Seat 4: UTG folded
Seat 5: UTG+1 folded
Seat 6: UTG+2 folded



PokerStars Hand #3946947232:  Hold'em No Limit ($2.50/$5) - 2020/05/19 11:47:07 ET
Table '21505646' 9-max Seat #3 is the button
Seat 1: UTG+1 ($467.06 in chips) 
Seat 2: UTG+2 ($492.50 in chips) 
Seat 3: Dealer ($179.03 in chips) 
Seat 4: Hero ($1041.34 in chips) 
Seat 5: Big Blind ($500.00 in chips) 
Seat 6: UTG ($434.46 in chips) 
Hero: posts small blind $2.50
Big Blind: posts big blind $5
*** HOLE CARDS ***
Dealt to Hero [9s Ks]
UTG: folds 
UTG+1: folds 
UTG+2: folds 
Dealer: raises $5 to $10
Hero: raises $25.00 to $35
Big Blind: folds 
Dealer: calls $25
*** FLOP *** [7d Jh 7s]
Hero: bets $40
Dealer: calls $40
*** TURN *** [7d Jh 7s] [3c]
Hero: checks 
Dealer: checks 
*** RIVER *** [7d Jh 7s 3c] [2c]
Hero: checks 
Dealer: bets $104.03 and is all-in
Hero: folds 
*** SHOW DOWN ***
Big Blind: shows [Ac 7h] (a hand...)
Hero: shows [9s Ks] (a hand...)
Dealer: shows [Kh 9d] (a hand...)
UTG+2: shows [5d Qc] (a hand...)
UTG: shows [3d 8d] (a hand...)
UTG+1: shows [Th 4s] (a hand...)
Uncalled bet ($104.03) returned to Dealer
Dealer collected $151 from pot
*** SUMMARY ***
Total pot $155.00 | Rake $4.00
Board [7d Jh 7s 3c 2c]
Seat 1: UTG+1 folded
Seat 2: UTG+2 folded
Seat 3: Dealer collected ($151)
Seat 4: Hero folded
Seat 5: Big Blind folded
Seat 6: UTG folded



PokerStars Hand #3946946602:  Hold'em No Limit ($2.50/$5) - 2020/05/19 11:44:53 ET
Table '21505982' 9-max Seat #3 is the button
Seat 1: UTG+1 ($561.14 in chips) 
Seat 2: UTG+2 ($894.06 in chips) 
Seat 3: Hero ($609.55 in chips) 
Seat 4: Small Blind ($118.56 in chips) 
Seat 5: Big Blind ($505.00 in chips) 
Seat 6: UTG ($627.95 in chips) 
Small Blind: posts small blind $2.50
Big Blind: posts big blind $5
*** HOLE CARDS ***
Dealt to Hero [Ah 8d]
UTG: folds 
UTG+1: folds 
UTG+2: folds 
Hero: raises $7.50 to $12.50
Small Blind: calls $10
Big Blind: folds 
*** FLOP *** [4d Kh Qh]
Small Blind: checks 
Hero: bets $8.55
Small Blind: calls $8.55
*** TURN *** [4d Kh Qh] [7h]
Small Blind: checks 
Hero: checks 
*** RIVER *** [4d Kh Qh 7h] [Ad]
Small Blind: bets $22.38
Hero: calls $22.38
*** SHOW DOWN ***
Small Blind: shows [Jd Ks] (a hand...)
Big Blind: shows [2d 9h] (a hand...)
Hero: shows [Ah 8d] (a hand...)
UTG+2: shows [5s 3d] (a hand...)
UTG: shows [5d 7d] (a hand...)
UTG+1: shows [3c 6d] (a hand...)
Hero collected $87.86 from pot
*** SUMMARY ***
Total pot $91.86 | Rake $4.00
Board [4d Kh Qh 7h Ad]
Seat 1: UTG+1 folded
Seat 2: UTG+2 folded
Seat 3: Hero showed [Ah 8d] and won ($87.86)
Seat 4: Small Blind showed [Jd Ks] and lost with...
Seat 5: Big Blind folded
Seat 6: UTG folded



PokerStars Hand #3946944289:  Hold'em No Limit ($2.50/$5) - 2020/05/19 11:36:24 ET
Table '21505646' 9-max Seat #5 is the button
Seat 1: Small Blind ($994.56 in chips) 
Seat 2: Big Blind ($464.66 in chips) 
Seat 3: Hero ($547.18 in chips) 
Seat 4: UTG+1 ($470.50 in chips) 
Seat 5: Dealer ($456.96 in chips) 
Small Blind: posts small blind $2.50
Big Blind: posts big blind $5
*** HOLE CARDS ***
Dealt to Hero [Qs Qd]
Hero: raises $7.50 to $12.50
UTG+1: calls $12.50
Dealer: folds 
Small Blind: folds 
Big Blind: calls $7.50
*** FLOP *** [2h 9c 6d]
Big Blind: checks 
Hero: bets $25
UTG+1: folds 
Big Blind: calls $25
*** TURN *** [2h 9c 6d] [4d]
Big Blind: checks 
Hero: bets $115.71
Big Blind: calls $115.71
*** RIVER *** [2h 9c 6d 4d] [8d]
Big Blind: bets $311.45 and is all-in
Hero: calls $311.45
*** SHOW DOWN ***
Small Blind: shows [4s Kd] (a hand...)
Big Blind: shows [9s Td] (a hand...)
Hero: shows [Qs Qd] (a hand...)
Dealer: shows [Kc 3d] (a hand...)
UTG+1: shows [Jh Ad] (a hand...)
Hero collected $941.32 from pot
*** SUMMARY ***
Total pot $944.32 | Rake $3.00
Board [2h 9c 6d 4d 8d]
Seat 1: Small Blind folded
Seat 2: Big Blind showed [9s Td] and lost with...
Seat 3: Hero showed [Qs Qd] and won ($941.32)
Seat 4: UTG+1 folded
Seat 5: Dealer folded



PokerStars Hand #3946942217:  Hold'em No Limit ($2.50/$5) - 2020/05/19 11:28:30 ET
Table '21505646' 9-max Seat #2 is the button
Seat 1: UTG ($981.56 in chips) 
Seat 2: Hero ($518.13 in chips) 
Seat 3: Small Blind ($55.40 in chips) 
Seat 4: Big Blind ($441.57 in chips) 
Small Blind: posts small blind $2.50
Big Blind: posts big blind $5
*** HOLE CARDS ***
Dealt to Hero [7d 7h]
UTG: folds 
Hero: raises $7.50 to $12.50
Small Blind: folds 
Big Blind: calls $7.50
*** FLOP *** [5h Ts 6d]
Big Blind: checks 
Hero: bets $13.07
Big Blind: calls $13.07
*** TURN *** [5h Ts 6d] [Jh]
Big Blind: checks 
Hero: checks 
*** RIVER *** [5h Ts 6d Jh] [Td]
Big Blind: bets $50.96
Hero: folds 
*** SHOW DOWN ***
Small Blind: shows [3d 6c] (a hand...)
UTG: shows [5d 3c] (a hand...)
Big Blind: shows [Th Qs] (a hand...)
Hero: shows [7d 7h] (a hand...)
Uncalled bet ($50.96) returned to Big Blind
Big Blind collected $50.96 from pot
*** SUMMARY ***
Total pot $53.64 | Rake $2.68
Board [5h Ts 6d Jh Td]
Seat 1: UTG folded
Seat 2: Hero folded
Seat 3: Small Blind folded
Seat 4: Big Blind collected ($50.96)



PokerStars Hand #3946376909:  Hold'em No Limit ($2.50/$5) - 2020/05/18 12:16:48 ET
Table '21496880' 9-max Seat #3 is the button
Seat 1: Small Blind ($487.50 in chips) 
Seat 2: Big Blind ($486.25 in chips) 
Seat 3: Hero ($500.00 in chips) 
Small Blind: posts small blind $2.50
Big Blind: posts big blind $5
*** HOLE CARDS ***
Dealt to Hero [Td Tc]
Hero: raises $7.50 to $12.50
Small Blind: raises $27.50 to $40
Big Blind: folds 
Hero: calls $27.50
*** FLOP *** [2c 5h 7h]
Small Blind: checks 
Hero: checks 
*** TURN *** [2c 5h 7h] [4h]
Small Blind: bets $40
Hero: calls $40
*** RIVER *** [2c 5h 7h 4h] [Kd]
Small Blind: bets $163
Hero: calls $163
*** SHOW DOWN ***
Small Blind: shows [Jc 9c] (a hand...)
Big Blind: shows [6c Qc] (a hand...)
Hero: shows [Td Tc] (a hand...)
Hero collected $489 from pot
*** SUMMARY ***
Total pot $491.00 | Rake $2.00
Board [2c 5h 7h 4h Kd]
Seat 1: Small Blind showed [Jc 9c] and lost with...
Seat 2: Big Blind folded
Seat 3: Hero showed [Td Tc] and won ($489)



PokerStars Hand #3946375447:  Hold'em No Limit ($2.50/$5) - 2020/05/18 12:11:44 ET
Table '21496853' 9-max Seat #3 is the button
Seat 1: UTG ($542.00 in chips) 
Seat 2: UTG+1 ($517.48 in chips) 
Seat 3: Dealer ($497.50 in chips) 
Seat 4: Small Blind ($291.33 in chips) 
Seat 5: Hero ($500.00 in chips) 
Small Blind: posts small blind $2.50
Hero: posts big blind $5
*** HOLE CARDS ***
Dealt to Hero [Jh 2h]
UTG: folds 
UTG+1: calls $5
Dealer: folds 
Small Blind: calls $2.50
Hero: checks 
*** FLOP *** [8s 2d 5s]
Small Blind: checks 
Hero: checks 
UTG+1: checks 
*** TURN *** [8s 2d 5s] [3c]
Small Blind: checks 
Hero: checks 
UTG+1: checks 
*** RIVER *** [8s 2d 5s 3c] [4s]
Small Blind: checks 
Hero: checks 
UTG+1: bets $7.13
Small Blind: folds 
Hero: folds 
*** SHOW DOWN ***
Small Blind: shows [Qh 4h] (a hand...)
Hero: shows [Jh 2h] (a hand...)
Dealer: shows [6d Qd] (a hand...)
UTG: shows [3h 6c] (a hand...)
UTG+1: shows [Ts 9c] (a hand...)
Uncalled bet ($7.13) returned to UTG+1
UTG+1 collected $14.25 from pot
*** SUMMARY ***
Total pot $15.00 | Rake $0.75
Board [8s 2d 5s 3c 4s]
Seat 1: UTG folded
Seat 2: UTG+1 collected ($14.25)
Seat 3: Dealer folded
Seat 4: Small Blind folded
Seat 5: Hero folded



PokerStars Hand #3946374354:  Hold'em No Limit ($2.50/$5) - 2020/05/18 12:08:01 ET
Table '21496853' 9-max Seat #1 is the button
Seat 1: Dealer ($542.00 in chips) 
Seat 2: Small Blind ($415.50 in chips) 
Seat 3: Big Blind ($465.82 in chips) 
Seat 4: UTG ($196.83 in chips) 
Seat 5: Hero ($507.45 in chips) 
Small Blind: posts small blind $2.50
Big Blind: posts big blind $5
*** HOLE CARDS ***
Dealt to Hero [Qd Ad]
UTG: folds 
Hero: raises $7.50 to $12.50
Dealer: folds 
Small Blind: calls $10
Big Blind: folds 
*** FLOP *** [5d 3c Jc]
Small Blind: checks 
Hero: bets $20
Small Blind: calls $20
*** TURN *** [5d 3c Jc] [Qc]
Small Blind: checks 
Hero: bets $44.89
Small Blind: calls $44.89
*** RIVER *** [5d 3c Jc Qc] [6s]
Small Blind: bets $117.59
Hero: calls $117.59
*** SHOW DOWN ***
Small Blind: shows [2c Kc] (a hand...)
Big Blind: shows [4h Qh] (a hand...)
Hero: shows [Qd Ad] (a hand...)
Dealer: shows [5s Ks] (a hand...)
UTG: shows [7h 3d] (a hand...)
Small Blind collected $391.96 from pot
*** SUMMARY ***
Total pot $394.96 | Rake $3.00
Board [5d 3c Jc Qc 6s]
Seat 1: Dealer folded
Seat 2: Small Blind showed [2c Kc] and won ($391.96)
Seat 3: Big Blind folded
Seat 4: UTG folded
Seat 5: Hero showed [Qd Ad] and lost with...



PokerStars Hand #3946372309:  Hold'em No Limit ($2.50/$5) - 2020/05/18 12:01:12 ET
Table '21496877' 9-max Seat #2 is the button
Seat 1: Hero ($505.00 in chips) 
Seat 2: Dealer ($495.00 in chips) 
Dealer: posts small blind $2.50
Hero: posts big blind $5
*** HOLE CARDS ***
Dealt to Hero [Ts 8h]
Dealer: raises $5.00 to $10
Hero: calls $5
*** FLOP *** [Ac 9c 6d]
Hero: checks 
Dealer: bets $10
Hero: calls $10
*** TURN *** [Ac 9c 6d] [6s]
Hero: checks 
Dealer: checks 
*** RIVER *** [Ac 9c 6d 6s] [Kh]
Hero: bets $12.50
Dealer: raises $27.50 to $40
Hero: folds 
*** SHOW DOWN ***
Dealer: shows [Ah Jd] (a hand...)
Hero: shows [Ts 8h] (a hand...)
Uncalled bet ($27.50) returned to Dealer
Dealer collected $64 from pot
*** SUMMARY ***
Total pot $65.00 | Rake $1.00
Board [Ac 9c 6d 6s Kh]
Seat 1: Hero folded
Seat 2: Dealer collected ($64)



PokerStars Hand #3944490323:  Hold'em No Limit ($2.50/$5) - 2020/05/15 12:45:23 ET
Table '21465182' 9-max Seat #4 is the button
Seat 1: Big Blind ($531.60 in chips) 
Seat 2: UTG ($993.16 in chips) 
Seat 3: UTG+1 ($487.00 in chips) 
Seat 4: Dealer ($394.61 in chips) 
Seat 5: Hero ($568.86 in chips) 
Hero: posts small blind $2.50
Big Blind: posts big blind $5
*** HOLE CARDS ***
Dealt to Hero [9s Ts]
UTG: raises $10 to $15
UTG+1: folds 
Dealer: folds 
Hero: raises $50.00 to $65
Big Blind: folds 
UTG: calls $50
*** FLOP *** [Jc Kh 7c]
Hero: bets $66
UTG: calls $66
*** TURN *** [Jc Kh 7c] [7s]
Hero: bets $131.72
UTG: raises $131.72 to $263.44
Hero: calls $131.72
*** RIVER *** [Jc Kh 7c 7s] [3c]
Hero: checks 
UTG: bets $175
Hero: folds 
*** SHOW DOWN ***
Big Blind: shows [9h 8s] (a hand...)
Hero: shows [9s Ts] (a hand...)
Dealer: shows [3d Qc] (a hand...)
UTG: shows [7d Kd] (a hand...)
UTG+1: shows [8h As] (a hand...)
Uncalled bet ($175.00) returned to UTG
UTG collected $790.88 from pot
*** SUMMARY ***
Total pot $793.88 | Rake $3.00
Board [Jc Kh 7c 7s 3c]
Seat 1: Big Blind folded
Seat 2: UTG collected ($790.88)
Seat 3: UTG+1 folded
Seat 4: Dealer folded
Seat 5: Hero folded



PokerStars Hand #3944483355:  Hold'em No Limit ($2.50/$5) - 2020/05/15 12:26:16 ET
Table '21465451' 9-max Seat #4 is the button
Seat 1: Hero ($923.62 in chips) 
Seat 2: UTG ($601.00 in chips) 
Seat 3: UTG+1 ($485.00 in chips) 
Seat 4: Dealer ($884.75 in chips) 
Seat 5: Small Blind ($626.14 in chips) 
Small Blind: posts small blind $2.50
Hero: posts big blind $5
*** HOLE CARDS ***
Dealt to Hero [3c Kc]
UTG: folds 
UTG+1: folds 
Dealer: folds 
Small Blind: raises $10.00 to $15
Hero: calls $10
*** FLOP *** [Qs 5s Jh]
Small Blind: checks 
Hero: checks 
*** TURN *** [Qs 5s Jh] [5c]
Small Blind: checks 
Hero: checks 
*** RIVER *** [Qs 5s Jh 5c] [3s]
Small Blind: bets $26.38
Hero: folds 
*** SHOW DOWN ***
Small Blind: shows [6d Kd] (a hand...)
Hero: shows [3c Kc] (a hand...)
Dealer: shows [Ad 6s] (a hand...)
UTG: shows [4h 6h] (a hand...)
UTG+1: shows [Ac 8h] (a hand...)
Uncalled bet ($26.38) returned to Small Blind
Small Blind collected $28.50 from pot
*** SUMMARY ***
Total pot $30.00 | Rake $1.50
Board [Qs 5s Jh 5c 3s]
Seat 1: Hero folded
Seat 2: UTG folded
Seat 3: UTG+1 folded
Seat 4: Dealer folded
Seat 5: Small Blind collected ($28.50)



PokerStars Hand #3944483009:  Hold'em No Limit ($2.50/$5) - 2020/05/15 12:25:20 ET
Table '21465758' 9-max Seat #1 is the button
Seat 1: Dealer ($392.84 in chips) 
Seat 2: Small Blind ($319.33 in chips) 
Seat 3: Hero ($1191.02 in chips) 
Seat 4: UTG ($1187.51 in chips) 
Seat 5: UTG+1 ($492.50 in chips) 
Seat 6: UTG+2 ($158.79 in chips) 
Small Blind: posts small blind $2.50
Hero: posts big blind $5
*** HOLE CARDS ***
Dealt to Hero [Kh Ah]
UTG: folds 
UTG+1: folds 
UTG+2: calls $5
Dealer: raises $10 to $15
Small Blind: folds 
Hero: raises $52.50 to $67.50
UTG+2: folds 
Dealer: calls $52.50
*** FLOP *** [Js Qs Qh]
Hero: bets $41.55
Dealer: raises $41.55 to $83.10
Hero: calls $41.55
*** TURN *** [Js Qs Qh] [Qc]
Hero: checks 
Dealer: checks 
*** RIVER *** [Js Qs Qh Qc] [7h]
Hero: checks 
Dealer: bets $242.24 and is all-in
Hero: calls $242.24
*** SHOW DOWN ***
Small Blind: shows [7c 4s] (a hand...)
Hero: shows [Kh Ah] (a hand...)
Dealer: shows [Jh 8c] (a hand...)
UTG+2: shows [2s 4d] (a hand...)
UTG: shows [3h 9s] (a hand...)
UTG+1: shows [2c 6h] (a hand...)
Dealer collected $789.18 from pot
*** SUMMARY ***
Total pot $793.18 | Rake $4.00
Board [Js Qs Qh Qc 7h]
Seat 1: Dealer showed [Jh 8c] and won ($789.18)
Seat 2: Small Blind folded
Seat 3: Hero showed [Kh Ah] and lost with...
Seat 4: UTG folded
Seat 5: UTG+1 folded
Seat 6: UTG+2 folded



PokerStars Hand #3944477694:  Hold'em No Limit ($2.50/$5) - 2020/05/15 12:09:49 ET
Table '21465451' 9-max
Seat 1: Hero ($1028.12 in chips) 
Seat 2: Small Blind ($616.00 in chips) 
Seat 3: Big Blind ($689.25 in chips) 
Small Blind: posts small blind $2.50
Big Blind: posts big blind $5
*** HOLE CARDS ***
Dealt to Hero [Ac 8c]
Hero: raises $7.50 to $12.50
Small Blind: raises $39.50 to $52
Big Blind: calls $47
Hero: calls $39.50
*** FLOP *** [9h 2s Js]
Small Blind: checks 
Big Blind: checks 
Hero: checks 
*** TURN *** [9h 2s Js] [7h]
Small Blind: checks 
Big Blind: checks 
Hero: checks 
*** RIVER *** [9h 2s Js 7h] [5h]
Small Blind: checks 
Big Blind: bets $138
Hero: folds 
Small Blind: folds 
*** SHOW DOWN ***
Small Blind: shows [Kh Ad] (a hand...)
Big Blind: shows [Qd As] (a hand...)
Hero: shows [Ac 8c] (a hand...)
Uncalled bet ($138.00) returned to Big Blind
Big Blind collected $154 from pot
*** SUMMARY ***
Total pot $156.00 | Rake $2.00
Board [9h 2s Js 7h 5h]
Seat 1: Hero folded
Seat 2: Small Blind folded
Seat 3: Big Blind collected ($154)



PokerStars Hand #3944473250:  Hold'em No Limit ($2.50/$5) - 2020/05/15 11:57:13 ET
Table '21465953' 9-max Seat #1 is the button
Seat 1: Dealer ($500.00 in chips) 
Seat 2: Hero ($500.00 in chips) 
Dealer: posts small blind $2.50
Hero: posts big blind $5
*** HOLE CARDS ***
Dealt to Hero [Kc 5h]
Dealer: raises $5.00 to $10
Hero: calls $5
*** FLOP *** [Jc Kh Ad]
Hero: checks 
Dealer: checks 
*** TURN *** [Jc Kh Ad] [3h]
Hero: checks 
Dealer: bets $14.25
Hero: calls $14.25
*** RIVER *** [Jc Kh Ad 3h] [Ah]
Hero: checks 
Dealer: bets $35.63
Hero: folds 
*** SHOW DOWN ***
Dealer: shows [As 5c] (a hand...)
Hero: shows [Kc 5h] (a hand...)
Uncalled bet ($35.63) returned to Dealer
Dealer collected $47.50 from pot
*** SUMMARY ***
Total pot $48.50 | Rake $1.00
Board [Jc Kh Ad 3h Ah]
Seat 1: Dealer collected ($47.50)
Seat 2: Hero folded



PokerStars Hand #3944470441:  Hold'em No Limit ($2.50/$5) - 2020/05/15 11:49:12 ET
Table '21465451' 9-max Seat #5 is the button
Seat 1: Hero ($560.12 in chips) 
Seat 2: Big Blind ($494.91 in chips) 
Seat 3: UTG ($490.00 in chips) 
Seat 4: UTG+1 ($492.50 in chips) 
Seat 5: Dealer ($190.13 in chips) 
Hero: posts small blind $2.50
Big Blind: posts big blind $5
*** HOLE CARDS ***
Dealt to Hero [6h Ad]
UTG: folds 
UTG+1: folds 
Dealer: folds 
Hero: raises $10.00 to $15
Big Blind: calls $10
*** FLOP *** [3s Ac 8h]
Hero: checks 
Big Blind: checks 
*** TURN *** [3s Ac 8h] [As]
Hero: checks 
Big Blind: bets $14.25
Hero: calls $14.25
*** RIVER *** [3s Ac 8h As] [Js]
Hero: checks 
Big Blind: bets $36.69
Hero: calls $36.69
*** SHOW DOWN ***
Big Blind: shows [Ah 7s] (a hand...)
Hero: shows [6h Ad] (a hand...)
Dealer: shows [6c Kc] (a hand...)
UTG: shows [Jc 8s] (a hand...)
UTG+1: shows [Jd 7d] (a hand...)
Hero collected $64.44 from pot
Big Blind collected $64.44 from pot
*** SUMMARY ***
Total pot $131.88 | Rake $3.00
Board [3s Ac 8h As Js]
Seat 1: Hero showed [6h Ad] and won ($64.44)
Seat 2: Big Blind showed [Ah 7s] and won ($64.44)
Seat 3: UTG folded
Seat 4: UTG+1 folded
Seat 5: Dealer folded



PokerStars Hand #3944469329:  Hold'em No Limit ($2.50/$5) - 2020/05/15 11:45:59 ET
Table '21465451' 9-max Seat #4 is the button
Seat 1: Hero ($500.00 in chips) 
Seat 2: UTG ($494.91 in chips) 
Seat 3: UTG+1 ($490.00 in chips) 
Seat 4: Dealer ($1069.50 in chips) 
Seat 5: Small Blind ($210.13 in chips) 
Small Blind: posts small blind $2.50
Hero: posts big blind $5
*** HOLE CARDS ***
Dealt to Hero [6d Ah]
UTG: folds 
UTG+1: folds 
Dealer: raises $7.50 to $12.50
Small Blind: folds 
Hero: calls $7.50
*** FLOP *** [Ac As 7c]
Hero: checks 
Dealer: bets $9
Hero: calls $9
*** TURN *** [Ac As 7c] [5c]
Hero: checks 
Dealer: checks 
*** RIVER *** [Ac As 7c 5c] [3c]
Hero: checks 
Dealer: bets $21.62
Hero: calls $21.62
*** SHOW DOWN ***
Small Blind: shows [9d Qs] (a hand...)
Hero: shows [6d Ah] (a hand...)
Dealer: shows [Js Qh] (a hand...)
UTG: shows [7d 4s] (a hand...)
UTG+1: shows [4h 3h] (a hand...)
Hero collected $85.74 from pot
*** SUMMARY ***
Total pot $88.74 | Rake $3.00
Board [Ac As 7c 5c 3c]
Seat 1: Hero showed [6d Ah] and won ($85.74)
Seat 2: UTG folded
Seat 3: UTG+1 folded
Seat 4: Dealer showed [Js Qh] and lost with...
Seat 5: Small Blind folded



PokerStars Hand #3944465220:  Hold'em No Limit ($2.50/$5) - 2020/05/15 11:34:12 ET
Table '21465182' 9-max Seat #1 is the button
Seat 1: Dealer ($380.11 in chips) 
Seat 2: Small Blind ($653.38 in chips) 
Seat 3: Big Blind ($266.82 in chips) 
Seat 4: UTG ($415.51 in chips) 
Seat 5: Hero ($996.50 in chips) 
Small Blind: posts small blind $2.50
Big Blind: posts big blind $5
*** HOLE CARDS ***
Dealt to Hero [Tc Kc]
UTG: folds 
Hero: raises $7.50 to $12.50
Dealer: folds 
Small Blind: raises $45.00 to $57.50
Big Blind: folds 
Hero: calls $45
*** FLOP *** [4s Qd Kh]
Small Blind: bets $38.61
Hero: calls $38.61
*** TURN *** [4s Qd Kh] [8h]
Small Blind: bets $129.47
Hero: calls $129.47
*** RIVER *** [4s Qd Kh 8h] [6c]
Small Blind: bets $427.80 and is all-in
Hero: folds 
*** SHOW DOWN ***
Small Blind: shows [Ad As] (a hand...)
Big Blind: shows [8s Ac] (a hand...)
Hero: shows [Tc Kc] (a hand...)
Dealer: shows [6s 3d] (a hand...)
UTG: shows [Qs 9c] (a hand...)
Uncalled bet ($427.80) returned to Small Blind
Small Blind collected $453.16 from pot
*** SUMMARY ***
Total pot $456.16 | Rake $3.00
Board [4s Qd Kh 8h 6c]
Seat 1: Dealer folded
Seat 2: Small Blind collected ($453.16)
Seat 3: Big Blind folded
Seat 4: UTG folded
Seat 5: Hero folded



PokerStars Hand #3944464276:  Hold'em No Limit ($2.50/$5) - 2020/05/15 11:31:24 ET
Table '21464682' 9-max Seat #4 is the button
Seat 2: Big Blind ($1293.69 in chips) 
Seat 3: UTG ($774.09 in chips) 
Seat 4: Dealer ($586.34 in chips) 
Seat 5: Hero ($551.29 in chips) 
Hero: posts small blind $2.50
Big Blind: posts big blind $5
*** HOLE CARDS ***
Dealt to Hero [Tc 9c]
UTG: raises $6 to $11
Dealer: folds 
Hero: raises $41.50 to $52.50
Big Blind: folds 
UTG: calls $41.50
*** FLOP *** [7d 8d 5h]
Hero: checks 
UTG: bets $53.50
Hero: calls $53.50
*** TURN *** [7d 8d 5h] [4h]
Hero: checks 
UTG: bets $71.33
Hero: calls $71.33
*** RIVER *** [7d 8d 5h 4h] [9s]
Hero: checks 
UTG: bets $596.76 and is all-in
Hero: calls $373.96 and is all-in
*** SHOW DOWN ***
UTG: shows [8c 7c] (a hand...)
Dealer: shows [Ts 3d] (a hand...)
Big Blind: shows [7h Th] (a hand...)
Hero: shows [Tc 9c] (a hand...)
Uncalled bet ($222.80) returned to UTG
UTG collected $1104.58 from pot
*** SUMMARY ***
Total pot $1107.58 | Rake $3.00
Board [7d 8d 5h 4h 9s]
Seat 2: Big Blind folded
Seat 3: UTG showed [8c 7c] and won ($1104.58)
Seat 4: Dealer folded
Seat 5: Hero showed [Tc 9c] and lost with...



PokerStars Hand #3944462677:  Hold'em No Limit ($2.50/$5) - 2020/05/15 11:26:45 ET
Table '21465182' 9-max Seat #5 is the button
Seat 1: Small Blind ($843.29 in chips) 
Seat 2: Big Blind ($645.88 in chips) 
Seat 3: UTG ($235.82 in chips) 
Seat 4: UTG+1 ($459.76 in chips) 
Seat 5: Hero ($508.50 in chips) 
Small Blind: posts small blind $2.50
Big Blind: posts big blind $5
*** HOLE CARDS ***
Dealt to Hero [5d 5h]
UTG: calls $5
UTG+1: folds 
Hero: raises $15 to $20
Small Blind: raises $50.00 to $70
Big Blind: folds 
UTG: folds 
Hero: calls $50
*** FLOP *** [5s 2d Ad]
Small Blind: bets $48.51
Hero: calls $48.51
*** TURN *** [5s 2d Ad] [7h]
Small Blind: bets $139
Hero: calls $139
*** RIVER *** [5s 2d Ad 7h] [7s]
Small Blind: bets $585.78 and is all-in
Hero: calls $250.99 and is all-in
*** SHOW DOWN ***
Small Blind: shows [As Kc] (a hand...)
Big Blind: shows [6d Th] (a hand...)
Hero: shows [5d 5h] (a hand...)
UTG: shows [7d Td] (a hand...)
UTG+1: shows [3s Qd] (a hand...)
Uncalled bet ($334.79) returned to Small Blind
Hero collected $1024 from pot
*** SUMMARY ***
Total pot $1027.00 | Rake $3.00
Board [5s 2d Ad 7h 7s]
Seat 1: Small Blind showed [As Kc] and lost with...
Seat 2: Big Blind folded
Seat 3: UTG folded
Seat 4: UTG+1 folded
Seat 5: Hero showed [5d 5h] and won ($1024)



PokerStars Hand #3944461223:  Hold'em No Limit ($2.50/$5) - 2020/05/15 11:22:29 ET
Table '21465451' 9-max Seat #6 is the button
Seat 1: Hero ($503.50 in chips) 
Seat 2: Big Blind ($500.00 in chips) 
Seat 3: UTG ($500.88 in chips) 
Seat 4: UTG+1 ($507.50 in chips) 
Seat 5: UTG+2 ($436.34 in chips) 
Seat 6: Dealer ($232.50 in chips) 
Hero: posts small blind $2.50
Big Blind: posts big blind $5
*** HOLE CARDS ***
Dealt to Hero [8d Ah]
UTG: folds 
UTG+1: folds 
UTG+2: calls $5
Dealer: folds 
Hero: calls $2.50
Big Blind: checks 
*** FLOP *** [Jh Ac 6s]
Hero: checks 
Big Blind: checks 
UTG+2: checks 
*** TURN *** [Jh Ac 6s] [Th]
Hero: checks 
Big Blind: checks 
UTG+2: bets $14.25
Hero: calls $14.25
Big Blind: folds 
*** RIVER *** [Jh Ac 6s Th] [Kc]
Hero: checks 
UTG+2: bets $20.67
Hero: calls $20.67
*** SHOW DOWN ***
Big Blind: shows [Qs 3c] (a hand...)
Hero: shows [8d Ah] (a hand...)
UTG+2: shows [Kh As] (a hand...)
Dealer: shows [Qd 5h] (a hand...)
UTG: shows [6h 3s] (a hand...)
UTG+1: shows [4c 3d] (a hand...)
UTG+2 collected $80.84 from pot
*** SUMMARY ***
Total pot $84.84 | Rake $4.00
Board [Jh Ac 6s Th Kc]
Seat 1: Hero showed [8d Ah] and lost with...
Seat 2: Big Blind folded
Seat 3: UTG folded
Seat 4: UTG+1 folded
Seat 5: UTG+2 showed [Kh As] and won ($80.84)
Seat 6: Dealer folded



PokerStars Hand #3944460057:  Hold'em No Limit ($2.50/$5) - 2020/05/15 11:18:58 ET
Table '21465451' 9-max Seat #2 is the button
Seat 1: Hero ($541.00 in chips) 
Seat 2: Dealer ($344.95 in chips) 
Seat 3: Small Blind ($503.38 in chips) 
Seat 4: Big Blind ($500.00 in chips) 
Seat 5: UTG ($420.34 in chips) 
Seat 6: UTG+1 ($242.50 in chips) 
Small Blind: posts small blind $2.50
Big Blind: posts big blind $5
*** HOLE CARDS ***
Dealt to Hero [8s 8d]
UTG: folds 
UTG+1: folds 
Hero: raises $7.50 to $12.50
Dealer: calls $12.50
Small Blind: folds 
Big Blind: folds 
*** FLOP *** [2h 6c Qd]
Hero: checks 
Dealer: checks 
*** TURN *** [2h 6c Qd] [Jc]
Hero: checks 
Dealer: checks 
*** RIVER *** [2h 6c Qd Jc] [5d]
Hero: checks 
Dealer: bets $20
Hero: calls $20
*** SHOW DOWN ***
Small Blind: shows [6h 3s] (a hand...)
Big Blind: shows [5c Kd] (a hand...)
Hero: shows [8s 8d] (a hand...)
Dealer: shows [5s 6s] (a hand...)
UTG: shows [Qc 5h] (a hand...)
UTG+1: shows [Kh 4s] (a hand...)
Dealer collected $68.88 from pot
*** SUMMARY ***
Total pot $72.50 | Rake $3.62
Board [2h 6c Qd Jc 5d]
Seat 1: Hero showed [8s 8d] and lost with...
Seat 2: Dealer showed [5s 6s] and won ($68.88)
Seat 3: Small Blind folded
Seat 4: Big Blind folded
Seat 5: UTG folded
Seat 6: UTG+1 folded



